Poker Hand #RC95078899: Hold'em No Limit ($0.1/$0.25) - 2020/04/07 15:03:54
Table 'RushAndCash363020' 6-max Seat #1 is the button
Seat 1: b5d592d2 ($13.54 in chips)
Seat 2: 3abc34ff ($25 in chips)
Seat 3: Hero ($25 in chips)
Seat 4: dbf6981f ($25.97 in chips)
Seat 5: 5794e88f ($26.2 in chips)
Seat 6: 289f2e46 ($36.48 in chips)
3abc34ff: posts small blind $0.1
Hero: posts big blind $0.25
*** HOLE CARDS ***
Dealt to b5d592d2 
Dealt to 3abc34ff 
Dealt to Hero [8d 4c]
Dealt to dbf6981f 
Dealt to 5794e88f 
Dealt to 289f2e46 
dbf6981f: folds
5794e88f: raises $0.38 to $0.63
289f2e46: folds
b5d592d2: folds
3abc34ff: folds
Hero: folds
Uncalled bet ($0.38) returned to 5794e88f
*** SHOWDOWN ***
5794e88f collected $0.6 from pot
*** SUMMARY ***
Total pot $0.6
Seat 1: b5d592d2 (button) folded before Flop (didn't bet)
Seat 2: 3abc34ff (small blind) folded before Flop
Seat 3: Hero (big blind) folded before Flop
Seat 4: dbf6981f folded before Flop (didn't bet)
Seat 5: 5794e88f collected ($0.6)
Seat 6: 289f2e46 folded before Flop (didn't bet)


Poker Hand #RC95079000: Hold'em No Limit ($0.1/$0.25) - 2020/04/07 15:04:07
Table 'RushAndCash363032' 6-max Seat #1 is the button
Seat 1: 5d360146 ($15.69 in chips)
Seat 2: Hero ($25 in chips)
Seat 3: 887f8eab ($8.05 in chips)
Seat 4: 7ac43878 ($8.51 in chips)
Seat 5: acf1a889 ($17.37 in chips)
Seat 6: 8c86f461 ($31.21 in chips)
Hero: posts small blind $0.1
887f8eab: posts big blind $0.25
*** HOLE CARDS ***
Dealt to 5d360146 
Dealt to Hero [As 3d]
Dealt to 887f8eab 
Dealt to 7ac43878 
Dealt to acf1a889 
Dealt to 8c86f461 
7ac43878: folds
acf1a889: folds
8c86f461: folds
5d360146: raises $0.5 to $0.75
Hero: folds
887f8eab: folds
Uncalled bet ($0.5) returned to 5d360146
*** SHOWDOWN ***
5d360146 collected $0.6 from pot
*** SUMMARY ***
Total pot $0.6
Seat 1: 5d360146 (button) collected ($0.6)
Seat 2: Hero (small blind) folded before Flop
Seat 3: 887f8eab (big blind) folded before Flop
Seat 4: 7ac43878 folded before Flop (didn't bet)
Seat 5: acf1a889 folded before Flop (didn't bet)
Seat 6: 8c86f461 folded before Flop (didn't bet)


Poker Hand #RC95079076: Hold'em No Limit ($0.1/$0.25) - 2020/04/07 15:04:16
Table 'RushAndCash363040' 6-max Seat #1 is the button
Seat 1: Hero ($25 in chips)
Seat 2: 966446c2 ($21.94 in chips)
Seat 3: 3cfd7308 ($32.41 in chips)
Seat 4: c028c3ef ($14.71 in chips)
Seat 5: d84d476b ($27.61 in chips)
Seat 6: 181171f9 ($59.81 in chips)
966446c2: posts small blind $0.1
3cfd7308: posts big blind $0.25
*** HOLE CARDS ***
Dealt to Hero [Tc 5c]
Dealt to 966446c2 
Dealt to 3cfd7308 
Dealt to c028c3ef 
Dealt to d84d476b 
Dealt to 181171f9 
c028c3ef: folds
d84d476b: folds
181171f9: raises $0.38 to $0.63
Hero: folds
966446c2: folds
3cfd7308: calls $0.38
*** FLOP *** [Ad 3d 3c]
3cfd7308: checks
181171f9: bets $0.5
3cfd7308: folds
Uncalled bet ($0.5) returned to 181171f9
*** SHOWDOWN ***
181171f9 collected $1.36 from pot
*** SUMMARY ***
Total pot $1.36
Board [Ad 3d 3c]
Seat 1: Hero (button) folded before Flop (didn't bet)
Seat 2: 966446c2 (small blind) folded before Flop
Seat 3: 3cfd7308 (big blind) folded on the Flop
Seat 4: c028c3ef folded before Flop (didn't bet)
Seat 5: d84d476b folded before Flop (didn't bet)
Seat 6: 181171f9 won ($1.36)


Poker Hand #RC95079139: Hold'em No Limit ($0.1/$0.25) - 2020/04/07 15:04:24
Table 'RushAndCash363046' 6-max Seat #1 is the button
Seat 1: 103129d8 ($24.04 in chips)
Seat 2: 5794e88f ($26.55 in chips)
Seat 3: af082b6b ($12.5 in chips)
Seat 4: 32c812e3 ($45.47 in chips)
Seat 5: Hero ($25 in chips)
Seat 6: e814b201 ($25.57 in chips)
5794e88f: posts small blind $0.1
af082b6b: posts big blind $0.25
*** HOLE CARDS ***
Dealt to 103129d8 
Dealt to 5794e88f 
Dealt to af082b6b 
Dealt to 32c812e3 
Dealt to Hero [Td 8s]
Dealt to e814b201 
32c812e3: folds
Hero: folds
e814b201: raises $0.25 to $0.5
103129d8: folds
5794e88f: raises $2 to $2.5
af082b6b: folds
e814b201: calls $2
*** FLOP *** [5c Ts Jh]
5794e88f: bets $1.8
e814b201: calls $1.8
*** TURN *** [5c Ts Jh] [9c]
5794e88f: checks
e814b201: bets $5.75
5794e88f: folds
Uncalled bet ($5.75) returned to e814b201
*** SHOWDOWN ***
e814b201 collected $8.85 from pot
*** SUMMARY ***
Total pot $8.85
Board [5c Ts Jh 9c]
Seat 1: 103129d8 (button) folded before Flop (didn't bet)
Seat 2: 5794e88f (small blind) folded on the Turn
Seat 3: af082b6b (big blind) folded before Flop
Seat 4: 32c812e3 folded before Flop (didn't bet)
Seat 5: Hero folded before Flop (didn't bet)
Seat 6: e814b201 won ($8.85)


Poker Hand #RC95079168: Hold'em No Limit ($0.1/$0.25) - 2020/04/07 15:04:27
Table 'RushAndCash363050' 6-max Seat #1 is the button
Seat 1: 8c86f461 ($30.96 in chips)
Seat 2: db070299 ($22.68 in chips)
Seat 3: a4ba858f ($25 in chips)
Seat 4: 966446c2 ($21.84 in chips)
Seat 5: a6fc3bd6 ($28.65 in chips)
Seat 6: Hero ($25 in chips)
db070299: posts small blind $0.1
a4ba858f: posts big blind $0.25
*** HOLE CARDS ***
Dealt to 8c86f461 
Dealt to db070299 
Dealt to a4ba858f 
Dealt to 966446c2 
Dealt to a6fc3bd6 
Dealt to Hero [9s 5c]
966446c2: folds
a6fc3bd6: folds
Hero: folds
8c86f461: folds
db070299: folds
Uncalled bet ($0.15) returned to a4ba858f
*** SHOWDOWN ***
a4ba858f collected $0.2 from pot
*** SUMMARY ***
Total pot $0.2
Seat 1: 8c86f461 (button) folded before Flop (didn't bet)
Seat 2: db070299 (small blind) folded before Flop
Seat 3: a4ba858f (big blind) collected ($0.2)
Seat 4: 966446c2 folded before Flop (didn't bet)
Seat 5: a6fc3bd6 folded before Flop (didn't bet)
Seat 6: Hero folded before Flop (didn't bet)


Poker Hand #RC95079236: Hold'em No Limit ($0.1/$0.25) - 2020/04/07 15:04:35
Table 'RushAndCash363057' 6-max Seat #1 is the button
Seat 1: bfa55601 ($12.5 in chips)
Seat 2: af84e661 ($12.05 in chips)
Seat 3: c86cf70b ($32.47 in chips)
Seat 4: bbb85b3f ($29.59 in chips)
Seat 5: 3abc34ff ($25 in chips)
Seat 6: Hero ($25 in chips)
af84e661: posts small blind $0.1
c86cf70b: posts big blind $0.25
*** HOLE CARDS ***
Dealt to bfa55601 
Dealt to af84e661 
Dealt to c86cf70b 
Dealt to bbb85b3f 
Dealt to 3abc34ff 
Dealt to Hero [5d 2h]
bbb85b3f: folds
3abc34ff: raises $0.5 to $0.75
Hero: folds
bfa55601: folds
af84e661: folds
c86cf70b: folds
Uncalled bet ($0.5) returned to 3abc34ff
*** SHOWDOWN ***
3abc34ff collected $0.6 from pot
*** SUMMARY ***
Total pot $0.6
Seat 1: bfa55601 (button) folded before Flop (didn't bet)
Seat 2: af84e661 (small blind) folded before Flop
Seat 3: c86cf70b (big blind) folded before Flop
Seat 4: bbb85b3f folded before Flop (didn't bet)
Seat 5: 3abc34ff collected ($0.6)
Seat 6: Hero folded before Flop (didn't bet)


Poker Hand #RC95079295: Hold'em No Limit ($0.1/$0.25) - 2020/04/07 15:04:41
Table 'RushAndCash363065' 6-max Seat #1 is the button
Seat 1: f322483e ($26.38 in chips)
Seat 2: 4dd920ba ($25 in chips)
Seat 3: 2d45ce80 ($10.03 in chips)
Seat 4: Hero ($25 in chips)
Seat 5: 2609e300 ($13.02 in chips)
Seat 6: d2986703 ($33.2 in chips)
4dd920ba: posts small blind $0.1
2d45ce80: posts big blind $0.25
*** HOLE CARDS ***
Dealt to f322483e 
Dealt to 4dd920ba 
Dealt to 2d45ce80 
Dealt to Hero [Js 5c]
Dealt to 2609e300 
Dealt to d2986703 
Hero: folds
2609e300: folds
d2986703: raises $0.5 to $0.75
f322483e: raises $1.45 to $2.2
4dd920ba: folds
2d45ce80: folds
d2986703: folds
Uncalled bet ($1.45) returned to f322483e
*** SHOWDOWN ***
f322483e collected $1.85 from pot
*** SUMMARY ***
Total pot $1.85
Seat 1: f322483e (button) collected ($1.85)
Seat 2: 4dd920ba (small blind) folded before Flop
Seat 3: 2d45ce80 (big blind) folded before Flop
Seat 4: Hero folded before Flop (didn't bet)
Seat 5: 2609e300 folded before Flop (didn't bet)
Seat 6: d2986703 folded before Flop


Poker Hand #RC95079329: Hold'em No Limit ($0.1/$0.25) - 2020/04/07 15:04:45
Table 'RushAndCash363069' 6-max Seat #1 is the button
Seat 1: f44f8c27 ($33.93 in chips)
Seat 2: Hero ($25 in chips)
Seat 3: 41064a47 ($12.75 in chips)
Seat 4: 18075352 ($27.89 in chips)
Seat 5: fe3f48f4 ($25.93 in chips)
Seat 6: 79cc211c ($25.35 in chips)
Hero: posts small blind $0.1
41064a47: posts big blind $0.25
*** HOLE CARDS ***
Dealt to f44f8c27 
Dealt to Hero [Ah Ac]
Dealt to 41064a47 
Dealt to 18075352 
Dealt to fe3f48f4 
Dealt to 79cc211c 
18075352: raises $0.5 to $0.75
fe3f48f4: folds
79cc211c: folds
f44f8c27: folds
Hero: raises $2 to $2.75
41064a47: folds
18075352: folds
Uncalled bet ($2) returned to Hero
*** SHOWDOWN ***
Hero collected $1.75 from pot
*** SUMMARY ***
Total pot $1.75
Seat 1: f44f8c27 (button) folded before Flop (didn't bet)
Seat 2: Hero (small blind) collected ($1.75)
Seat 3: 41064a47 (big blind) folded before Flop
Seat 4: 18075352 folded before Flop
Seat 5: fe3f48f4 folded before Flop (didn't bet)
Seat 6: 79cc211c folded before Flop (didn't bet)


Poker Hand #RC95079656: Hold'em No Limit ($0.1/$0.25) - 2020/04/07 15:05:27
Table 'RushAndCash363111' 6-max Seat #1 is the button
Seat 1: bda1b4ce ($25 in chips)
Seat 2: 2d45ce80 ($9.68 in chips)
Seat 3: Hero ($25.92 in chips)
Seat 4: f172d4cc ($63.96 in chips)
Seat 5: bfa55601 ($12.75 in chips)
Seat 6: 704c37d9 ($57.91 in chips)
2d45ce80: posts small blind $0.1
Hero: posts big blind $0.25
*** HOLE CARDS ***
Dealt to bda1b4ce 
Dealt to 2d45ce80 
Dealt to Hero [Ah 4h]
Dealt to f172d4cc 
Dealt to bfa55601 
Dealt to 704c37d9 
f172d4cc: folds
bfa55601: folds
704c37d9: folds
bda1b4ce: raises $0.38 to $0.63
2d45ce80: folds
Hero: calls $0.38
*** FLOP *** [8c 3s Ts]
Hero: checks
bda1b4ce: bets $0.7
Hero: folds
Uncalled bet ($0.7) returned to bda1b4ce
*** SHOWDOWN ***
bda1b4ce collected $1.36 from pot
*** SUMMARY ***
Total pot $1.36
Board [8c 3s Ts]
Seat 1: bda1b4ce (button) won ($1.36)
Seat 2: 2d45ce80 (small blind) folded before Flop
Seat 3: Hero (big blind) folded on the Flop
Seat 4: f172d4cc folded before Flop (didn't bet)
Seat 5: bfa55601 folded before Flop (didn't bet)
Seat 6: 704c37d9 folded before Flop (didn't bet)


Poker Hand #RC95079955: Hold'em No Limit ($0.1/$0.25) - 2020/04/07 15:06:07
Table 'RushAndCash363156' 6-max Seat #1 is the button
Seat 1: Hero ($25.29 in chips)
Seat 2: af84e661 ($12.3 in chips)
Seat 3: 324d8e1d ($25.67 in chips)
Seat 4: 8c86f461 ($32.27 in chips)
Seat 5: acf1a889 ($17.02 in chips)
Seat 6: f172d4cc ($63.71 in chips)
af84e661: posts small blind $0.1
324d8e1d: posts big blind $0.25
*** HOLE CARDS ***
Dealt to Hero [9c 2c]
Dealt to af84e661 
Dealt to 324d8e1d 
Dealt to 8c86f461 
Dealt to acf1a889 
Dealt to f172d4cc 
8c86f461: folds
acf1a889: folds
f172d4cc: raises $0.38 to $0.63
Hero: folds
af84e661: folds
324d8e1d: folds
Uncalled bet ($0.38) returned to f172d4cc
*** SHOWDOWN ***
f172d4cc collected $0.6 from pot
*** SUMMARY ***
Total pot $0.6
Seat 1: Hero (button) folded before Flop (didn't bet)
Seat 2: af84e661 (small blind) folded before Flop
Seat 3: 324d8e1d (big blind) folded before Flop
Seat 4: 8c86f461 folded before Flop (didn't bet)
Seat 5: acf1a889 folded before Flop (didn't bet)
Seat 6: f172d4cc collected ($0.6)


Poker Hand #RC95079987: Hold'em No Limit ($0.1/$0.25) - 2020/04/07 15:06:10
Table 'RushAndCash363161' 6-max Seat #1 is the button
Seat 1: ce59b684 ($35.09 in chips)
Seat 2: 605bdd57 ($12.5 in chips)
Seat 3: 18075352 ($27.04 in chips)
Seat 4: Hero ($25.29 in chips)
Seat 5: 704a7fcf ($34.06 in chips)
Seat 6: db070299 ($31.53 in chips)
605bdd57: posts small blind $0.1
18075352: posts big blind $0.25
*** HOLE CARDS ***
Dealt to ce59b684 
Dealt to 605bdd57 
Dealt to 18075352 
Dealt to Hero [5h 3s]
Dealt to 704a7fcf 
Dealt to db070299 
Hero: folds
704a7fcf: folds
db070299: folds
ce59b684: folds
605bdd57: folds
Uncalled bet ($0.15) returned to 18075352
*** SHOWDOWN ***
18075352 collected $0.2 from pot
*** SUMMARY ***
Total pot $0.2
Seat 1: ce59b684 (button) folded before Flop (didn't bet)
Seat 2: 605bdd57 (small blind) folded before Flop
Seat 3: 18075352 (big blind) collected ($0.2)
Seat 4: Hero folded before Flop (didn't bet)
Seat 5: 704a7fcf folded before Flop (didn't bet)
Seat 6: db070299 folded before Flop (didn't bet)


Poker Hand #RC95080027: Hold'em No Limit ($0.1/$0.25) - 2020/04/07 15:06:15
Table 'RushAndCash363166' 6-max Seat #1 is the button
Seat 1: 466b8e5e ($12.85 in chips)
Seat 2: bbb85b3f ($29.84 in chips)
Seat 3: a2f2938c ($25.22 in chips)
Seat 4: Hero ($25.29 in chips)
Seat 5: e814b201 ($29.43 in chips)
Seat 6: accea393 ($40.46 in chips)
bbb85b3f: posts small blind $0.1
a2f2938c: posts big blind $0.25
*** HOLE CARDS ***
Dealt to 466b8e5e 
Dealt to bbb85b3f 
Dealt to a2f2938c 
Dealt to Hero [Ad Th]
Dealt to e814b201 
Dealt to accea393 
Hero: folds
e814b201: folds
accea393: folds
466b8e5e: folds
bbb85b3f: raises $0.5 to $0.75
a2f2938c: raises $1.5 to $2.25
bbb85b3f: calls $1.5
*** FLOP *** [8h 9d 7h]
bbb85b3f: checks
a2f2938c: bets $3
bbb85b3f: calls $3
*** TURN *** [8h 9d 7h] [Jh]
bbb85b3f: checks
a2f2938c: checks
*** RIVER *** [8h 9d 7h Jh] [2s]
bbb85b3f: bets $3
a2f2938c: calls $3
bbb85b3f: shows [8s 8c] (Three Eights)
a2f2938c: shows [Ts Js] (Jacks-High Straight)
*** SHOWDOWN ***
a2f2938c collected $16.5 from pot
*** SUMMARY ***
Total pot $16.5
Board [8h 9d 7h Jh 2s]
Seat 1: 466b8e5e (button) folded before Flop (didn't bet)
Seat 2: bbb85b3f (small blind) showed [8s 8c] and lost with Three Eights
Seat 3: a2f2938c (big blind) showed [Js Ts] and won ($16.5) with Jacks-High Straight
Seat 4: Hero folded before Flop (didn't bet)
Seat 5: e814b201 folded before Flop (didn't bet)
Seat 6: accea393 folded before Flop (didn't bet)


Poker Hand #RC95080066: Hold'em No Limit ($0.1/$0.25) - 2020/04/07 15:06:19
Table 'RushAndCash363172' 6-max Seat #1 is the button
Seat 1: Hero ($25.29 in chips)
Seat 2: 65837850 ($147.32 in chips)
Seat 3: 605bdd57 ($12.5 in chips)
Seat 4: 528a07f8 ($33.03 in chips)
Seat 5: 3cfd7308 ($31.78 in chips)
Seat 6: 3abc34ff ($25 in chips)
65837850: posts small blind $0.1
605bdd57: posts big blind $0.25
*** HOLE CARDS ***
Dealt to Hero [Kh 9h]
Dealt to 65837850 
Dealt to 605bdd57 
Dealt to 528a07f8 
Dealt to 3cfd7308 
Dealt to 3abc34ff 
528a07f8: folds
3cfd7308: folds
3abc34ff: raises $0.5 to $0.75
Hero: folds
65837850: folds
605bdd57: folds
Uncalled bet ($0.5) returned to 3abc34ff
*** SHOWDOWN ***
3abc34ff collected $0.6 from pot
*** SUMMARY ***
Total pot $0.6
Seat 1: Hero (button) folded before Flop (didn't bet)
Seat 2: 65837850 (small blind) folded before Flop
Seat 3: 605bdd57 (big blind) folded before Flop
Seat 4: 528a07f8 folded before Flop (didn't bet)
Seat 5: 3cfd7308 folded before Flop (didn't bet)
Seat 6: 3abc34ff collected ($0.6)


Poker Hand #RC95080172: Hold'em No Limit ($0.1/$0.25) - 2020/04/07 15:06:32
Table 'RushAndCash363187' 6-max Seat #1 is the button
Seat 1: 4dd920ba ($25 in chips)
Seat 2: 181171f9 ($59.85 in chips)
Seat 3: Hero ($25.29 in chips)
Seat 4: 7ac43878 ($11.25 in chips)
Seat 5: accea393 ($40.46 in chips)
Seat 6: dbf6981f ($41.57 in chips)
181171f9: posts small blind $0.1
Hero: posts big blind $0.25
*** HOLE CARDS ***
Dealt to 4dd920ba 
Dealt to 181171f9 
Dealt to Hero [Kh 9c]
Dealt to 7ac43878 
Dealt to accea393 
Dealt to dbf6981f 
7ac43878: calls $0.25
accea393: folds
dbf6981f: folds
4dd920ba: calls $0.25
181171f9: folds
Hero: checks
*** FLOP *** [As 3s 4s]
Hero: checks
7ac43878: bets $0.9
4dd920ba: raises $2 to $2.9
Hero: folds
7ac43878: calls $2
*** TURN *** [As 3s 4s] [8s]
7ac43878: bets $8.1 and is all-in
4dd920ba: folds
Uncalled bet ($8.1) returned to 7ac43878
*** SHOWDOWN ***
7ac43878 collected $6.65 from pot
*** SUMMARY ***
Total pot $6.65
Board [As 3s 4s 8s]
Seat 1: 4dd920ba (button) folded on the Turn
Seat 2: 181171f9 (small blind) folded before Flop
Seat 3: Hero (big blind) folded on the Flop
Seat 4: 7ac43878 won ($6.65)
Seat 5: accea393 folded before Flop (didn't bet)
Seat 6: dbf6981f folded before Flop (didn't bet)


Poker Hand #RC95080196: Hold'em No Limit ($0.1/$0.25) - 2020/04/07 15:06:35
Table 'RushAndCash363190' 6-max Seat #1 is the button
Seat 1: e814b201 ($29.43 in chips)
Seat 2: ba64e1 ($11.75 in chips)
Seat 3: 8c86f461 ($32.62 in chips)
Seat 4: 95083363 ($25.35 in chips)
Seat 5: d80f1bfd ($12.85 in chips)
Seat 6: Hero ($25.04 in chips)
ba64e1: posts small blind $0.1
8c86f461: posts big blind $0.25
*** HOLE CARDS ***
Dealt to e814b201 
Dealt to ba64e1 
Dealt to 8c86f461 
Dealt to 95083363 
Dealt to d80f1bfd 
Dealt to Hero [8d 5c]
95083363: raises $0.5 to $0.75
d80f1bfd: folds
Hero: folds
e814b201: folds
ba64e1: folds
8c86f461: folds
Uncalled bet ($0.5) returned to 95083363
*** SHOWDOWN ***
95083363 collected $0.6 from pot
*** SUMMARY ***
Total pot $0.6
Seat 1: e814b201 (button) folded before Flop (didn't bet)
Seat 2: ba64e1 (small blind) folded before Flop
Seat 3: 8c86f461 (big blind) folded before Flop
Seat 4: 95083363 collected ($0.6)
Seat 5: d80f1bfd folded before Flop (didn't bet)
Seat 6: Hero folded before Flop (didn't bet)


Poker Hand #RC95080223: Hold'em No Limit ($0.1/$0.25) - 2020/04/07 15:06:39
Table 'RushAndCash363194' 6-max Seat #1 is the button
Seat 1: ba64e1 ($11.65 in chips)
Seat 2: Hero ($25.04 in chips)
Seat 3: 29100105 ($30.73 in chips)
Seat 4: f172d4cc ($64.06 in chips)
Seat 5: 3ff56a6c ($24.9 in chips)
Seat 6: 1a41ed0b ($25.35 in chips)
Hero: posts small blind $0.1
29100105: posts big blind $0.25
*** HOLE CARDS ***
Dealt to ba64e1 
Dealt to Hero [9d 5c]
Dealt to 29100105 
Dealt to f172d4cc 
Dealt to 3ff56a6c 
Dealt to 1a41ed0b 
f172d4cc: folds
3ff56a6c: folds
1a41ed0b: raises $0.75 to $1
ba64e1: folds
Hero: folds
29100105: folds
Uncalled bet ($0.75) returned to 1a41ed0b
*** SHOWDOWN ***
1a41ed0b collected $0.6 from pot
*** SUMMARY ***
Total pot $0.6
Seat 1: ba64e1 (button) folded before Flop (didn't bet)
Seat 2: Hero (small blind) folded before Flop
Seat 3: 29100105 (big blind) folded before Flop
Seat 4: f172d4cc folded before Flop (didn't bet)
Seat 5: 3ff56a6c folded before Flop (didn't bet)
Seat 6: 1a41ed0b collected ($0.6)


Poker Hand #RC95080259: Hold'em No Limit ($0.1/$0.25) - 2020/04/07 15:06:43
Table 'RushAndCash363198' 6-max Seat #1 is the button
Seat 1: a4ba858f ($25.25 in chips)
Seat 2: 90ddca47 ($25 in chips)
Seat 3: 3ff56a6c ($24.9 in chips)
Seat 4: 605bdd57 ($12.5 in chips)
Seat 5: ba64e1 ($11.65 in chips)
Seat 6: Hero ($25 in chips)
90ddca47: posts small blind $0.1
3ff56a6c: posts big blind $0.25
*** HOLE CARDS ***
Dealt to a4ba858f 
Dealt to 90ddca47 
Dealt to 3ff56a6c 
Dealt to 605bdd57 
Dealt to ba64e1 
Dealt to Hero [Jd 7h]
605bdd57: folds
ba64e1: folds
Hero: folds
a4ba858f: folds
90ddca47: raises $0.5 to $0.75
3ff56a6c: calls $0.5
*** FLOP *** [9s 5d 8h]
90ddca47: checks
3ff56a6c: bets $1
90ddca47: folds
Uncalled bet ($1) returned to 3ff56a6c
*** SHOWDOWN ***
3ff56a6c collected $1.5 from pot
*** SUMMARY ***
Total pot $1.5
Board [9s 5d 8h]
Seat 1: a4ba858f (button) folded before Flop (didn't bet)
Seat 2: 90ddca47 (small blind) folded on the Flop
Seat 3: 3ff56a6c (big blind) won ($1.5)
Seat 4: 605bdd57 folded before Flop (didn't bet)
Seat 5: ba64e1 folded before Flop (didn't bet)
Seat 6: Hero folded before Flop (didn't bet)


Poker Hand #RC95080293: Hold'em No Limit ($0.1/$0.25) - 2020/04/07 15:06:47
Table 'RushAndCash363203' 6-max Seat #1 is the button
Seat 1: 704c37d9 ($57.51 in chips)
Seat 2: 29100105 ($30.48 in chips)
Seat 3: bfa55601 ($12.5 in chips)
Seat 4: 45920dbc ($52.75 in chips)
Seat 5: a4ba858f ($25.25 in chips)
Seat 6: Hero ($25 in chips)
29100105: posts small blind $0.1
bfa55601: posts big blind $0.25
*** HOLE CARDS ***
Dealt to 704c37d9 
Dealt to 29100105 
Dealt to bfa55601 
Dealt to 45920dbc 
Dealt to a4ba858f 
Dealt to Hero [Jh 4c]
45920dbc: folds
a4ba858f: folds
Hero: folds
704c37d9: folds
29100105: folds
Uncalled bet ($0.15) returned to bfa55601
*** SHOWDOWN ***
bfa55601 collected $0.2 from pot
*** SUMMARY ***
Total pot $0.2
Seat 1: 704c37d9 (button) folded before Flop (didn't bet)
Seat 2: 29100105 (small blind) folded before Flop
Seat 3: bfa55601 (big blind) collected ($0.2)
Seat 4: 45920dbc folded before Flop (didn't bet)
Seat 5: a4ba858f folded before Flop (didn't bet)
Seat 6: Hero folded before Flop (didn't bet)


Poker Hand #RC95080347: Hold'em No Limit ($0.1/$0.25) - 2020/04/07 15:06:54
Table 'RushAndCash363212' 6-max Seat #1 is the button
Seat 1: 1a41ed0b ($25.6 in chips)
Seat 2: Hero ($25 in chips)
Seat 3: caa68458 ($25.25 in chips)
Seat 4: 258d376e ($25.57 in chips)
Seat 5: 966446c2 ($22.41 in chips)
Seat 6: 89387862 ($29.88 in chips)
Hero: posts small blind $0.1
caa68458: posts big blind $0.25
*** HOLE CARDS ***
Dealt to 1a41ed0b 
Dealt to Hero [Kd 4d]
Dealt to caa68458 
Dealt to 258d376e 
Dealt to 966446c2 
Dealt to 89387862 
258d376e: raises $0.38 to $0.63
966446c2: folds
89387862: folds
1a41ed0b: folds
Hero: folds
caa68458: folds
Uncalled bet ($0.38) returned to 258d376e
*** SHOWDOWN ***
258d376e collected $0.6 from pot
*** SUMMARY ***
Total pot $0.6
Seat 1: 1a41ed0b (button) folded before Flop (didn't bet)
Seat 2: Hero (small blind) folded before Flop
Seat 3: caa68458 (big blind) folded before Flop
Seat 4: 258d376e collected ($0.6)
Seat 5: 966446c2 folded before Flop (didn't bet)
Seat 6: 89387862 folded before Flop (didn't bet)


Poker Hand #RC95080379: Hold'em No Limit ($0.1/$0.25) - 2020/04/07 15:06:59
Table 'RushAndCash363216' 6-max Seat #1 is the button
Seat 1: Hero ($25 in chips)
Seat 2: d437c92d ($24.4 in chips)
Seat 3: 1a41ed0b ($25.6 in chips)
Seat 4: 65837850 ($147.47 in chips)
Seat 5: 704c37d9 ($57.51 in chips)
Seat 6: ce59b684 ($34.84 in chips)
d437c92d: posts small blind $0.1
1a41ed0b: posts big blind $0.25
*** HOLE CARDS ***
Dealt to Hero [4c 3h]
Dealt to d437c92d 
Dealt to 1a41ed0b 
Dealt to 65837850 
Dealt to 704c37d9 
Dealt to ce59b684 
65837850: folds
704c37d9: raises $0.38 to $0.63
ce59b684: folds
Hero: folds
d437c92d: folds
1a41ed0b: folds
Uncalled bet ($0.38) returned to 704c37d9
*** SHOWDOWN ***
704c37d9 collected $0.6 from pot
*** SUMMARY ***
Total pot $0.6
Seat 1: Hero (button) folded before Flop (didn't bet)
Seat 2: d437c92d (small blind) folded before Flop
Seat 3: 1a41ed0b (big blind) folded before Flop
Seat 4: 65837850 folded before Flop (didn't bet)
Seat 5: 704c37d9 collected ($0.6)
Seat 6: ce59b684 folded before Flop (didn't bet)


Poker Hand #RC95080470: Hold'em No Limit ($0.1/$0.25) - 2020/04/07 15:07:11
Table 'RushAndCash363229' 6-max Seat #1 is the button
Seat 1: f9ba2d22 ($24.08 in chips)
Seat 2: 32953d2a ($14.7 in chips)
Seat 3: Hero ($25 in chips)
Seat 4: d84d476b ($25.57 in chips)
Seat 5: 2d45ce80 ($9.48 in chips)
Seat 6: d07b3de1 ($31.52 in chips)
32953d2a: posts small blind $0.1
Hero: posts big blind $0.25
*** HOLE CARDS ***
Dealt to f9ba2d22 
Dealt to 32953d2a 
Dealt to Hero [Js 2h]
Dealt to d84d476b 
Dealt to 2d45ce80 
Dealt to d07b3de1 
d84d476b: folds
2d45ce80: folds
d07b3de1: raises $0.25 to $0.5
f9ba2d22: calls $0.5
32953d2a: folds
Hero: folds
*** FLOP *** [6s 4d 2s]
d07b3de1: checks
f9ba2d22: checks
*** TURN *** [6s 4d 2s] [9d]
d07b3de1: checks
f9ba2d22: bets $1.1
d07b3de1: folds
Uncalled bet ($1.1) returned to f9ba2d22
*** SHOWDOWN ***
f9ba2d22 collected $1.35 from pot
*** SUMMARY ***
Total pot $1.35
Board [6s 4d 2s 9d]
Seat 1: f9ba2d22 (button) won ($1.35)
Seat 2: 32953d2a (small blind) folded before Flop
Seat 3: Hero (big blind) folded before Flop
Seat 4: d84d476b folded before Flop (didn't bet)
Seat 5: 2d45ce80 folded before Flop (didn't bet)
Seat 6: d07b3de1 folded on the Turn


Poker Hand #RC95080511: Hold'em No Limit ($0.1/$0.25) - 2020/04/07 15:07:16
Table 'RushAndCash363236' 6-max Seat #1 is the button
Seat 1: bda1b4ce ($25.67 in chips)
Seat 2: 8b8d197c ($26.69 in chips)
Seat 3: 103129d8 ($23.57 in chips)
Seat 4: d2986703 ($34.92 in chips)
Seat 5: cae4d8ce ($12.64 in chips)
Seat 6: Hero ($25 in chips)
8b8d197c: posts small blind $0.1
103129d8: posts big blind $0.25
*** HOLE CARDS ***
Dealt to bda1b4ce 
Dealt to 8b8d197c 
Dealt to 103129d8 
Dealt to d2986703 
Dealt to cae4d8ce 
Dealt to Hero [8d 2s]
d2986703: folds
cae4d8ce: raises $0.38 to $0.63
Hero: folds
bda1b4ce: calls $0.63
8b8d197c: folds
103129d8: folds
*** FLOP *** [5s Ad 4s]
cae4d8ce: bets $0.6
bda1b4ce: folds
Uncalled bet ($0.6) returned to cae4d8ce
*** SHOWDOWN ***
cae4d8ce collected $1.61 from pot
*** SUMMARY ***
Total pot $1.61
Board [5s Ad 4s]
Seat 1: bda1b4ce (button) folded on the Flop
Seat 2: 8b8d197c (small blind) folded before Flop
Seat 3: 103129d8 (big blind) folded before Flop
Seat 4: d2986703 folded before Flop (didn't bet)
Seat 5: cae4d8ce won ($1.61)
Seat 6: Hero folded before Flop (didn't bet)


Poker Hand #RC95080542: Hold'em No Limit ($0.1/$0.25) - 2020/04/07 15:07:20
Table 'RushAndCash363241' 6-max Seat #1 is the button
Seat 1: f322483e ($28.78 in chips)
Seat 2: d84d476b ($25.57 in chips)
Seat 3: 89387862 ($29.88 in chips)
Seat 4: 36017ad1 ($25.87 in chips)
Seat 5: Hero ($25 in chips)
Seat 6: 4ab4e4a3 ($25.42 in chips)
d84d476b: posts small blind $0.1
89387862: posts big blind $0.25
*** HOLE CARDS ***
Dealt to f322483e 
Dealt to d84d476b 
Dealt to 89387862 
Dealt to 36017ad1 
Dealt to Hero [7c 4d]
Dealt to 4ab4e4a3 
36017ad1: folds
Hero: folds
4ab4e4a3: folds
f322483e: folds
d84d476b: folds
Uncalled bet ($0.15) returned to 89387862
*** SHOWDOWN ***
89387862 collected $0.2 from pot
*** SUMMARY ***
Total pot $0.2
Seat 1: f322483e (button) folded before Flop (didn't bet)
Seat 2: d84d476b (small blind) folded before Flop
Seat 3: 89387862 (big blind) collected ($0.2)
Seat 4: 36017ad1 folded before Flop (didn't bet)
Seat 5: Hero folded before Flop (didn't bet)
Seat 6: 4ab4e4a3 folded before Flop (didn't bet)


Poker Hand #RC95080571: Hold'em No Limit ($0.1/$0.25) - 2020/04/07 15:07:24
Table 'RushAndCash363245' 6-max Seat #1 is the button
Seat 1: 20b62793 ($62.58 in chips)
Seat 2: 50ccb9a1 ($23.14 in chips)
Seat 3: 275e7f74 ($28.65 in chips)
Seat 4: 2c9e9ffe ($18.99 in chips)
Seat 5: Hero ($25 in chips)
Seat 6: 3ff56a6c ($25.58 in chips)
50ccb9a1: posts small blind $0.1
275e7f74: posts big blind $0.25
*** HOLE CARDS ***
Dealt to 20b62793 
Dealt to 50ccb9a1 
Dealt to 275e7f74 
Dealt to 2c9e9ffe 
Dealt to Hero [As 2c]
Dealt to 3ff56a6c 
2c9e9ffe: folds
Hero: folds
3ff56a6c: folds
20b62793: raises $0.5 to $0.75
50ccb9a1: folds
275e7f74: calls $0.5
*** FLOP *** [Ad 8d 8s]
275e7f74: checks
20b62793: bets $1.2
275e7f74: folds
Uncalled bet ($1.2) returned to 20b62793
*** SHOWDOWN ***
20b62793 collected $1.6 from pot
*** SUMMARY ***
Total pot $1.6
Board [Ad 8d 8s]
Seat 1: 20b62793 (button) won ($1.6)
Seat 2: 50ccb9a1 (small blind) folded before Flop
Seat 3: 275e7f74 (big blind) folded on the Flop
Seat 4: 2c9e9ffe folded before Flop (didn't bet)
Seat 5: Hero folded before Flop (didn't bet)
Seat 6: 3ff56a6c folded before Flop (didn't bet)


Poker Hand #RC95080601: Hold'em No Limit ($0.1/$0.25) - 2020/04/07 15:07:27
Table 'RushAndCash363250' 6-max Seat #1 is the button
Seat 1: 9f803cc2 ($26.17 in chips)
Seat 2: Hero ($25 in chips)
Seat 3: 5d360146 ($15.85 in chips)
Seat 4: 18075352 ($27.14 in chips)
Seat 5: 4ab4e4a3 ($25.42 in chips)
Seat 6: 5794e88f ($25.26 in chips)
Hero: posts small blind $0.1
5d360146: posts big blind $0.25
*** HOLE CARDS ***
Dealt to 9f803cc2 
Dealt to Hero [Jc 5s]
Dealt to 5d360146 
Dealt to 18075352 
Dealt to 4ab4e4a3 
Dealt to 5794e88f 
18075352: folds
4ab4e4a3: folds
5794e88f: raises $0.38 to $0.63
9f803cc2: folds
Hero: folds
5d360146: calls $0.38
*** FLOP *** [Ac 8s Qd]
5d360146: checks
5794e88f: bets $0.5
5d360146: folds
Uncalled bet ($0.5) returned to 5794e88f
*** SHOWDOWN ***
5794e88f collected $1.36 from pot
*** SUMMARY ***
Total pot $1.36
Board [Ac 8s Qd]
Seat 1: 9f803cc2 (button) folded before Flop (didn't bet)
Seat 2: Hero (small blind) folded before Flop
Seat 3: 5d360146 (big blind) folded on the Flop
Seat 4: 18075352 folded before Flop (didn't bet)
Seat 5: 4ab4e4a3 folded before Flop (didn't bet)
Seat 6: 5794e88f won ($1.36)


Poker Hand #RC95080695: Hold'em No Limit ($0.1/$0.25) - 2020/04/07 15:07:38
Table 'RushAndCash363264' 6-max Seat #1 is the button
Seat 1: 528a07f8 ($33.03 in chips)
Seat 2: f44f8c27 ($33.03 in chips)
Seat 3: Hero ($25 in chips)
Seat 4: 244f5d59 ($14.31 in chips)
Seat 5: 45920dbc ($52.85 in chips)
Seat 6: d80f1bfd ($12.5 in chips)
f44f8c27: posts small blind $0.1
Hero: posts big blind $0.25
*** HOLE CARDS ***
Dealt to 528a07f8 
Dealt to f44f8c27 
Dealt to Hero [9h 8h]
Dealt to 244f5d59 
Dealt to 45920dbc 
Dealt to d80f1bfd 
244f5d59: raises $0.38 to $0.63
45920dbc: folds
d80f1bfd: folds
528a07f8: folds
f44f8c27: folds
Hero: calls $0.38
*** FLOP *** [9d Th Jc]
Hero: checks
244f5d59: bets $0.95
Hero: calls $0.95
*** TURN *** [9d Th Jc] [Qc]
Hero: checks
244f5d59: checks
*** RIVER *** [9d Th Jc Qc] [5s]
Hero: bets $2.5
244f5d59: folds
Uncalled bet ($2.5) returned to Hero
*** SHOWDOWN ***
Hero collected $3.26 from pot
*** SUMMARY ***
Total pot $3.26
Board [9d Th Jc Qc 5s]
Seat 1: 528a07f8 (button) folded before Flop (didn't bet)
Seat 2: f44f8c27 (small blind) folded before Flop
Seat 3: Hero (big blind) won ($3.26)
Seat 4: 244f5d59 folded on the River
Seat 5: 45920dbc folded before Flop (didn't bet)
Seat 6: d80f1bfd folded before Flop (didn't bet)


Poker Hand #RC95081077: Hold'em No Limit ($0.1/$0.25) - 2020/04/07 15:08:24
Table 'RushAndCash363318' 6-max Seat #1 is the button
Seat 1: Hero ($26.52 in chips)
Seat 2: 289f2e46 ($45.73 in chips)
Seat 3: deb69778 ($32.13 in chips)
Seat 4: 2c9e9ffe ($19.42 in chips)
Seat 5: bda1b4ce ($25.04 in chips)
Seat 6: 244f5d59 ($12.73 in chips)
289f2e46: posts small blind $0.1
deb69778: posts big blind $0.25
*** HOLE CARDS ***
Dealt to Hero [7h 6s]
Dealt to 289f2e46 
Dealt to deb69778 
Dealt to 2c9e9ffe 
Dealt to bda1b4ce 
Dealt to 244f5d59 
2c9e9ffe: raises $0.5 to $0.75
bda1b4ce: folds
244f5d59: folds
Hero: folds
289f2e46: folds
deb69778: folds
Uncalled bet ($0.5) returned to 2c9e9ffe
*** SHOWDOWN ***
2c9e9ffe collected $0.6 from pot
*** SUMMARY ***
Total pot $0.6
Seat 1: Hero (button) folded before Flop (didn't bet)
Seat 2: 289f2e46 (small blind) folded before Flop
Seat 3: deb69778 (big blind) folded before Flop
Seat 4: 2c9e9ffe collected ($0.6)
Seat 5: bda1b4ce folded before Flop (didn't bet)
Seat 6: 244f5d59 folded before Flop (didn't bet)


Poker Hand #RC95081113: Hold'em No Limit ($0.1/$0.25) - 2020/04/07 15:08:28
Table 'RushAndCash363325' 6-max Seat #1 is the button
Seat 1: 2b973722 ($25 in chips)
Seat 2: 244f5d59 ($12.73 in chips)
Seat 3: 45920dbc ($52.6 in chips)
Seat 4: Hero ($26.52 in chips)
Seat 5: c86cf70b ($34.22 in chips)
Seat 6: 103129d8 ($22.97 in chips)
244f5d59: posts small blind $0.1
45920dbc: posts big blind $0.25
*** HOLE CARDS ***
Dealt to 2b973722 
Dealt to 244f5d59 
Dealt to 45920dbc 
Dealt to Hero [Ac Js]
Dealt to c86cf70b 
Dealt to 103129d8 
Hero: raises $0.38 to $0.63
c86cf70b: folds
103129d8: calls $0.63
2b973722: folds
244f5d59: calls $0.53
45920dbc: folds
*** FLOP *** [8h 6c Td]
244f5d59: checks
Hero: checks
103129d8: bets $1.1
244f5d59: calls $1.1
Hero: folds
*** TURN *** [8h 6c Td] [Qd]
244f5d59: checks
103129d8: checks
*** RIVER *** [8h 6c Td Qd] [Ks]
244f5d59: checks
103129d8: checks
244f5d59: shows [9h Th] (Pair of Tens)
103129d8: shows [3d 6d] (Pair of Sixes)
*** SHOWDOWN ***
244f5d59 collected $4.34 from pot
*** SUMMARY ***
Total pot $4.34
Board [8h 6c Td Qd Ks]
Seat 1: 2b973722 (button) folded before Flop (didn't bet)
Seat 2: 244f5d59 (small blind) showed [Th 9h] and won ($4.34) with Pair of Tens
Seat 3: 45920dbc (big blind) folded before Flop
Seat 4: Hero folded on the Flop
Seat 5: c86cf70b folded before Flop (didn't bet)
Seat 6: 103129d8 showed [6d 3d] and lost with Pair of Sixes


Poker Hand #RC95081520: Hold'em No Limit ($0.1/$0.25) - 2020/04/07 15:09:18
Table 'RushAndCash363386' 6-max Seat #1 is the button
Seat 1: da0bf932 ($16.13 in chips)
Seat 2: cc092a76 ($12.16 in chips)
Seat 3: 244f5d59 ($15.13 in chips)
Seat 4: 3cfd7308 ($40.31 in chips)
Seat 5: Hero ($25.89 in chips)
Seat 6: 103129d8 ($21.24 in chips)
cc092a76: posts small blind $0.1
244f5d59: posts big blind $0.25
*** HOLE CARDS ***
Dealt to da0bf932 
Dealt to cc092a76 
Dealt to 244f5d59 
Dealt to 3cfd7308 
Dealt to Hero [Th 5h]
Dealt to 103129d8 
3cfd7308: folds
Hero: folds
103129d8: calls $0.25
da0bf932: folds
cc092a76: calls $0.15
244f5d59: checks
*** FLOP *** [9s 6d Ad]
cc092a76: checks
244f5d59: checks
103129d8: checks
*** TURN *** [9s 6d Ad] [Kd]
cc092a76: checks
244f5d59: bets $0.4
103129d8: folds
cc092a76: calls $0.4
*** RIVER *** [9s 6d Ad Kd] [4c]
cc092a76: checks
244f5d59: checks
cc092a76: shows [5d 8h] (Ace-High)
244f5d59: shows [Kc Jd] (Pair of Kings)
*** SHOWDOWN ***
244f5d59 collected $1.55 from pot
*** SUMMARY ***
Total pot $1.55
Board [9s 6d Ad Kd 4c]
Seat 1: da0bf932 (button) folded before Flop (didn't bet)
Seat 2: cc092a76 (small blind) showed [8h 5d] and lost with Ace-High
Seat 3: 244f5d59 (big blind) showed [Kc Jd] and won ($1.55) with Pair of Kings
Seat 4: 3cfd7308 folded before Flop (didn't bet)
Seat 5: Hero folded before Flop (didn't bet)
Seat 6: 103129d8 folded on the Turn


Poker Hand #RC95081551: Hold'em No Limit ($0.1/$0.25) - 2020/04/07 15:09:22
Table 'RushAndCash363391' 6-max Seat #1 is the button
Seat 1: f172d4cc ($64.18 in chips)
Seat 2: 7c935d24 ($25.68 in chips)
Seat 3: f44f8c27 ($35.9 in chips)
Seat 4: a6fc3bd6 ($25.37 in chips)
Seat 5: Hero ($25.89 in chips)
Seat 6: 605bdd57 ($12.5 in chips)
7c935d24: posts small blind $0.1
f44f8c27: posts big blind $0.25
*** HOLE CARDS ***
Dealt to f172d4cc 
Dealt to 7c935d24 
Dealt to f44f8c27 
Dealt to a6fc3bd6 
Dealt to Hero [Kc 8s]
Dealt to 605bdd57 
a6fc3bd6: folds
Hero: folds
605bdd57: folds
f172d4cc: raises $0.38 to $0.63
7c935d24: folds
f44f8c27: folds
Uncalled bet ($0.38) returned to f172d4cc
*** SHOWDOWN ***
f172d4cc collected $0.6 from pot
*** SUMMARY ***
Total pot $0.6
Seat 1: f172d4cc (button) collected ($0.6)
Seat 2: 7c935d24 (small blind) folded before Flop
Seat 3: f44f8c27 (big blind) folded before Flop
Seat 4: a6fc3bd6 folded before Flop (didn't bet)
Seat 5: Hero folded before Flop (didn't bet)
Seat 6: 605bdd57 folded before Flop (didn't bet)


Poker Hand #RC95081585: Hold'em No Limit ($0.1/$0.25) - 2020/04/07 15:09:25
Table 'RushAndCash363396' 6-max Seat #1 is the button
Seat 1: 4ab4e4a3 ($30.41 in chips)
Seat 2: accea393 ($41.47 in chips)
Seat 3: 6d46dd9d ($25 in chips)
Seat 4: 2609e300 ($12.5 in chips)
Seat 5: dbf6981f ($36.8 in chips)
Seat 6: Hero ($25.89 in chips)
accea393: posts small blind $0.1
6d46dd9d: posts big blind $0.25
*** HOLE CARDS ***
Dealt to 4ab4e4a3 
Dealt to accea393 
Dealt to 6d46dd9d 
Dealt to 2609e300 
Dealt to dbf6981f 
Dealt to Hero [Kh 8c]
2609e300: folds
dbf6981f: folds
Hero: folds
4ab4e4a3: raises $0.5 to $0.75
accea393: folds
6d46dd9d: folds
Uncalled bet ($0.5) returned to 4ab4e4a3
*** SHOWDOWN ***
4ab4e4a3 collected $0.6 from pot
*** SUMMARY ***
Total pot $0.6
Seat 1: 4ab4e4a3 (button) collected ($0.6)
Seat 2: accea393 (small blind) folded before Flop
Seat 3: 6d46dd9d (big blind) folded before Flop
Seat 4: 2609e300 folded before Flop (didn't bet)
Seat 5: dbf6981f folded before Flop (didn't bet)
Seat 6: Hero folded before Flop (didn't bet)


Poker Hand #RC95081649: Hold'em No Limit ($0.1/$0.25) - 2020/04/07 15:09:33
Table 'RushAndCash363404' 6-max Seat #1 is the button
Seat 1: 887f8eab ($4 in chips)
Seat 2: 2609e300 ($12.5 in chips)
Seat 3: Hero ($25.89 in chips)
Seat 4: 1a41ed0b ($26.27 in chips)
Seat 5: 36017ad1 ($25.35 in chips)
Seat 6: 18075352 ($26.79 in chips)
2609e300: posts small blind $0.1
Hero: posts big blind $0.25
*** HOLE CARDS ***
Dealt to 887f8eab 
Dealt to 2609e300 
Dealt to Hero [Jh 7c]
Dealt to 1a41ed0b 
Dealt to 36017ad1 
Dealt to 18075352 
1a41ed0b: folds
36017ad1: folds
18075352: folds
887f8eab: folds
2609e300: folds
Uncalled bet ($0.15) returned to Hero
*** SHOWDOWN ***
Hero collected $0.2 from pot
*** SUMMARY ***
Total pot $0.2
Seat 1: 887f8eab (button) folded before Flop (didn't bet)
Seat 2: 2609e300 (small blind) folded before Flop
Seat 3: Hero (big blind) collected ($0.2)
Seat 4: 1a41ed0b folded before Flop (didn't bet)
Seat 5: 36017ad1 folded before Flop (didn't bet)
Seat 6: 18075352 folded before Flop (didn't bet)


Poker Hand #RC95081685: Hold'em No Limit ($0.1/$0.25) - 2020/04/07 15:09:38
Table 'RushAndCash363408' 6-max Seat #1 is the button
Seat 1: 8db504d0 ($17.7 in chips)
Seat 2: Hero ($25.64 in chips)
Seat 3: 476775f5 ($15.16 in chips)
Seat 4: 1a41ed0b ($26.27 in chips)
Seat 5: 18075352 ($26.79 in chips)
Seat 6: 9f138297 ($31.41 in chips)
Hero: posts small blind $0.1
476775f5: posts big blind $0.25
*** HOLE CARDS ***
Dealt to 8db504d0 
Dealt to Hero [Ah Th]
Dealt to 476775f5 
Dealt to 1a41ed0b 
Dealt to 18075352 
Dealt to 9f138297 
1a41ed0b: folds
18075352: folds
9f138297: folds
8db504d0: folds
Hero: raises $0.5 to $0.75
476775f5: folds
Uncalled bet ($0.5) returned to Hero
*** SHOWDOWN ***
Hero collected $0.5 from pot
*** SUMMARY ***
Total pot $0.5
Seat 1: 8db504d0 (button) folded before Flop (didn't bet)
Seat 2: Hero (small blind) collected ($0.5)
Seat 3: 476775f5 (big blind) folded before Flop
Seat 4: 1a41ed0b folded before Flop (didn't bet)
Seat 5: 18075352 folded before Flop (didn't bet)
Seat 6: 9f138297 folded before Flop (didn't bet)


Poker Hand #RC95081880: Hold'em No Limit ($0.1/$0.25) - 2020/04/07 15:10:01
Table 'RushAndCash363434' 6-max Seat #1 is the button
Seat 1: Hero ($26.24 in chips)
Seat 2: d437c92d ($23.82 in chips)
Seat 3: 454abe8b ($25.71 in chips)
Seat 4: 7ac43878 ($17.18 in chips)
Seat 5: ba64e1 ($12.1 in chips)
Seat 6: 3abc34ff ($25 in chips)
d437c92d: posts small blind $0.1
454abe8b: posts big blind $0.25
*** HOLE CARDS ***
Dealt to Hero [Th 2h]
Dealt to d437c92d 
Dealt to 454abe8b 
Dealt to 7ac43878 
Dealt to ba64e1 
Dealt to 3abc34ff 
7ac43878: folds
ba64e1: raises $0.25 to $0.5
3abc34ff: folds
Hero: folds
d437c92d: calls $0.4
454abe8b: folds
*** FLOP *** [3h Jc 9h]
d437c92d: bets $1
ba64e1: calls $1
*** TURN *** [3h Jc 9h] [6c]
d437c92d: bets $22.32 and is all-in
ba64e1: calls $10.6 and is all-in
Uncalled bet ($11.72) returned to d437c92d
d437c92d: shows [Ts Kd] (King-High)
ba64e1: shows [Js Ah] (Pair of Jacks)
*** RIVER *** [3h Jc 9h 6c] [Qc]
*** SHOWDOWN ***
d437c92d collected $24.45 from pot
*** SUMMARY ***
Total pot $24.45
Board [3h Jc 9h 6c Qc]
Seat 1: Hero (button) folded before Flop (didn't bet)
Seat 2: d437c92d (small blind) showed [Kd Ts] and won ($24.45) with Kings-High Straight
Seat 3: 454abe8b (big blind) folded before Flop
Seat 4: 7ac43878 folded before Flop (didn't bet)
Seat 5: ba64e1 showed [Ah Js] and lost with Pair of Jacks
Seat 6: 3abc34ff folded before Flop (didn't bet)


Poker Hand #RC95081926: Hold'em No Limit ($0.1/$0.25) - 2020/04/07 15:10:07
Table 'RushAndCash363441' 6-max Seat #1 is the button
Seat 1: dbf6981f ($36.55 in chips)
Seat 2: 95083363 ($30.67 in chips)
Seat 3: 61ad32d ($22.07 in chips)
Seat 4: c88456c4 ($14.27 in chips)
Seat 5: 275e7f74 ($27.65 in chips)
Seat 6: Hero ($26.24 in chips)
95083363: posts small blind $0.1
61ad32d: posts big blind $0.25
*** HOLE CARDS ***
Dealt to dbf6981f 
Dealt to 95083363 
Dealt to 61ad32d 
Dealt to c88456c4 
Dealt to 275e7f74 
Dealt to Hero [Tc 5s]
c88456c4: raises $0.38 to $0.63
275e7f74: folds
Hero: folds
dbf6981f: folds
95083363: folds
61ad32d: folds
Uncalled bet ($0.38) returned to c88456c4
*** SHOWDOWN ***
c88456c4 collected $0.6 from pot
*** SUMMARY ***
Total pot $0.6
Seat 1: dbf6981f (button) folded before Flop (didn't bet)
Seat 2: 95083363 (small blind) folded before Flop
Seat 3: 61ad32d (big blind) folded before Flop
Seat 4: c88456c4 collected ($0.6)
Seat 5: 275e7f74 folded before Flop (didn't bet)
Seat 6: Hero folded before Flop (didn't bet)


Poker Hand #RC95081953: Hold'em No Limit ($0.1/$0.25) - 2020/04/07 15:10:10
Table 'RushAndCash363445' 6-max Seat #1 is the button
Seat 1: d59ed63d ($10.42 in chips)
Seat 2: accea393 ($40.62 in chips)
Seat 3: cc092a76 ($11.51 in chips)
Seat 4: a6fc3bd6 ($26.04 in chips)
Seat 5: 45920dbc ($51.2 in chips)
Seat 6: Hero ($26.24 in chips)
accea393: posts small blind $0.1
cc092a76: posts big blind $0.25
*** HOLE CARDS ***
Dealt to d59ed63d 
Dealt to accea393 
Dealt to cc092a76 
Dealt to a6fc3bd6 
Dealt to 45920dbc 
Dealt to Hero [9d 3h]
a6fc3bd6: folds
45920dbc: folds
Hero: folds
d59ed63d: raises $0.25 to $0.5
accea393: folds
cc092a76: calls $0.25
*** FLOP *** [5d 2d 9c]
cc092a76: bets $0.6
d59ed63d: calls $0.6
*** TURN *** [5d 2d 9c] [4d]
cc092a76: bets $1.8
d59ed63d: calls $1.8
*** RIVER *** [5d 2d 9c 4d] [Qd]
cc092a76: checks
d59ed63d: checks
cc092a76: shows [2s Ac] (Pair of Twos)
d59ed63d: shows [9h 8c] (Pair of Nines)
*** SHOWDOWN ***
d59ed63d collected $5.9 from pot
*** SUMMARY ***
Total pot $5.9
Board [5d 2d 9c 4d Qd]
Seat 1: d59ed63d (button) showed [9h 8c] and won ($5.9) with Pair of Nines
Seat 2: accea393 (small blind) folded before Flop
Seat 3: cc092a76 (big blind) showed [Ac 2s] and lost with Pair of Twos
Seat 4: a6fc3bd6 folded before Flop (didn't bet)
Seat 5: 45920dbc folded before Flop (didn't bet)
Seat 6: Hero folded before Flop (didn't bet)


Poker Hand #RC95081982: Hold'em No Limit ($0.1/$0.25) - 2020/04/07 15:10:13
Table 'RushAndCash363449' 6-max Seat #1 is the button
Seat 1: 518d077e ($25.7 in chips)
Seat 2: Hero ($26.24 in chips)
Seat 3: ce59b684 ($34.74 in chips)
Seat 4: 36017ad1 ($25 in chips)
Seat 5: 704c37d9 ($54.48 in chips)
Seat 6: 887f8eab ($3.65 in chips)
Hero: posts small blind $0.1
ce59b684: posts big blind $0.25
*** HOLE CARDS ***
Dealt to 518d077e 
Dealt to Hero [Qh 9h]
Dealt to ce59b684 
Dealt to 36017ad1 
Dealt to 704c37d9 
Dealt to 887f8eab 
36017ad1: folds
704c37d9: folds
887f8eab: raises $3.4 to $3.65 and is all-in
518d077e: folds
Hero: folds
ce59b684: folds
Uncalled bet ($3.4) returned to 887f8eab
*** SHOWDOWN ***
887f8eab collected $0.6 from pot
*** SUMMARY ***
Total pot $0.6
Seat 1: 518d077e (button) folded before Flop (didn't bet)
Seat 2: Hero (small blind) folded before Flop
Seat 3: ce59b684 (big blind) folded before Flop
Seat 4: 36017ad1 folded before Flop (didn't bet)
Seat 5: 704c37d9 folded before Flop (didn't bet)
Seat 6: 887f8eab collected ($0.6)


Poker Hand #RC95082090: Hold'em No Limit ($0.1/$0.25) - 2020/04/07 15:10:26
Table 'RushAndCash363465' 6-max Seat #1 is the button
Seat 1: 7bf7c8c9 ($28.26 in chips)
Seat 2: 2d45ce80 ($11.37 in chips)
Seat 3: Hero ($26.14 in chips)
Seat 4: 3f5f9735 ($19.57 in chips)
Seat 5: c88456c4 ($14.62 in chips)
Seat 6: 5d360146 ($15.51 in chips)
2d45ce80: posts small blind $0.1
Hero: posts big blind $0.25
*** HOLE CARDS ***
Dealt to 7bf7c8c9 
Dealt to 2d45ce80 
Dealt to Hero [5c 4c]
Dealt to 3f5f9735 
Dealt to c88456c4 
Dealt to 5d360146 
3f5f9735: folds
c88456c4: folds
5d360146: raises $0.5 to $0.75
7bf7c8c9: folds
2d45ce80: raises $1.75 to $2.5
Hero: folds
5d360146: raises $2.5 to $5
2d45ce80: calls $2.5
*** FLOP *** [8s 3c 8c]
2d45ce80: checks
5d360146: bets $10.3
2d45ce80: folds
Uncalled bet ($10.3) returned to 5d360146
*** SHOWDOWN ***
5d360146 collected $10.25 from pot
*** SUMMARY ***
Total pot $10.25
Board [8s 3c 8c]
Seat 1: 7bf7c8c9 (button) folded before Flop (didn't bet)
Seat 2: 2d45ce80 (small blind) folded on the Flop
Seat 3: Hero (big blind) folded before Flop
Seat 4: 3f5f9735 folded before Flop (didn't bet)
Seat 5: c88456c4 folded before Flop (didn't bet)
Seat 6: 5d360146 won ($10.25)


Poker Hand #RC95082129: Hold'em No Limit ($0.1/$0.25) - 2020/04/07 15:10:30
Table 'RushAndCash363471' 6-max Seat #1 is the button
Seat 1: 605bdd57 ($12.5 in chips)
Seat 2: fe3f48f4 ($26.36 in chips)
Seat 3: 528a07f8 ($31.9 in chips)
Seat 4: 8ebd1db4 ($34.52 in chips)
Seat 5: 887f8eab ($4 in chips)
Seat 6: Hero ($25.89 in chips)
fe3f48f4: posts small blind $0.1
528a07f8: posts big blind $0.25
*** HOLE CARDS ***
Dealt to 605bdd57 
Dealt to fe3f48f4 
Dealt to 528a07f8 
Dealt to 8ebd1db4 
Dealt to 887f8eab 
Dealt to Hero [Qd 2c]
8ebd1db4: folds
887f8eab: folds
Hero: folds
605bdd57: folds
fe3f48f4: raises $0.5 to $0.75
528a07f8: raises $1.5 to $2.25
fe3f48f4: folds
Uncalled bet ($1.5) returned to 528a07f8
*** SHOWDOWN ***
528a07f8 collected $1.5 from pot
*** SUMMARY ***
Total pot $1.5
Seat 1: 605bdd57 (button) folded before Flop (didn't bet)
Seat 2: fe3f48f4 (small blind) folded before Flop
Seat 3: 528a07f8 (big blind) collected ($1.5)
Seat 4: 8ebd1db4 folded before Flop (didn't bet)
Seat 5: 887f8eab folded before Flop (didn't bet)
Seat 6: Hero folded before Flop (didn't bet)


Poker Hand #RC95082164: Hold'em No Limit ($0.1/$0.25) - 2020/04/07 15:10:34
Table 'RushAndCash363477' 6-max Seat #1 is the button
Seat 1: Hero ($25.89 in chips)
Seat 2: be711e9d ($31.17 in chips)
Seat 3: f322483e ($28.25 in chips)
Seat 4: 3f5f9735 ($19.57 in chips)
Seat 5: d84d476b ($23.96 in chips)
Seat 6: accea393 ($40.27 in chips)
be711e9d: posts small blind $0.1
f322483e: posts big blind $0.25
*** HOLE CARDS ***
Dealt to Hero [9d 4d]
Dealt to be711e9d 
Dealt to f322483e 
Dealt to 3f5f9735 
Dealt to d84d476b 
Dealt to accea393 
3f5f9735: folds
d84d476b: folds
accea393: raises $0.5 to $0.75
Hero: folds
be711e9d: folds
f322483e: folds
Uncalled bet ($0.5) returned to accea393
*** SHOWDOWN ***
accea393 collected $0.6 from pot
*** SUMMARY ***
Total pot $0.6
Seat 1: Hero (button) folded before Flop (didn't bet)
Seat 2: be711e9d (small blind) folded before Flop
Seat 3: f322483e (big blind) folded before Flop
Seat 4: 3f5f9735 folded before Flop (didn't bet)
Seat 5: d84d476b folded before Flop (didn't bet)
Seat 6: accea393 collected ($0.6)


Poker Hand #RC95082185: Hold'em No Limit ($0.1/$0.25) - 2020/04/07 15:10:37
Table 'RushAndCash363480' 6-max Seat #1 is the button
Seat 1: 89387862 ($28.1 in chips)
Seat 2: 18633f97 ($11.75 in chips)
Seat 3: c88456c4 ($14.62 in chips)
Seat 4: 476775f5 ($15.16 in chips)
Seat 5: 32953d2a ($14.42 in chips)
Seat 6: Hero ($25.89 in chips)
18633f97: posts small blind $0.1
c88456c4: posts big blind $0.25
*** HOLE CARDS ***
Dealt to 89387862 
Dealt to 18633f97 
Dealt to c88456c4 
Dealt to 476775f5 
Dealt to 32953d2a 
Dealt to Hero [Jc 5s]
476775f5: folds
32953d2a: folds
Hero: folds
89387862: folds
18633f97: folds
Uncalled bet ($0.15) returned to c88456c4
*** SHOWDOWN ***
c88456c4 collected $0.2 from pot
*** SUMMARY ***
Total pot $0.2
Seat 1: 89387862 (button) folded before Flop (didn't bet)
Seat 2: 18633f97 (small blind) folded before Flop
Seat 3: c88456c4 (big blind) collected ($0.2)
Seat 4: 476775f5 folded before Flop (didn't bet)
Seat 5: 32953d2a folded before Flop (didn't bet)
Seat 6: Hero folded before Flop (didn't bet)


Poker Hand #RC95082242: Hold'em No Limit ($0.1/$0.25) - 2020/04/07 15:10:44
Table 'RushAndCash363489' 6-max Seat #1 is the button
Seat 1: 3f5f9735 ($19.57 in chips)
Seat 2: f44f8c27 ($36.21 in chips)
Seat 3: d2986703 ($36.85 in chips)
Seat 4: d07b3de1 ($31.44 in chips)
Seat 5: c86cf70b ($35.02 in chips)
Seat 6: Hero ($25.89 in chips)
f44f8c27: posts small blind $0.1
d2986703: posts big blind $0.25
*** HOLE CARDS ***
Dealt to 3f5f9735 
Dealt to f44f8c27 
Dealt to d2986703 
Dealt to d07b3de1 
Dealt to c86cf70b 
Dealt to Hero [8d 5s]
d07b3de1: folds
c86cf70b: folds
Hero: folds
3f5f9735: raises $0.5 to $0.75
f44f8c27: folds
d2986703: folds
Uncalled bet ($0.5) returned to 3f5f9735
*** SHOWDOWN ***
3f5f9735 collected $0.6 from pot
*** SUMMARY ***
Total pot $0.6
Seat 1: 3f5f9735 (button) collected ($0.6)
Seat 2: f44f8c27 (small blind) folded before Flop
Seat 3: d2986703 (big blind) folded before Flop
Seat 4: d07b3de1 folded before Flop (didn't bet)
Seat 5: c86cf70b folded before Flop (didn't bet)
Seat 6: Hero folded before Flop (didn't bet)


Poker Hand #RC95082269: Hold'em No Limit ($0.1/$0.25) - 2020/04/07 15:10:47
Table 'RushAndCash363492' 6-max Seat #1 is the button
Seat 1: Hero ($25.89 in chips)
Seat 2: e814b201 ($29.64 in chips)
Seat 3: e6c023d1 ($25 in chips)
Seat 4: 96eec3de ($40.77 in chips)
Seat 5: 18633f97 ($11.65 in chips)
Seat 6: b5d592d2 ($12.01 in chips)
e814b201: posts small blind $0.1
e6c023d1: posts big blind $0.25
*** HOLE CARDS ***
Dealt to Hero [Jd 5d]
Dealt to e814b201 
Dealt to e6c023d1 
Dealt to 96eec3de 
Dealt to 18633f97 
Dealt to b5d592d2 
96eec3de: folds
18633f97: folds
b5d592d2: folds
Hero: folds
e814b201: folds
Uncalled bet ($0.15) returned to e6c023d1
*** SHOWDOWN ***
e6c023d1 collected $0.2 from pot
*** SUMMARY ***
Total pot $0.2
Seat 1: Hero (button) folded before Flop (didn't bet)
Seat 2: e814b201 (small blind) folded before Flop
Seat 3: e6c023d1 (big blind) collected ($0.2)
Seat 4: 96eec3de folded before Flop (didn't bet)
Seat 5: 18633f97 folded before Flop (didn't bet)
Seat 6: b5d592d2 folded before Flop (didn't bet)


Poker Hand #RC95082296: Hold'em No Limit ($0.1/$0.25) - 2020/04/07 15:10:51
Table 'RushAndCash363496' 6-max Seat #1 is the button
Seat 1: a0df58f2 ($12.5 in chips)
Seat 2: Hero ($25.89 in chips)
Seat 3: 704a7fcf ($29.41 in chips)
Seat 4: 4ab4e4a3 ($30.76 in chips)
Seat 5: af84e661 ($8.72 in chips)
Seat 6: 18633f97 ($11.65 in chips)
Hero: posts small blind $0.1
704a7fcf: posts big blind $0.25
*** HOLE CARDS ***
Dealt to a0df58f2 
Dealt to Hero [Ad Ts]
Dealt to 704a7fcf 
Dealt to 4ab4e4a3 
Dealt to af84e661 
Dealt to 18633f97 
4ab4e4a3: folds
af84e661: folds
18633f97: folds
a0df58f2: folds
Hero: folds
Uncalled bet ($0.15) returned to 704a7fcf
*** SHOWDOWN ***
704a7fcf collected $0.2 from pot
*** SUMMARY ***
Total pot $0.2
Seat 1: a0df58f2 (button) folded before Flop (didn't bet)
Seat 2: Hero (small blind) folded before Flop
Seat 3: 704a7fcf (big blind) collected ($0.2)
Seat 4: 4ab4e4a3 folded before Flop (didn't bet)
Seat 5: af84e661 folded before Flop (didn't bet)
Seat 6: 18633f97 folded before Flop (didn't bet)


Poker Hand #RC95082327: Hold'em No Limit ($0.1/$0.25) - 2020/04/07 15:10:55
Table 'RushAndCash363501' 6-max Seat #1 is the button
Seat 1: 454abe8b ($25.81 in chips)
Seat 2: 89387862 ($28.1 in chips)
Seat 3: Hero ($25.79 in chips)
Seat 4: 18633f97 ($11.65 in chips)
Seat 5: d437c92d ($35.17 in chips)
Seat 6: e4c4c11e ($10.75 in chips)
89387862: posts small blind $0.1
Hero: posts big blind $0.25
*** HOLE CARDS ***
Dealt to 454abe8b 
Dealt to 89387862 
Dealt to Hero [Th 7h]
Dealt to 18633f97 
Dealt to d437c92d 
Dealt to e4c4c11e 
18633f97: folds
d437c92d: folds
e4c4c11e: folds
454abe8b: raises $0.38 to $0.63
89387862: folds
Hero: folds
Uncalled bet ($0.38) returned to 454abe8b
*** SHOWDOWN ***
454abe8b collected $0.6 from pot
*** SUMMARY ***
Total pot $0.6
Seat 1: 454abe8b (button) collected ($0.6)
Seat 2: 89387862 (small blind) folded before Flop
Seat 3: Hero (big blind) folded before Flop
Seat 4: 18633f97 folded before Flop (didn't bet)
Seat 5: d437c92d folded before Flop (didn't bet)
Seat 6: e4c4c11e folded before Flop (didn't bet)


Poker Hand #RC95082374: Hold'em No Limit ($0.1/$0.25) - 2020/04/07 15:11:01
Table 'RushAndCash363509' 6-max Seat #1 is the button
Seat 1: 324d8e1d ($25 in chips)
Seat 2: 3cfd7308 ($39.78 in chips)
Seat 3: 2dd038c3 ($6.78 in chips)
Seat 4: 3f5f9735 ($19.92 in chips)
Seat 5: Hero ($25.54 in chips)
Seat 6: c88456c4 ($14.62 in chips)
3cfd7308: posts small blind $0.1
2dd038c3: posts big blind $0.25
*** HOLE CARDS ***
Dealt to 324d8e1d 
Dealt to 3cfd7308 
Dealt to 2dd038c3 
Dealt to 3f5f9735 
Dealt to Hero [9c 3h]
Dealt to c88456c4 
3f5f9735: raises $0.5 to $0.75
Hero: folds
c88456c4: folds
324d8e1d: folds
3cfd7308: folds
2dd038c3: folds
Uncalled bet ($0.5) returned to 3f5f9735
*** SHOWDOWN ***
3f5f9735 collected $0.6 from pot
*** SUMMARY ***
Total pot $0.6
Seat 1: 324d8e1d (button) folded before Flop (didn't bet)
Seat 2: 3cfd7308 (small blind) folded before Flop
Seat 3: 2dd038c3 (big blind) folded before Flop
Seat 4: 3f5f9735 collected ($0.6)
Seat 5: Hero folded before Flop (didn't bet)
Seat 6: c88456c4 folded before Flop (didn't bet)


Poker Hand #RC95082405: Hold'em No Limit ($0.1/$0.25) - 2020/04/07 15:11:04
Table 'RushAndCash363513' 6-max Seat #1 is the button
Seat 1: 96eec3de ($40.77 in chips)
Seat 2: 20b62793 ($78.47 in chips)
Seat 3: 324d8e1d ($25 in chips)
Seat 4: d6f2a39c ($11.97 in chips)
Seat 5: 605bdd57 ($12.85 in chips)
Seat 6: Hero ($25.54 in chips)
20b62793: posts small blind $0.1
324d8e1d: posts big blind $0.25
*** HOLE CARDS ***
Dealt to 96eec3de 
Dealt to 20b62793 
Dealt to 324d8e1d 
Dealt to d6f2a39c 
Dealt to 605bdd57 
Dealt to Hero [Jh 4c]
d6f2a39c: folds
605bdd57: folds
Hero: folds
96eec3de: raises $0.38 to $0.63
20b62793: folds
324d8e1d: folds
Uncalled bet ($0.38) returned to 96eec3de
*** SHOWDOWN ***
96eec3de collected $0.6 from pot
*** SUMMARY ***
Total pot $0.6
Seat 1: 96eec3de (button) collected ($0.6)
Seat 2: 20b62793 (small blind) folded before Flop
Seat 3: 324d8e1d (big blind) folded before Flop
Seat 4: d6f2a39c folded before Flop (didn't bet)
Seat 5: 605bdd57 folded before Flop (didn't bet)
Seat 6: Hero folded before Flop (didn't bet)


Poker Hand #RC95082437: Hold'em No Limit ($0.1/$0.25) - 2020/04/07 15:11:09
Table 'RushAndCash363519' 6-max Seat #1 is the button
Seat 1: 9f803cc2 ($41.89 in chips)
Seat 2: 65837850 ($134.27 in chips)
Seat 3: fe3f48f4 ($25.61 in chips)
Seat 4: a4ba858f ($30.65 in chips)
Seat 5: Hero ($25.54 in chips)
Seat 6: d6f2a39c ($11.97 in chips)
65837850: posts small blind $0.1
fe3f48f4: posts big blind $0.25
*** HOLE CARDS ***
Dealt to 9f803cc2 
Dealt to 65837850 
Dealt to fe3f48f4 
Dealt to a4ba858f 
Dealt to Hero [Jd Td]
Dealt to d6f2a39c 
a4ba858f: folds
Hero: raises $0.38 to $0.63
d6f2a39c: folds
9f803cc2: folds
65837850: folds
fe3f48f4: folds
Uncalled bet ($0.38) returned to Hero
*** SHOWDOWN ***
Hero collected $0.6 from pot
*** SUMMARY ***
Total pot $0.6
Seat 1: 9f803cc2 (button) folded before Flop (didn't bet)
Seat 2: 65837850 (small blind) folded before Flop
Seat 3: fe3f48f4 (big blind) folded before Flop
Seat 4: a4ba858f folded before Flop (didn't bet)
Seat 5: Hero collected ($0.6)
Seat 6: d6f2a39c folded before Flop (didn't bet)


Poker Hand #RC95082618: Hold'em No Limit ($0.1/$0.25) - 2020/04/07 15:11:30
Table 'RushAndCash363542' 6-max Seat #1 is the button
Seat 1: e4c4c11e ($10.4 in chips)
Seat 2: 8c86f461 ($32.66 in chips)
Seat 3: 96eec3de ($41.12 in chips)
Seat 4: Hero ($25.89 in chips)
Seat 5: 887f8eab ($3.65 in chips)
Seat 6: e6c023d1 ($25 in chips)
8c86f461: posts small blind $0.1
96eec3de: posts big blind $0.25
*** HOLE CARDS ***
Dealt to e4c4c11e 
Dealt to 8c86f461 
Dealt to 96eec3de 
Dealt to Hero [9c 8s]
Dealt to 887f8eab 
Dealt to e6c023d1 
Hero: folds
887f8eab: folds
e6c023d1: raises $0.38 to $0.63
e4c4c11e: calls $0.63
8c86f461: folds
96eec3de: calls $0.38
*** FLOP *** [6d 6h Ts]
96eec3de: checks
e6c023d1: checks
e4c4c11e: checks
*** TURN *** [6d 6h Ts] [Kc]
96eec3de: checks
e6c023d1: bets $2
e4c4c11e: folds
96eec3de: calls $2
*** RIVER *** [6d 6h Ts Kc] [5h]
96eec3de: checks
e6c023d1: bets $6
96eec3de: calls $6
e6c023d1: shows [Ah Qs] (Pair of Sixes)
96eec3de: shows [Qd Ks] (Pair of Kings and Pair of Sixes)
*** SHOWDOWN ***
96eec3de collected $17.99 from pot
*** SUMMARY ***
Total pot $17.99
Board [6d 6h Ts Kc 5h]
Seat 1: e4c4c11e (button) folded on the Turn
Seat 2: 8c86f461 (small blind) folded before Flop
Seat 3: 96eec3de (big blind) showed [Ks Qd] and won ($17.99) with Pair of Kings and Pair of Sixes
Seat 4: Hero folded before Flop (didn't bet)
Seat 5: 887f8eab folded before Flop (didn't bet)
Seat 6: e6c023d1 showed [Ah Qs] and lost with Pair of Sixes


Poker Hand #RC95082646: Hold'em No Limit ($0.1/$0.25) - 2020/04/07 15:11:33
Table 'RushAndCash363548' 6-max Seat #1 is the button
Seat 1: bbb85b3f ($25 in chips)
Seat 2: Hero ($25.89 in chips)
Seat 3: acf1a889 ($14.94 in chips)
Seat 4: a0df58f2 ($12.5 in chips)
Seat 5: bf64de7f ($11.65 in chips)
Seat 6: 518d077e ($27.93 in chips)
Hero: posts small blind $0.1
acf1a889: posts big blind $0.25
*** HOLE CARDS ***
Dealt to bbb85b3f 
Dealt to Hero [Kc 9c]
Dealt to acf1a889 
Dealt to a0df58f2 
Dealt to bf64de7f 
Dealt to 518d077e 
a0df58f2: folds
bf64de7f: folds
518d077e: folds
bbb85b3f: folds
Hero: folds
Uncalled bet ($0.15) returned to acf1a889
*** SHOWDOWN ***
acf1a889 collected $0.2 from pot
*** SUMMARY ***
Total pot $0.2
Seat 1: bbb85b3f (button) folded before Flop (didn't bet)
Seat 2: Hero (small blind) folded before Flop
Seat 3: acf1a889 (big blind) collected ($0.2)
Seat 4: a0df58f2 folded before Flop (didn't bet)
Seat 5: bf64de7f folded before Flop (didn't bet)
Seat 6: 518d077e folded before Flop (didn't bet)


Poker Hand #RC95082672: Hold'em No Limit ($0.1/$0.25) - 2020/04/07 15:11:36
Table 'RushAndCash363553' 6-max Seat #1 is the button
Seat 1: 432498db ($25 in chips)
Seat 2: 5794e88f ($27.2 in chips)
Seat 3: Hero ($25.79 in chips)
Seat 4: cc092a76 ($9.08 in chips)
Seat 5: 181171f9 ($69.09 in chips)
Seat 6: 103129d8 ($18.39 in chips)
5794e88f: posts small blind $0.1
Hero: posts big blind $0.25
*** HOLE CARDS ***
Dealt to 432498db 
Dealt to 5794e88f 
Dealt to Hero [Th 3d]
Dealt to cc092a76 
Dealt to 181171f9 
Dealt to 103129d8 
cc092a76: folds
181171f9: folds
103129d8: folds
432498db: folds
5794e88f: folds
Uncalled bet ($0.15) returned to Hero
*** SHOWDOWN ***
Hero collected $0.2 from pot
*** SUMMARY ***
Total pot $0.2
Seat 1: 432498db (button) folded before Flop (didn't bet)
Seat 2: 5794e88f (small blind) folded before Flop
Seat 3: Hero (big blind) collected ($0.2)
Seat 4: cc092a76 folded before Flop (didn't bet)
Seat 5: 181171f9 folded before Flop (didn't bet)
Seat 6: 103129d8 folded before Flop (didn't bet)


Poker Hand #RC95082691: Hold'em No Limit ($0.1/$0.25) - 2020/04/07 15:11:39
Table 'RushAndCash363556' 6-max Seat #1 is the button
Seat 1: Hero ($25.54 in chips)
Seat 2: a4ba858f ($30.75 in chips)
Seat 3: d84d476b ($23.96 in chips)
Seat 4: 887f8eab ($3.65 in chips)
Seat 5: deb69778 ($28.48 in chips)
Seat 6: a0df58f2 ($12.5 in chips)
a4ba858f: posts small blind $0.1
d84d476b: posts big blind $0.25
*** HOLE CARDS ***
Dealt to Hero [Qs 2h]
Dealt to a4ba858f 
Dealt to d84d476b 
Dealt to 887f8eab 
Dealt to deb69778 
Dealt to a0df58f2 
887f8eab: folds
deb69778: folds
a0df58f2: folds
Hero: folds
a4ba858f: folds
Uncalled bet ($0.15) returned to d84d476b
*** SHOWDOWN ***
d84d476b collected $0.2 from pot
*** SUMMARY ***
Total pot $0.2
Seat 1: Hero (button) folded before Flop (didn't bet)
Seat 2: a4ba858f (small blind) folded before Flop
Seat 3: d84d476b (big blind) collected ($0.2)
Seat 4: 887f8eab folded before Flop (didn't bet)
Seat 5: deb69778 folded before Flop (didn't bet)
Seat 6: a0df58f2 folded before Flop (didn't bet)


Poker Hand #RC95082725: Hold'em No Limit ($0.1/$0.25) - 2020/04/07 15:11:43
Table 'RushAndCash363561' 6-max Seat #1 is the button
Seat 1: acf1a889 ($15.04 in chips)
Seat 2: 605bdd57 ($12.6 in chips)
Seat 3: e131407f ($29.32 in chips)
Seat 4: 887f8eab ($3.65 in chips)
Seat 5: Hero ($25.54 in chips)
Seat 6: 54c211fb ($25 in chips)
605bdd57: posts small blind $0.1
e131407f: posts big blind $0.25
*** HOLE CARDS ***
Dealt to acf1a889 
Dealt to 605bdd57 
Dealt to e131407f 
Dealt to 887f8eab 
Dealt to Hero [Ah 6s]
Dealt to 54c211fb 
887f8eab: folds
Hero: folds
54c211fb: folds
acf1a889: folds
605bdd57: folds
Uncalled bet ($0.15) returned to e131407f
*** SHOWDOWN ***
e131407f collected $0.2 from pot
*** SUMMARY ***
Total pot $0.2
Seat 1: acf1a889 (button) folded before Flop (didn't bet)
Seat 2: 605bdd57 (small blind) folded before Flop
Seat 3: e131407f (big blind) collected ($0.2)
Seat 4: 887f8eab folded before Flop (didn't bet)
Seat 5: Hero folded before Flop (didn't bet)
Seat 6: 54c211fb folded before Flop (didn't bet)


Poker Hand #RC95082763: Hold'em No Limit ($0.1/$0.25) - 2020/04/07 15:11:48
Table 'RushAndCash363567' 6-max Seat #1 is the button
Seat 1: 29100105 ($37.85 in chips)
Seat 2: 887f8eab ($3.65 in chips)
Seat 3: 3cfd7308 ($40.03 in chips)
Seat 4: a4ba858f ($30.65 in chips)
Seat 5: 45920dbc ($52.51 in chips)
Seat 6: Hero ($25.54 in chips)
887f8eab: posts small blind $0.1
3cfd7308: posts big blind $0.25
*** HOLE CARDS ***
Dealt to 29100105 
Dealt to 887f8eab 
Dealt to 3cfd7308 
Dealt to a4ba858f 
Dealt to 45920dbc 
Dealt to Hero [5h 5c]
a4ba858f: raises $0.5 to $0.75
45920dbc: folds
Hero: folds
29100105: folds
887f8eab: folds
3cfd7308: folds
Uncalled bet ($0.5) returned to a4ba858f
*** SHOWDOWN ***
a4ba858f collected $0.6 from pot
*** SUMMARY ***
Total pot $0.6
Seat 1: 29100105 (button) folded before Flop (didn't bet)
Seat 2: 887f8eab (small blind) folded before Flop
Seat 3: 3cfd7308 (big blind) folded before Flop
Seat 4: a4ba858f collected ($0.6)
Seat 5: 45920dbc folded before Flop (didn't bet)
Seat 6: Hero folded before Flop (didn't bet)


Poker Hand #RC95082827: Hold'em No Limit ($0.1/$0.25) - 2020/04/07 15:11:56
Table 'RushAndCash363576' 6-max Seat #1 is the button
Seat 1: 18633f97 ($12.96 in chips)
Seat 2: Hero ($25.89 in chips)
Seat 3: fc8a29ea ($83.39 in chips)
Seat 4: 528a07f8 ($32.23 in chips)
Seat 5: 4dd920ba ($25 in chips)
Seat 6: 605bdd57 ($12.5 in chips)
Hero: posts small blind $0.1
fc8a29ea: posts big blind $0.25
*** HOLE CARDS ***
Dealt to 18633f97 
Dealt to Hero [6s 5d]
Dealt to fc8a29ea 
Dealt to 528a07f8 
Dealt to 4dd920ba 
Dealt to 605bdd57 
528a07f8: folds
4dd920ba: folds
605bdd57: folds
18633f97: folds
Hero: folds
Uncalled bet ($0.15) returned to fc8a29ea
*** SHOWDOWN ***
fc8a29ea collected $0.2 from pot
*** SUMMARY ***
Total pot $0.2
Seat 1: 18633f97 (button) folded before Flop (didn't bet)
Seat 2: Hero (small blind) folded before Flop
Seat 3: fc8a29ea (big blind) collected ($0.2)
Seat 4: 528a07f8 folded before Flop (didn't bet)
Seat 5: 4dd920ba folded before Flop (didn't bet)
Seat 6: 605bdd57 folded before Flop (didn't bet)


Poker Hand #RC95082848: Hold'em No Limit ($0.1/$0.25) - 2020/04/07 15:11:59
Table 'RushAndCash363579' 6-max Seat #1 is the button
Seat 1: 887f8eab ($3.55 in chips)
Seat 2: acf1a889 ($15.04 in chips)
Seat 3: 74937d40 ($41.91 in chips)
Seat 4: 3abc34ff ($25 in chips)
Seat 5: Hero ($25.79 in chips)
Seat 6: 8db504d0 ($25.06 in chips)
acf1a889: posts small blind $0.1
74937d40: posts big blind $0.25
*** HOLE CARDS ***
Dealt to 887f8eab 
Dealt to acf1a889 
Dealt to 74937d40 
Dealt to 3abc34ff 
Dealt to Hero [Kc 8d]
Dealt to 8db504d0 
3abc34ff: folds
Hero: folds
8db504d0: folds
887f8eab: raises $3.3 to $3.55 and is all-in
acf1a889: folds
74937d40: folds
Uncalled bet ($3.3) returned to 887f8eab
*** SHOWDOWN ***
887f8eab collected $0.6 from pot
*** SUMMARY ***
Total pot $0.6
Seat 1: 887f8eab (button) collected ($0.6)
Seat 2: acf1a889 (small blind) folded before Flop
Seat 3: 74937d40 (big blind) folded before Flop
Seat 4: 3abc34ff folded before Flop (didn't bet)
Seat 5: Hero folded before Flop (didn't bet)
Seat 6: 8db504d0 folded before Flop (didn't bet)


Poker Hand #RC95082881: Hold'em No Limit ($0.1/$0.25) - 2020/04/07 15:12:03
Table 'RushAndCash363584' 6-max Seat #1 is the button
Seat 1: 704c37d9 ($53.5 in chips)
Seat 2: d05d0db2 ($25.1 in chips)
Seat 3: Hero ($25.79 in chips)
Seat 4: 90ddca47 ($26.01 in chips)
Seat 5: 91c71347 ($25 in chips)
Seat 6: 528a07f8 ($32.23 in chips)
d05d0db2: posts small blind $0.1
Hero: posts big blind $0.25
*** HOLE CARDS ***
Dealt to 704c37d9 
Dealt to d05d0db2 
Dealt to Hero [9d 2c]
Dealt to 90ddca47 
Dealt to 91c71347 
Dealt to 528a07f8 
90ddca47: folds
91c71347: raises $0.38 to $0.63
528a07f8: folds
704c37d9: folds
d05d0db2: folds
Hero: folds
Uncalled bet ($0.38) returned to 91c71347
*** SHOWDOWN ***
91c71347 collected $0.6 from pot
*** SUMMARY ***
Total pot $0.6
Seat 1: 704c37d9 (button) folded before Flop (didn't bet)
Seat 2: d05d0db2 (small blind) folded before Flop
Seat 3: Hero (big blind) folded before Flop
Seat 4: 90ddca47 folded before Flop (didn't bet)
Seat 5: 91c71347 collected ($0.6)
Seat 6: 528a07f8 folded before Flop (didn't bet)


Poker Hand #RC95082912: Hold'em No Limit ($0.1/$0.25) - 2020/04/07 15:12:07
Table 'RushAndCash363589' 6-max Seat #1 is the button
Seat 1: Hero ($25.54 in chips)
Seat 2: a2f2938c ($25 in chips)
Seat 3: 3abc34ff ($25 in chips)
Seat 4: bd460ce3 ($28.55 in chips)
Seat 5: d6f2a39c ($11.62 in chips)
Seat 6: 7c0ffa93 ($24.65 in chips)
a2f2938c: posts small blind $0.1
3abc34ff: posts big blind $0.25
*** HOLE CARDS ***
Dealt to Hero [Qs 2h]
Dealt to a2f2938c 
Dealt to 3abc34ff 
Dealt to bd460ce3 
Dealt to d6f2a39c 
Dealt to 7c0ffa93 
bd460ce3: folds
d6f2a39c: folds
7c0ffa93: folds
Hero: folds
a2f2938c: folds
Uncalled bet ($0.15) returned to 3abc34ff
*** SHOWDOWN ***
3abc34ff collected $0.2 from pot
*** SUMMARY ***
Total pot $0.2
Seat 1: Hero (button) folded before Flop (didn't bet)
Seat 2: a2f2938c (small blind) folded before Flop
Seat 3: 3abc34ff (big blind) collected ($0.2)
Seat 4: bd460ce3 folded before Flop (didn't bet)
Seat 5: d6f2a39c folded before Flop (didn't bet)
Seat 6: 7c0ffa93 folded before Flop (didn't bet)


Poker Hand #RC95082940: Hold'em No Limit ($0.1/$0.25) - 2020/04/07 15:12:11
Table 'RushAndCash363593' 6-max Seat #1 is the button
Seat 1: deb69778 ($28.28 in chips)
Seat 2: 29100105 ($37.85 in chips)
Seat 3: bbb85b3f ($25 in chips)
Seat 4: 9f138297 ($30.71 in chips)
Seat 5: 7c0ffa93 ($24.65 in chips)
Seat 6: Hero ($25.54 in chips)
29100105: posts small blind $0.1
bbb85b3f: posts big blind $0.25
*** HOLE CARDS ***
Dealt to deb69778 
Dealt to 29100105 
Dealt to bbb85b3f 
Dealt to 9f138297 
Dealt to 7c0ffa93 
Dealt to Hero [Qh 8s]
9f138297: raises $0.25 to $0.5
7c0ffa93: folds
Hero: folds
deb69778: folds
29100105: folds
bbb85b3f: folds
Uncalled bet ($0.25) returned to 9f138297
*** SHOWDOWN ***
9f138297 collected $0.6 from pot
*** SUMMARY ***
Total pot $0.6
Seat 1: deb69778 (button) folded before Flop (didn't bet)
Seat 2: 29100105 (small blind) folded before Flop
Seat 3: bbb85b3f (big blind) folded before Flop
Seat 4: 9f138297 collected ($0.6)
Seat 5: 7c0ffa93 folded before Flop (didn't bet)
Seat 6: Hero folded before Flop (didn't bet)


Poker Hand #RC95082971: Hold'em No Limit ($0.1/$0.25) - 2020/04/07 15:12:15
Table 'RushAndCash363597' 6-max Seat #1 is the button
Seat 1: 324d8e1d ($25 in chips)
Seat 2: 7ac43878 ($18.44 in chips)
Seat 3: bd460ce3 ($28.55 in chips)
Seat 4: Hero ($25.54 in chips)
Seat 5: e4c4c11e ($9.77 in chips)
Seat 6: 887f8eab ($3.9 in chips)
7ac43878: posts small blind $0.1
bd460ce3: posts big blind $0.25
*** HOLE CARDS ***
Dealt to 324d8e1d 
Dealt to 7ac43878 
Dealt to bd460ce3 
Dealt to Hero [6d 5d]
Dealt to e4c4c11e 
Dealt to 887f8eab 
Hero: raises $0.38 to $0.63
e4c4c11e: folds
887f8eab: raises $0.38 to $1.01
324d8e1d: folds
7ac43878: folds
bd460ce3: folds
Hero: calls $0.38
*** FLOP *** [Ac 6h 4s]
Hero: checks
887f8eab: bets $0.8
Hero: calls $0.8
*** TURN *** [Ac 6h 4s] [Ah]
Hero: checks
887f8eab: bets $1.4
Hero: raises $2.3 to $3.7
887f8eab: calls $0.69 and is all-in
Uncalled bet ($1.61) returned to Hero
Hero: shows [6d 5d] (Pair of Aces and Pair of Sixes)
887f8eab: shows [8d As] (Three Aces)
*** RIVER *** [Ac 6h 4s Ah] [7h]
*** SHOWDOWN ***
887f8eab collected $8.15 from pot
*** SUMMARY ***
Total pot $8.15
Board [Ac 6h 4s Ah 7h]
Seat 1: 324d8e1d (button) folded before Flop (didn't bet)
Seat 2: 7ac43878 (small blind) folded before Flop
Seat 3: bd460ce3 (big blind) folded before Flop
Seat 4: Hero showed [6d 5d] and lost with Pair of Aces and Pair of Sixes
Seat 5: e4c4c11e folded before Flop (didn't bet)
Seat 6: 887f8eab showed [As 8d] and won ($8.15) with Three Aces


Poker Hand #RC95083452: Hold'em No Limit ($0.1/$0.25) - 2020/04/07 15:13:14
Table 'RushAndCash363667' 6-max Seat #1 is the button
Seat 1: 9f138297 ($30.96 in chips)
Seat 2: 8ebd1db4 ($30.1 in chips)
Seat 3: d05d0db2 ($25.35 in chips)
Seat 4: cae4d8ce ($12.49 in chips)
Seat 5: Hero ($25 in chips)
Seat 6: 3cfd7308 ($39.68 in chips)
8ebd1db4: posts small blind $0.1
d05d0db2: posts big blind $0.25
*** HOLE CARDS ***
Dealt to 9f138297 
Dealt to 8ebd1db4 
Dealt to d05d0db2 
Dealt to cae4d8ce 
Dealt to Hero [6s 2c]
Dealt to 3cfd7308 
cae4d8ce: folds
Hero: folds
3cfd7308: folds
9f138297: folds
8ebd1db4: folds
Uncalled bet ($0.15) returned to d05d0db2
*** SHOWDOWN ***
d05d0db2 collected $0.2 from pot
*** SUMMARY ***
Total pot $0.2
Seat 1: 9f138297 (button) folded before Flop (didn't bet)
Seat 2: 8ebd1db4 (small blind) folded before Flop
Seat 3: d05d0db2 (big blind) collected ($0.2)
Seat 4: cae4d8ce folded before Flop (didn't bet)
Seat 5: Hero folded before Flop (didn't bet)
Seat 6: 3cfd7308 folded before Flop (didn't bet)


Poker Hand #RC95083483: Hold'em No Limit ($0.1/$0.25) - 2020/04/07 15:13:18
Table 'RushAndCash363674' 6-max Seat #1 is the button
Seat 1: 20c221eb ($11.65 in chips)
Seat 2: 518d077e ($25 in chips)
Seat 3: Hero ($25 in chips)
Seat 4: 3f5f9735 ($19.92 in chips)
Seat 5: 8ebd1db4 ($30 in chips)
Seat 6: cae4d8ce ($12.49 in chips)
518d077e: posts small blind $0.1
Hero: posts big blind $0.25
*** HOLE CARDS ***
Dealt to 20c221eb 
Dealt to 518d077e 
Dealt to Hero [Jc 8d]
Dealt to 3f5f9735 
Dealt to 8ebd1db4 
Dealt to cae4d8ce 
3f5f9735: folds
8ebd1db4: folds
cae4d8ce: raises $0.5 to $0.75
20c221eb: raises $1.7 to $2.45
518d077e: folds
Hero: folds
cae4d8ce: calls $1.7
*** FLOP *** [8c 5d Kd]
cae4d8ce: checks
20c221eb: checks
*** TURN *** [8c 5d Kd] [Kc]
cae4d8ce: checks
20c221eb: bets $2.95
cae4d8ce: folds
Uncalled bet ($2.95) returned to 20c221eb
*** SHOWDOWN ***
20c221eb collected $5.25 from pot
*** SUMMARY ***
Total pot $5.25
Board [8c 5d Kd Kc]
Seat 1: 20c221eb (button) won ($5.25)
Seat 2: 518d077e (small blind) folded before Flop
Seat 3: Hero (big blind) folded before Flop
Seat 4: 3f5f9735 folded before Flop (didn't bet)
Seat 5: 8ebd1db4 folded before Flop (didn't bet)
Seat 6: cae4d8ce folded on the Turn


Poker Hand #RC95083550: Hold'em No Limit ($0.1/$0.25) - 2020/04/07 15:13:26
Table 'RushAndCash363683' 6-max Seat #1 is the button
Seat 1: 2d45ce80 ($7.54 in chips)
Seat 2: Hero ($25 in chips)
Seat 3: 89387862 ($28.66 in chips)
Seat 4: 8ebd1db4 ($30 in chips)
Seat 5: d437c92d ($33.64 in chips)
Seat 6: 454abe8b ($27.46 in chips)
Hero: posts small blind $0.1
89387862: posts big blind $0.25
*** HOLE CARDS ***
Dealt to 2d45ce80 
Dealt to Hero [Ks 7c]
Dealt to 89387862 
Dealt to 8ebd1db4 
Dealt to d437c92d 
Dealt to 454abe8b 
8ebd1db4: folds
d437c92d: folds
454abe8b: folds
2d45ce80: folds
Hero: folds
Uncalled bet ($0.15) returned to 89387862
*** SHOWDOWN ***
89387862 collected $0.2 from pot
*** SUMMARY ***
Total pot $0.2
Seat 1: 2d45ce80 (button) folded before Flop (didn't bet)
Seat 2: Hero (small blind) folded before Flop
Seat 3: 89387862 (big blind) collected ($0.2)
Seat 4: 8ebd1db4 folded before Flop (didn't bet)
Seat 5: d437c92d folded before Flop (didn't bet)
Seat 6: 454abe8b folded before Flop (didn't bet)


Poker Hand #RC95083593: Hold'em No Limit ($0.1/$0.25) - 2020/04/07 15:13:31
Table 'RushAndCash363690' 6-max Seat #1 is the button
Seat 1: 202599c6 ($25 in chips)
Seat 2: 3f5f9735 ($19.92 in chips)
Seat 3: 454abe8b ($27.46 in chips)
Seat 4: Hero ($25 in chips)
Seat 5: f172d4cc ($59.26 in chips)
Seat 6: 50ccb9a1 ($22.06 in chips)
3f5f9735: posts small blind $0.1
454abe8b: posts big blind $0.25
*** HOLE CARDS ***
Dealt to 202599c6 
Dealt to 3f5f9735 
Dealt to 454abe8b 
Dealt to Hero [Jd Ts]
Dealt to f172d4cc 
Dealt to 50ccb9a1 
Hero: folds
f172d4cc: folds
50ccb9a1: folds
202599c6: folds
3f5f9735: folds
Uncalled bet ($0.15) returned to 454abe8b
*** SHOWDOWN ***
454abe8b collected $0.2 from pot
*** SUMMARY ***
Total pot $0.2
Seat 1: 202599c6 (button) folded before Flop (didn't bet)
Seat 2: 3f5f9735 (small blind) folded before Flop
Seat 3: 454abe8b (big blind) collected ($0.2)
Seat 4: Hero folded before Flop (didn't bet)
Seat 5: f172d4cc folded before Flop (didn't bet)
Seat 6: 50ccb9a1 folded before Flop (didn't bet)


Poker Hand #RC95083622: Hold'em No Limit ($0.1/$0.25) - 2020/04/07 15:13:35
Table 'RushAndCash363694' 6-max Seat #1 is the button
Seat 1: Hero ($25 in chips)
Seat 2: e131407f ($27.17 in chips)
Seat 3: 79cc211c ($25.78 in chips)
Seat 4: 4ab4e4a3 ($32.87 in chips)
Seat 5: 49b3e425 ($12 in chips)
Seat 6: 704a7fcf ($27.9 in chips)
e131407f: posts small blind $0.1
79cc211c: posts big blind $0.25
*** HOLE CARDS ***
Dealt to Hero [Jh 9d]
Dealt to e131407f 
Dealt to 79cc211c 
Dealt to 4ab4e4a3 
Dealt to 49b3e425 
Dealt to 704a7fcf 
4ab4e4a3: folds
49b3e425: raises $0.25 to $0.5
704a7fcf: folds
Hero: folds
e131407f: folds
79cc211c: calls $0.25
*** FLOP *** [Ks 2h Tc]
79cc211c: checks
49b3e425: bets $0.5
79cc211c: folds
Uncalled bet ($0.5) returned to 49b3e425
*** SHOWDOWN ***
49b3e425 collected $1.1 from pot
*** SUMMARY ***
Total pot $1.1
Board [Ks 2h Tc]
Seat 1: Hero (button) folded before Flop (didn't bet)
Seat 2: e131407f (small blind) folded before Flop
Seat 3: 79cc211c (big blind) folded on the Flop
Seat 4: 4ab4e4a3 folded before Flop (didn't bet)
Seat 5: 49b3e425 won ($1.1)
Seat 6: 704a7fcf folded before Flop (didn't bet)


Poker Hand #RC95083649: Hold'em No Limit ($0.1/$0.25) - 2020/04/07 15:13:39
Table 'RushAndCash363697' 6-max Seat #1 is the button
Seat 1: d4f64153 ($32 in chips)
Seat 2: 324d8e1d ($25 in chips)
Seat 3: f172d4cc ($59.26 in chips)
Seat 4: Hero ($25 in chips)
Seat 5: d05d0db2 ($25.35 in chips)
Seat 6: d6f2a39c ($11.27 in chips)
324d8e1d: posts small blind $0.1
f172d4cc: posts big blind $0.25
*** HOLE CARDS ***
Dealt to d4f64153 
Dealt to 324d8e1d 
Dealt to f172d4cc 
Dealt to Hero [Tc 8c]
Dealt to d05d0db2 
Dealt to d6f2a39c 
Hero: folds
d05d0db2: folds
d6f2a39c: raises $0.38 to $0.63
d4f64153: folds
324d8e1d: folds
f172d4cc: calls $0.38
*** FLOP *** [As Kh 7s]
f172d4cc: checks
d6f2a39c: bets $0.5
f172d4cc: calls $0.5
*** TURN *** [As Kh 7s] [2c]
f172d4cc: checks
d6f2a39c: bets $1.8
f172d4cc: calls $1.8
*** RIVER *** [As Kh 7s 2c] [Jh]
f172d4cc: checks
d6f2a39c: checks
f172d4cc: shows [Ts Ad] (Pair of Aces)
d6f2a39c: shows [Qd Js] (Pair of Jacks)
*** SHOWDOWN ***
f172d4cc collected $5.96 from pot
*** SUMMARY ***
Total pot $5.96
Board [As Kh 7s 2c Jh]
Seat 1: d4f64153 (button) folded before Flop (didn't bet)
Seat 2: 324d8e1d (small blind) folded before Flop
Seat 3: f172d4cc (big blind) showed [Ad Ts] and won ($5.96) with Pair of Aces
Seat 4: Hero folded before Flop (didn't bet)
Seat 5: d05d0db2 folded before Flop (didn't bet)
Seat 6: d6f2a39c showed [Qd Js] and lost with Pair of Jacks


Poker Hand #RC95083677: Hold'em No Limit ($0.1/$0.25) - 2020/04/07 15:13:42
Table 'RushAndCash363701' 6-max Seat #1 is the button
Seat 1: Hero ($25 in chips)
Seat 2: 3cfd7308 ($39.68 in chips)
Seat 3: 9f138297 ($30.96 in chips)
Seat 4: 2d45ce80 ($7.54 in chips)
Seat 5: bfa55601 ($12.5 in chips)
Seat 6: 27cb8937 ($19.19 in chips)
3cfd7308: posts small blind $0.1
9f138297: posts big blind $0.25
*** HOLE CARDS ***
Dealt to Hero [8d 7d]
Dealt to 3cfd7308 
Dealt to 9f138297 
Dealt to 2d45ce80 
Dealt to bfa55601 
Dealt to 27cb8937 
2d45ce80: folds
bfa55601: folds
27cb8937: folds
Hero: raises $0.38 to $0.63
3cfd7308: folds
9f138297: folds
Uncalled bet ($0.38) returned to Hero
*** SHOWDOWN ***
Hero collected $0.6 from pot
*** SUMMARY ***
Total pot $0.6
Seat 1: Hero (button) collected ($0.6)
Seat 2: 3cfd7308 (small blind) folded before Flop
Seat 3: 9f138297 (big blind) folded before Flop
Seat 4: 2d45ce80 folded before Flop (didn't bet)
Seat 5: bfa55601 folded before Flop (didn't bet)
Seat 6: 27cb8937 folded before Flop (didn't bet)


Poker Hand #RC95083796: Hold'em No Limit ($0.1/$0.25) - 2020/04/07 15:13:57
Table 'RushAndCash363720' 6-max Seat #1 is the button
Seat 1: 62eebc49 ($106.82 in chips)
Seat 2: Hero ($25.35 in chips)
Seat 3: d4f64153 ($32 in chips)
Seat 4: 91c71347 ($25 in chips)
Seat 5: 202599c6 ($25 in chips)
Seat 6: 432498db ($26.54 in chips)
Hero: posts small blind $0.1
d4f64153: posts big blind $0.25
*** HOLE CARDS ***
Dealt to 62eebc49 
Dealt to Hero [Jd Td]
Dealt to d4f64153 
Dealt to 91c71347 
Dealt to 202599c6 
Dealt to 432498db 
91c71347: folds
202599c6: folds
432498db: folds
62eebc49: folds
Hero: raises $0.5 to $0.75
d4f64153: folds
Uncalled bet ($0.5) returned to Hero
*** SHOWDOWN ***
Hero collected $0.5 from pot
*** SUMMARY ***
Total pot $0.5
Seat 1: 62eebc49 (button) folded before Flop (didn't bet)
Seat 2: Hero (small blind) collected ($0.5)
Seat 3: d4f64153 (big blind) folded before Flop
Seat 4: 91c71347 folded before Flop (didn't bet)
Seat 5: 202599c6 folded before Flop (didn't bet)
Seat 6: 432498db folded before Flop (didn't bet)


Poker Hand #RC95083891: Hold'em No Limit ($0.1/$0.25) - 2020/04/07 15:14:10
Table 'RushAndCash363735' 6-max Seat #1 is the button
Seat 1: cb835642 ($30.33 in chips)
Seat 2: 1a2581ce ($25 in chips)
Seat 3: Hero ($25.6 in chips)
Seat 4: 6a4f7541 ($25.7 in chips)
Seat 5: 518d077e ($25.1 in chips)
Seat 6: bfa55601 ($12.5 in chips)
1a2581ce: posts small blind $0.1
Hero: posts big blind $0.25
*** HOLE CARDS ***
Dealt to cb835642 
Dealt to 1a2581ce 
Dealt to Hero [7c 3c]
Dealt to 6a4f7541 
Dealt to 518d077e 
Dealt to bfa55601 
6a4f7541: folds
518d077e: folds
bfa55601: folds
cb835642: raises $0.38 to $0.63
1a2581ce: folds
Hero: folds
Uncalled bet ($0.38) returned to cb835642
*** SHOWDOWN ***
cb835642 collected $0.6 from pot
*** SUMMARY ***
Total pot $0.6
Seat 1: cb835642 (button) collected ($0.6)
Seat 2: 1a2581ce (small blind) folded before Flop
Seat 3: Hero (big blind) folded before Flop
Seat 4: 6a4f7541 folded before Flop (didn't bet)
Seat 5: 518d077e folded before Flop (didn't bet)
Seat 6: bfa55601 folded before Flop (didn't bet)


Poker Hand #RC95083928: Hold'em No Limit ($0.1/$0.25) - 2020/04/07 15:14:14
Table 'RushAndCash363742' 6-max Seat #1 is the button
Seat 1: bbb85b3f ($32.92 in chips)
Seat 2: 518d077e ($25.45 in chips)
Seat 3: 9a31a923 ($18.26 in chips)
Seat 4: 6736194e ($21.64 in chips)
Seat 5: 45920dbc ($45.33 in chips)
Seat 6: Hero ($25.35 in chips)
Cash Drop to Pot : total $2.5 
518d077e: posts small blind $0.1
9a31a923: posts big blind $0.25
*** HOLE CARDS ***
Dealt to bbb85b3f 
Dealt to 518d077e 
Dealt to 9a31a923 
Dealt to 6736194e 
Dealt to 45920dbc 
Dealt to Hero [Td 2d]
6736194e: calls $0.25
45920dbc: raises $2.8 to $3.05
Hero: folds
bbb85b3f: calls $3.05
518d077e: folds
9a31a923: folds
6736194e: folds
*** FLOP *** [5c Jc 7h]
45920dbc: checks
bbb85b3f: bets $3.1
45920dbc: folds
Uncalled bet ($3.1) returned to bbb85b3f
*** SHOWDOWN ***
bbb85b3f collected $9.2 from pot
*** SUMMARY ***
Total pot $9.2
Board [5c Jc 7h]
Seat 1: bbb85b3f (button) won ($9.2)
Seat 2: 518d077e (small blind) folded before Flop
Seat 3: 9a31a923 (big blind) folded before Flop
Seat 4: 6736194e folded before Flop
Seat 5: 45920dbc folded on the Flop
Seat 6: Hero folded before Flop (didn't bet)


Poker Hand #RC95084057: Hold'em No Limit ($0.1/$0.25) - 2020/04/07 15:14:31
Table 'RushAndCash363766' 6-max Seat #1 is the button
Seat 1: 3423a84d ($21.37 in chips)
Seat 2: 202599c6 ($25 in chips)
Seat 3: 704c37d9 ($54.3 in chips)
Seat 4: Hero ($25.35 in chips)
Seat 5: d05d0db2 ($25.7 in chips)
Seat 6: 275e7f74 ($28.59 in chips)
202599c6: posts small blind $0.1
704c37d9: posts big blind $0.25
*** HOLE CARDS ***
Dealt to 3423a84d 
Dealt to 202599c6 
Dealt to 704c37d9 
Dealt to Hero [Qd 9s]
Dealt to d05d0db2 
Dealt to 275e7f74 
Hero: folds
d05d0db2: folds
275e7f74: folds
3423a84d: folds
202599c6: folds
Uncalled bet ($0.15) returned to 704c37d9
*** SHOWDOWN ***
704c37d9 collected $0.2 from pot
*** SUMMARY ***
Total pot $0.2
Seat 1: 3423a84d (button) folded before Flop (didn't bet)
Seat 2: 202599c6 (small blind) folded before Flop
Seat 3: 704c37d9 (big blind) collected ($0.2)
Seat 4: Hero folded before Flop (didn't bet)
Seat 5: d05d0db2 folded before Flop (didn't bet)
Seat 6: 275e7f74 folded before Flop (didn't bet)


Poker Hand #RC95084093: Hold'em No Limit ($0.1/$0.25) - 2020/04/07 15:14:36
Table 'RushAndCash363772' 6-max Seat #1 is the button
Seat 1: d84d476b ($24.27 in chips)
Seat 2: 95083363 ($31.67 in chips)
Seat 3: 181171f9 ($68.64 in chips)
Seat 4: Hero ($25.35 in chips)
Seat 5: 275e7f74 ($28.59 in chips)
Seat 6: 1a2581ce ($25 in chips)
95083363: posts small blind $0.1
181171f9: posts big blind $0.25
*** HOLE CARDS ***
Dealt to d84d476b 
Dealt to 95083363 
Dealt to 181171f9 
Dealt to Hero [Ac 4s]
Dealt to 275e7f74 
Dealt to 1a2581ce 
Hero: folds
275e7f74: folds
1a2581ce: folds
d84d476b: raises $0.38 to $0.63
95083363: folds
181171f9: folds
Uncalled bet ($0.38) returned to d84d476b
*** SHOWDOWN ***
d84d476b collected $0.6 from pot
*** SUMMARY ***
Total pot $0.6
Seat 1: d84d476b (button) collected ($0.6)
Seat 2: 95083363 (small blind) folded before Flop
Seat 3: 181171f9 (big blind) folded before Flop
Seat 4: Hero folded before Flop (didn't bet)
Seat 5: 275e7f74 folded before Flop (didn't bet)
Seat 6: 1a2581ce folded before Flop (didn't bet)


Poker Hand #RC95084112: Hold'em No Limit ($0.1/$0.25) - 2020/04/07 15:14:39
Table 'RushAndCash363776' 6-max Seat #1 is the button
Seat 1: f66d5ebb ($9.84 in chips)
Seat 2: 887f8eab ($12 in chips)
Seat 3: 2609e300 ($13.31 in chips)
Seat 4: Hero ($25.35 in chips)
Seat 5: 8c86f461 ($35.39 in chips)
Seat 6: d2986703 ($36.47 in chips)
887f8eab: posts small blind $0.1
2609e300: posts big blind $0.25
*** HOLE CARDS ***
Dealt to f66d5ebb 
Dealt to 887f8eab 
Dealt to 2609e300 
Dealt to Hero [9h 5d]
Dealt to 8c86f461 
Dealt to d2986703 
Hero: folds
8c86f461: folds
d2986703: folds
f66d5ebb: raises $0.38 to $0.63
887f8eab: folds
2609e300: folds
Uncalled bet ($0.38) returned to f66d5ebb
*** SHOWDOWN ***
f66d5ebb collected $0.6 from pot
*** SUMMARY ***
Total pot $0.6
Seat 1: f66d5ebb (button) collected ($0.6)
Seat 2: 887f8eab (small blind) folded before Flop
Seat 3: 2609e300 (big blind) folded before Flop
Seat 4: Hero folded before Flop (didn't bet)
Seat 5: 8c86f461 folded before Flop (didn't bet)
Seat 6: d2986703 folded before Flop (didn't bet)


Poker Hand #RC95084138: Hold'em No Limit ($0.1/$0.25) - 2020/04/07 15:14:42
Table 'RushAndCash363781' 6-max Seat #1 is the button
Seat 1: 202599c6 ($25 in chips)
Seat 2: 18075352 ($23.87 in chips)
Seat 3: Hero ($25.35 in chips)
Seat 4: 832cd074 ($25.1 in chips)
Seat 5: 9f138297 ($30.46 in chips)
Seat 6: 2d45ce80 ($7.19 in chips)
18075352: posts small blind $0.1
Hero: posts big blind $0.25
*** HOLE CARDS ***
Dealt to 202599c6 
Dealt to 18075352 
Dealt to Hero [Qs 5s]
Dealt to 832cd074 
Dealt to 9f138297 
Dealt to 2d45ce80 
832cd074: raises $0.5 to $0.75
9f138297: folds
2d45ce80: folds
202599c6: folds
18075352: folds
Hero: folds
Uncalled bet ($0.5) returned to 832cd074
*** SHOWDOWN ***
832cd074 collected $0.6 from pot
*** SUMMARY ***
Total pot $0.6
Seat 1: 202599c6 (button) folded before Flop (didn't bet)
Seat 2: 18075352 (small blind) folded before Flop
Seat 3: Hero (big blind) folded before Flop
Seat 4: 832cd074 collected ($0.6)
Seat 5: 9f138297 folded before Flop (didn't bet)
Seat 6: 2d45ce80 folded before Flop (didn't bet)


Poker Hand #RC95084167: Hold'em No Limit ($0.1/$0.25) - 2020/04/07 15:14:46
Table 'RushAndCash363786' 6-max Seat #1 is the button
Seat 1: bda1b4ce ($25 in chips)
Seat 2: a75a3d24 ($35.01 in chips)
Seat 3: a2f2938c ($25.7 in chips)
Seat 4: Hero ($25.1 in chips)
Seat 5: 95083363 ($31.57 in chips)
Seat 6: 74937d40 ($31 in chips)
a75a3d24: posts small blind $0.1
a2f2938c: posts big blind $0.25
*** HOLE CARDS ***
Dealt to bda1b4ce 
Dealt to a75a3d24 
Dealt to a2f2938c 
Dealt to Hero [Kh Jh]
Dealt to 95083363 
Dealt to 74937d40 
Hero: raises $0.38 to $0.63
95083363: folds
74937d40: folds
bda1b4ce: folds
a75a3d24: folds
a2f2938c: calls $0.38
*** FLOP *** [4d 8h Ks]
a2f2938c: checks
Hero: bets $0.5
a2f2938c: calls $0.5
*** TURN *** [4d 8h Ks] [2s]
a2f2938c: checks
Hero: bets $1.8
a2f2938c: folds
Uncalled bet ($1.8) returned to Hero
*** SHOWDOWN ***
Hero collected $2.36 from pot
*** SUMMARY ***
Total pot $2.36
Board [4d 8h Ks 2s]
Seat 1: bda1b4ce (button) folded before Flop (didn't bet)
Seat 2: a75a3d24 (small blind) folded before Flop
Seat 3: a2f2938c (big blind) folded on the Turn
Seat 4: Hero won ($2.36)
Seat 5: 95083363 folded before Flop (didn't bet)
Seat 6: 74937d40 folded before Flop (didn't bet)


Poker Hand #RC95084640: Hold'em No Limit ($0.1/$0.25) - 2020/04/07 15:15:46
Table 'RushAndCash363865' 6-max Seat #1 is the button
Seat 1: Hero ($26.22 in chips)
Seat 2: 24a8e574 ($30.61 in chips)
Seat 3: 18075352 ($23.32 in chips)
Seat 4: fe3f48f4 ($28.65 in chips)
Seat 5: d437c92d ($43.62 in chips)
Seat 6: 2d45ce80 ($6.84 in chips)
24a8e574: posts small blind $0.1
18075352: posts big blind $0.25
*** HOLE CARDS ***
Dealt to Hero [Qc Ts]
Dealt to 24a8e574 
Dealt to 18075352 
Dealt to fe3f48f4 
Dealt to d437c92d 
Dealt to 2d45ce80 
fe3f48f4: folds
d437c92d: folds
2d45ce80: raises $0.38 to $0.63
Hero: folds
24a8e574: folds
18075352: calls $0.38
*** FLOP *** [Td 9s 3c]
18075352: checks
2d45ce80: bets $0.5
18075352: calls $0.5
*** TURN *** [Td 9s 3c] [6s]
18075352: checks
2d45ce80: bets $0.8
18075352: folds
Uncalled bet ($0.8) returned to 2d45ce80
*** SHOWDOWN ***
2d45ce80 collected $2.36 from pot
*** SUMMARY ***
Total pot $2.36
Board [Td 9s 3c 6s]
Seat 1: Hero (button) folded before Flop (didn't bet)
Seat 2: 24a8e574 (small blind) folded before Flop
Seat 3: 18075352 (big blind) folded on the Turn
Seat 4: fe3f48f4 folded before Flop (didn't bet)
Seat 5: d437c92d folded before Flop (didn't bet)
Seat 6: 2d45ce80 won ($2.36)


Poker Hand #RC95084732: Hold'em No Limit ($0.1/$0.25) - 2020/04/07 15:15:58
Table 'RushAndCash363879' 6-max Seat #1 is the button
Seat 1: a2f2938c ($25 in chips)
Seat 2: Hero ($26.22 in chips)
Seat 3: a6fc3bd6 ($27.54 in chips)
Seat 4: e4c4c11e ($12.6 in chips)
Seat 5: 4dd920ba ($25.84 in chips)
Seat 6: 103129d8 ($15.79 in chips)
Hero: posts small blind $0.1
a6fc3bd6: posts big blind $0.25
*** HOLE CARDS ***
Dealt to a2f2938c 
Dealt to Hero [Qh 8c]
Dealt to a6fc3bd6 
Dealt to e4c4c11e 
Dealt to 4dd920ba 
Dealt to 103129d8 
e4c4c11e: folds
4dd920ba: folds
103129d8: folds
a2f2938c: folds
Hero: folds
Uncalled bet ($0.15) returned to a6fc3bd6
*** SHOWDOWN ***
a6fc3bd6 collected $0.2 from pot
*** SUMMARY ***
Total pot $0.2
Seat 1: a2f2938c (button) folded before Flop (didn't bet)
Seat 2: Hero (small blind) folded before Flop
Seat 3: a6fc3bd6 (big blind) collected ($0.2)
Seat 4: e4c4c11e folded before Flop (didn't bet)
Seat 5: 4dd920ba folded before Flop (didn't bet)
Seat 6: 103129d8 folded before Flop (didn't bet)


Poker Hand #RC95084764: Hold'em No Limit ($0.1/$0.25) - 2020/04/07 15:16:02
Table 'RushAndCash363886' 6-max Seat #1 is the button
Seat 1: bd460ce3 ($28.52 in chips)
Seat 2: 4dd920ba ($25.84 in chips)
Seat 3: 832cd074 ($25 in chips)
Seat 4: acf1a889 ($12.5 in chips)
Seat 5: 1780ed6 ($55.73 in chips)
Seat 6: Hero ($26.12 in chips)
4dd920ba: posts small blind $0.1
832cd074: posts big blind $0.25
*** HOLE CARDS ***
Dealt to bd460ce3 
Dealt to 4dd920ba 
Dealt to 832cd074 
Dealt to acf1a889 
Dealt to 1780ed6 
Dealt to Hero [Ah 3d]
acf1a889: folds
1780ed6: raises $0.38 to $0.63
Hero: folds
bd460ce3: folds
4dd920ba: folds
832cd074: folds
Uncalled bet ($0.38) returned to 1780ed6
*** SHOWDOWN ***
1780ed6 collected $0.6 from pot
*** SUMMARY ***
Total pot $0.6
Seat 1: bd460ce3 (button) folded before Flop (didn't bet)
Seat 2: 4dd920ba (small blind) folded before Flop
Seat 3: 832cd074 (big blind) folded before Flop
Seat 4: acf1a889 folded before Flop (didn't bet)
Seat 5: 1780ed6 collected ($0.6)
Seat 6: Hero folded before Flop (didn't bet)


Poker Hand #RC95084786: Hold'em No Limit ($0.1/$0.25) - 2020/04/07 15:16:05
Table 'RushAndCash363889' 6-max Seat #1 is the button
Seat 1: Hero ($26.12 in chips)
Seat 2: 432498db ($25 in chips)
Seat 3: 895c14a7 ($12.5 in chips)
Seat 4: a2f2938c ($25 in chips)
Seat 5: ce59b684 ($32.98 in chips)
Seat 6: 792480d3 ($10.62 in chips)
432498db: posts small blind $0.1
895c14a7: posts big blind $0.25
*** HOLE CARDS ***
Dealt to Hero [Ad 5h]
Dealt to 432498db 
Dealt to 895c14a7 
Dealt to a2f2938c 
Dealt to ce59b684 
Dealt to 792480d3 
a2f2938c: folds
ce59b684: folds
792480d3: folds
Hero: raises $0.38 to $0.63
432498db: folds
895c14a7: folds
Uncalled bet ($0.38) returned to Hero
*** SHOWDOWN ***
Hero collected $0.6 from pot
*** SUMMARY ***
Total pot $0.6
Seat 1: Hero (button) collected ($0.6)
Seat 2: 432498db (small blind) folded before Flop
Seat 3: 895c14a7 (big blind) folded before Flop
Seat 4: a2f2938c folded before Flop (didn't bet)
Seat 5: ce59b684 folded before Flop (didn't bet)
Seat 6: 792480d3 folded before Flop (didn't bet)


Poker Hand #RC95084922: Hold'em No Limit ($0.1/$0.25) - 2020/04/07 15:16:21
Table 'RushAndCash363912' 6-max Seat #1 is the button
Seat 1: a6fc3bd6 ($27.54 in chips)
Seat 2: Hero ($26.47 in chips)
Seat 3: ce59b684 ($32.73 in chips)
Seat 4: be711e9d ($29.74 in chips)
Seat 5: 432498db ($25 in chips)
Seat 6: b431c8b6 ($25 in chips)
Hero: posts small blind $0.1
ce59b684: posts big blind $0.25
*** HOLE CARDS ***
Dealt to a6fc3bd6 
Dealt to Hero [Js 8d]
Dealt to ce59b684 
Dealt to be711e9d 
Dealt to 432498db 
Dealt to b431c8b6 
be711e9d: folds
432498db: folds
b431c8b6: folds
a6fc3bd6: raises $0.38 to $0.63
Hero: folds
ce59b684: folds
Uncalled bet ($0.38) returned to a6fc3bd6
*** SHOWDOWN ***
a6fc3bd6 collected $0.6 from pot
*** SUMMARY ***
Total pot $0.6
Seat 1: a6fc3bd6 (button) collected ($0.6)
Seat 2: Hero (small blind) folded before Flop
Seat 3: ce59b684 (big blind) folded before Flop
Seat 4: be711e9d folded before Flop (didn't bet)
Seat 5: 432498db folded before Flop (didn't bet)
Seat 6: b431c8b6 folded before Flop (didn't bet)


Poker Hand #RC95084965: Hold'em No Limit ($0.1/$0.25) - 2020/04/07 15:16:26
Table 'RushAndCash363918' 6-max Seat #1 is the button
Seat 1: 27cb8937 ($22.37 in chips)
Seat 2: f7ed681a ($12.5 in chips)
Seat 3: 91c71347 ($25 in chips)
Seat 4: 4ab4e4a3 ($27.62 in chips)
Seat 5: Hero ($26.37 in chips)
Seat 6: be711e9d ($29.74 in chips)
f7ed681a: posts small blind $0.1
91c71347: posts big blind $0.25
*** HOLE CARDS ***
Dealt to 27cb8937 
Dealt to f7ed681a 
Dealt to 91c71347 
Dealt to 4ab4e4a3 
Dealt to Hero [As Qd]
Dealt to be711e9d 
4ab4e4a3: folds
Hero: raises $0.38 to $0.63
be711e9d: folds
27cb8937: folds
f7ed681a: folds
91c71347: calls $0.38
*** FLOP *** [Js 6c Jh]
91c71347: bets $0.4
Hero: calls $0.4
*** TURN *** [Js 6c Jh] [8c]
91c71347: bets $1.8
Hero: folds
Uncalled bet ($1.8) returned to 91c71347
*** SHOWDOWN ***
91c71347 collected $2.16 from pot
*** SUMMARY ***
Total pot $2.16
Board [Js 6c Jh 8c]
Seat 1: 27cb8937 (button) folded before Flop (didn't bet)
Seat 2: f7ed681a (small blind) folded before Flop
Seat 3: 91c71347 (big blind) won ($2.16)
Seat 4: 4ab4e4a3 folded before Flop (didn't bet)
Seat 5: Hero folded on the Turn
Seat 6: be711e9d folded before Flop (didn't bet)


Poker Hand #RC95085202: Hold'em No Limit ($0.1/$0.25) - 2020/04/07 15:16:55
Table 'RushAndCash363959' 6-max Seat #1 is the button
Seat 1: 1a2581ce ($25 in chips)
Seat 2: 202599c6 ($25.67 in chips)
Seat 3: d4f64153 ($25.82 in chips)
Seat 4: Hero ($25.34 in chips)
Seat 5: 91c71347 ($26.03 in chips)
Seat 6: 5794e88f ($38.99 in chips)
202599c6: posts small blind $0.1
d4f64153: posts big blind $0.25
*** HOLE CARDS ***
Dealt to 1a2581ce 
Dealt to 202599c6 
Dealt to d4f64153 
Dealt to Hero [Ad 6c]
Dealt to 91c71347 
Dealt to 5794e88f 
Hero: folds
91c71347: folds
5794e88f: raises $0.38 to $0.63
1a2581ce: folds
202599c6: calls $0.53
d4f64153: folds
*** FLOP *** [3s 9d 4h]
202599c6: checks
5794e88f: bets $0.5
202599c6: calls $0.5
*** TURN *** [3s 9d 4h] [Jd]
202599c6: checks
5794e88f: bets $1.9
202599c6: folds
Uncalled bet ($1.9) returned to 5794e88f
*** SHOWDOWN ***
5794e88f collected $2.51 from pot
*** SUMMARY ***
Total pot $2.51
Board [3s 9d 4h Jd]
Seat 1: 1a2581ce (button) folded before Flop (didn't bet)
Seat 2: 202599c6 (small blind) folded on the Turn
Seat 3: d4f64153 (big blind) folded before Flop
Seat 4: Hero folded before Flop (didn't bet)
Seat 5: 91c71347 folded before Flop (didn't bet)
Seat 6: 5794e88f won ($2.51)


Poker Hand #RC95085234: Hold'em No Limit ($0.1/$0.25) - 2020/04/07 15:16:59
Table 'RushAndCash363964' 6-max Seat #1 is the button
Seat 1: 5d360146 ($9.27 in chips)
Seat 2: 91c71347 ($26.03 in chips)
Seat 3: Hero ($25.34 in chips)
Seat 4: 27485ddf ($15.76 in chips)
Seat 5: 895c14a7 ($12.5 in chips)
Seat 6: fd9dacc9 ($32.85 in chips)
91c71347: posts small blind $0.1
Hero: posts big blind $0.25
*** HOLE CARDS ***
Dealt to 5d360146 
Dealt to 91c71347 
Dealt to Hero [Th 2s]
Dealt to 27485ddf 
Dealt to 895c14a7 
Dealt to fd9dacc9 
27485ddf: folds
895c14a7: folds
fd9dacc9: folds
5d360146: folds
91c71347: folds
Uncalled bet ($0.15) returned to Hero
*** SHOWDOWN ***
Hero collected $0.2 from pot
*** SUMMARY ***
Total pot $0.2
Seat 1: 5d360146 (button) folded before Flop (didn't bet)
Seat 2: 91c71347 (small blind) folded before Flop
Seat 3: Hero (big blind) collected ($0.2)
Seat 4: 27485ddf folded before Flop (didn't bet)
Seat 5: 895c14a7 folded before Flop (didn't bet)
Seat 6: fd9dacc9 folded before Flop (didn't bet)


Poker Hand #RC95085263: Hold'em No Limit ($0.1/$0.25) - 2020/04/07 15:17:03
Table 'RushAndCash363968' 6-max Seat #1 is the button
Seat 1: 91c71347 ($25.93 in chips)
Seat 2: accea393 ($44.69 in chips)
Seat 3: 2d45ce80 ($7.86 in chips)
Seat 4: Hero ($25.09 in chips)
Seat 5: d07b3de1 ($31.42 in chips)
Seat 6: 6736194e ($22.91 in chips)
accea393: posts small blind $0.1
2d45ce80: posts big blind $0.25
*** HOLE CARDS ***
Dealt to 91c71347 
Dealt to accea393 
Dealt to 2d45ce80 
Dealt to Hero [Kh 2d]
Dealt to d07b3de1 
Dealt to 6736194e 
Hero: folds
d07b3de1: raises $0.25 to $0.5
6736194e: calls $0.5
91c71347: folds
accea393: raises $2.65 to $3.15
2d45ce80: folds
d07b3de1: folds
6736194e: folds
Uncalled bet ($2.65) returned to accea393
*** SHOWDOWN ***
accea393 collected $1.75 from pot
*** SUMMARY ***
Total pot $1.75
Seat 1: 91c71347 (button) folded before Flop (didn't bet)
Seat 2: accea393 (small blind) collected ($1.75)
Seat 3: 2d45ce80 (big blind) folded before Flop
Seat 4: Hero folded before Flop (didn't bet)
Seat 5: d07b3de1 folded before Flop
Seat 6: 6736194e folded before Flop


Poker Hand #RC95085290: Hold'em No Limit ($0.1/$0.25) - 2020/04/07 15:17:06
Table 'RushAndCash363972' 6-max Seat #1 is the button
Seat 1: Hero ($25.09 in chips)
Seat 2: a4ba858f ($31.19 in chips)
Seat 3: cc092a76 ($9.1 in chips)
Seat 4: e814b201 ($25.97 in chips)
Seat 5: d05d0db2 ($26.57 in chips)
Seat 6: 7e4944ca ($25.15 in chips)
a4ba858f: posts small blind $0.1
cc092a76: posts big blind $0.25
*** HOLE CARDS ***
Dealt to Hero [7h 3s]
Dealt to a4ba858f 
Dealt to cc092a76 
Dealt to e814b201 
Dealt to d05d0db2 
Dealt to 7e4944ca 
e814b201: folds
d05d0db2: folds
7e4944ca: folds
Hero: folds
a4ba858f: folds
Uncalled bet ($0.15) returned to cc092a76
*** SHOWDOWN ***
cc092a76 collected $0.2 from pot
*** SUMMARY ***
Total pot $0.2
Seat 1: Hero (button) folded before Flop (didn't bet)
Seat 2: a4ba858f (small blind) folded before Flop
Seat 3: cc092a76 (big blind) collected ($0.2)
Seat 4: e814b201 folded before Flop (didn't bet)
Seat 5: d05d0db2 folded before Flop (didn't bet)
Seat 6: 7e4944ca folded before Flop (didn't bet)


Poker Hand #RC95085311: Hold'em No Limit ($0.1/$0.25) - 2020/04/07 15:17:09
Table 'RushAndCash363975' 6-max Seat #1 is the button
Seat 1: d6f2a39c ($9.37 in chips)
Seat 2: Hero ($25.09 in chips)
Seat 3: fe5b2431 ($12.85 in chips)
Seat 4: bd460ce3 ($27.26 in chips)
Seat 5: 324d8e1d ($25.67 in chips)
Seat 6: deb69778 ($30.62 in chips)
Hero: posts small blind $0.1
fe5b2431: posts big blind $0.25
*** HOLE CARDS ***
Dealt to d6f2a39c 
Dealt to Hero [6c 4c]
Dealt to fe5b2431 
Dealt to bd460ce3 
Dealt to 324d8e1d 
Dealt to deb69778 
bd460ce3: raises $0.5 to $0.75
324d8e1d: folds
deb69778: folds
d6f2a39c: folds
Hero: folds
fe5b2431: folds
Uncalled bet ($0.5) returned to bd460ce3
*** SHOWDOWN ***
bd460ce3 collected $0.6 from pot
*** SUMMARY ***
Total pot $0.6
Seat 1: d6f2a39c (button) folded before Flop (didn't bet)
Seat 2: Hero (small blind) folded before Flop
Seat 3: fe5b2431 (big blind) folded before Flop
Seat 4: bd460ce3 collected ($0.6)
Seat 5: 324d8e1d folded before Flop (didn't bet)
Seat 6: deb69778 folded before Flop (didn't bet)


Poker Hand #RC95085347: Hold'em No Limit ($0.1/$0.25) - 2020/04/07 15:17:14
Table 'RushAndCash363980' 6-max Seat #1 is the button
Seat 1: 61ad32d ($12.5 in chips)
Seat 2: 8c86f461 ($34.01 in chips)
Seat 3: 45920dbc ($42.4 in chips)
Seat 4: Hero ($25 in chips)
Seat 5: e6c023d1 ($38.25 in chips)
Seat 6: d2986703 ($36.12 in chips)
8c86f461: posts small blind $0.1
45920dbc: posts big blind $0.25
*** HOLE CARDS ***
Dealt to 61ad32d 
Dealt to 8c86f461 
Dealt to 45920dbc 
Dealt to Hero [Js Jc]
Dealt to e6c023d1 
Dealt to d2986703 
Hero: raises $0.38 to $0.63
e6c023d1: folds
d2986703: calls $0.63
61ad32d: folds
8c86f461: folds
45920dbc: folds
*** FLOP *** [3h 5s 8d]
Hero: bets $1.3
d2986703: folds
Uncalled bet ($1.3) returned to Hero
*** SHOWDOWN ***
Hero collected $1.61 from pot
*** SUMMARY ***
Total pot $1.61
Board [3h 5s 8d]
Seat 1: 61ad32d (button) folded before Flop (didn't bet)
Seat 2: 8c86f461 (small blind) folded before Flop
Seat 3: 45920dbc (big blind) folded before Flop
Seat 4: Hero won ($1.61)
Seat 5: e6c023d1 folded before Flop (didn't bet)
Seat 6: d2986703 folded on the Flop


Poker Hand #RC95085511: Hold'em No Limit ($0.1/$0.25) - 2020/04/07 15:17:35
Table 'RushAndCash364007' 6-max Seat #1 is the button
Seat 1: d2986703 ($35.49 in chips)
Seat 2: d07b3de1 ($30.92 in chips)
Seat 3: Hero ($26.25 in chips)
Seat 4: 1055451d ($12.5 in chips)
Seat 5: 45920dbc ($42.05 in chips)
Seat 6: ce59b684 ($32.03 in chips)
d07b3de1: posts small blind $0.1
Hero: posts big blind $0.25
*** HOLE CARDS ***
Dealt to d2986703 
Dealt to d07b3de1 
Dealt to Hero [As 5c]
Dealt to 1055451d 
Dealt to 45920dbc 
Dealt to ce59b684 
1055451d: folds
45920dbc: folds
ce59b684: folds
d2986703: folds
d07b3de1: raises $0.5 to $0.75
Hero: folds
Uncalled bet ($0.5) returned to d07b3de1
*** SHOWDOWN ***
d07b3de1 collected $0.5 from pot
*** SUMMARY ***
Total pot $0.5
Seat 1: d2986703 (button) folded before Flop (didn't bet)
Seat 2: d07b3de1 (small blind) collected ($0.5)
Seat 3: Hero (big blind) folded before Flop
Seat 4: 1055451d folded before Flop (didn't bet)
Seat 5: 45920dbc folded before Flop (didn't bet)
Seat 6: ce59b684 folded before Flop (didn't bet)


Poker Hand #RC95085547: Hold'em No Limit ($0.1/$0.25) - 2020/04/07 15:17:39
Table 'RushAndCash364013' 6-max Seat #1 is the button
Seat 1: 2d45ce80 ($7.61 in chips)
Seat 2: a296ff49 ($11.75 in chips)
Seat 3: 324d8e1d ($25.57 in chips)
Seat 4: Hero ($26 in chips)
Seat 5: 7bf7c8c9 ($26.46 in chips)
Seat 6: 603fb192 ($15.96 in chips)
a296ff49: posts small blind $0.1
324d8e1d: posts big blind $0.25
*** HOLE CARDS ***
Dealt to 2d45ce80 
Dealt to a296ff49 
Dealt to 324d8e1d 
Dealt to Hero [7d 2d]
Dealt to 7bf7c8c9 
Dealt to 603fb192 
Hero: folds
7bf7c8c9: folds
603fb192: folds
2d45ce80: raises $0.25 to $0.5
a296ff49: calls $0.4
324d8e1d: calls $0.25
*** FLOP *** [Ac 6h 3d]
a296ff49: bets $0.8
324d8e1d: folds
2d45ce80: calls $0.8
*** TURN *** [Ac 6h 3d] [Qs]
a296ff49: checks
2d45ce80: checks
*** RIVER *** [Ac 6h 3d Qs] [4h]
a296ff49: checks
2d45ce80: bets $6.31 and is all-in
a296ff49: folds
Uncalled bet ($6.31) returned to 2d45ce80
*** SHOWDOWN ***
2d45ce80 collected $3.1 from pot
*** SUMMARY ***
Total pot $3.1
Board [Ac 6h 3d Qs 4h]
Seat 1: 2d45ce80 (button) won ($3.1)
Seat 2: a296ff49 (small blind) folded on the River
Seat 3: 324d8e1d (big blind) folded on the Flop
Seat 4: Hero folded before Flop (didn't bet)
Seat 5: 7bf7c8c9 folded before Flop (didn't bet)
Seat 6: 603fb192 folded before Flop (didn't bet)


Poker Hand #RC95085582: Hold'em No Limit ($0.1/$0.25) - 2020/04/07 15:17:43
Table 'RushAndCash364020' 6-max Seat #1 is the button
Seat 1: be711e9d ($29.05 in chips)
Seat 2: d2986703 ($35.49 in chips)
Seat 3: 94e745c ($24.93 in chips)
Seat 4: bfa55601 ($13.1 in chips)
Seat 5: Hero ($26 in chips)
Seat 6: 7bf7c8c9 ($26.46 in chips)
d2986703: posts small blind $0.1
94e745c: posts big blind $0.25
*** HOLE CARDS ***
Dealt to be711e9d 
Dealt to d2986703 
Dealt to 94e745c 
Dealt to bfa55601 
Dealt to Hero [Ts 6d]
Dealt to 7bf7c8c9 
bfa55601: folds
Hero: folds
7bf7c8c9: folds
be711e9d: folds
d2986703: folds
Uncalled bet ($0.15) returned to 94e745c
*** SHOWDOWN ***
94e745c collected $0.2 from pot
*** SUMMARY ***
Total pot $0.2
Seat 1: be711e9d (button) folded before Flop (didn't bet)
Seat 2: d2986703 (small blind) folded before Flop
Seat 3: 94e745c (big blind) collected ($0.2)
Seat 4: bfa55601 folded before Flop (didn't bet)
Seat 5: Hero folded before Flop (didn't bet)
Seat 6: 7bf7c8c9 folded before Flop (didn't bet)


Poker Hand #RC95085606: Hold'em No Limit ($0.1/$0.25) - 2020/04/07 15:17:46
Table 'RushAndCash364025' 6-max Seat #1 is the button
Seat 1: ce2bf8ea ($26.37 in chips)
Seat 2: e4c4c11e ($12.27 in chips)
Seat 3: d2986703 ($35.39 in chips)
Seat 4: 5794e88f ($40 in chips)
Seat 5: Hero ($26 in chips)
Seat 6: 29100105 ($34.64 in chips)
e4c4c11e: posts small blind $0.1
d2986703: posts big blind $0.25
*** HOLE CARDS ***
Dealt to ce2bf8ea 
Dealt to e4c4c11e 
Dealt to d2986703 
Dealt to 5794e88f 
Dealt to Hero [8h 6h]
Dealt to 29100105 
5794e88f: folds
Hero: folds
29100105: folds
ce2bf8ea: raises $0.38 to $0.63
e4c4c11e: folds
d2986703: raises $1.38 to $2.01
ce2bf8ea: calls $1.38
*** FLOP *** [4h Ah Qd]
d2986703: bets $2.1
ce2bf8ea: folds
Uncalled bet ($2.1) returned to d2986703
*** SHOWDOWN ***
d2986703 collected $4.12 from pot
*** SUMMARY ***
Total pot $4.12
Board [4h Ah Qd]
Seat 1: ce2bf8ea (button) folded on the Flop
Seat 2: e4c4c11e (small blind) folded before Flop
Seat 3: d2986703 (big blind) won ($4.12)
Seat 4: 5794e88f folded before Flop (didn't bet)
Seat 5: Hero folded before Flop (didn't bet)
Seat 6: 29100105 folded before Flop (didn't bet)


Poker Hand #RC95085643: Hold'em No Limit ($0.1/$0.25) - 2020/04/07 15:17:51
Table 'RushAndCash364029' 6-max Seat #1 is the button
Seat 1: 832cd074 ($27.58 in chips)
Seat 2: 7ac43878 ($14.75 in chips)
Seat 3: f66d5ebb ($9.85 in chips)
Seat 4: 7bf7c8c9 ($26.46 in chips)
Seat 5: bfa55601 ($13.1 in chips)
Seat 6: Hero ($26 in chips)
7ac43878: posts small blind $0.1
f66d5ebb: posts big blind $0.25
*** HOLE CARDS ***
Dealt to 832cd074 
Dealt to 7ac43878 
Dealt to f66d5ebb 
Dealt to 7bf7c8c9 
Dealt to bfa55601 
Dealt to Hero [Ts 9s]
7bf7c8c9: folds
bfa55601: folds
Hero: raises $0.38 to $0.63
832cd074: folds
7ac43878: folds
f66d5ebb: calls $0.38
*** FLOP *** [9c Kh Ac]
f66d5ebb: checks
Hero: bets $1.1
f66d5ebb: calls $1.1
*** TURN *** [9c Kh Ac] [5d]
f66d5ebb: checks
Hero: checks
*** RIVER *** [9c Kh Ac 5d] [2h]
f66d5ebb: checks
Hero: checks
f66d5ebb: shows [Kc Qd] (Pair of Kings)
Hero: shows [Ts 9s] (Pair of Nines)
*** SHOWDOWN ***
f66d5ebb collected $3.56 from pot
*** SUMMARY ***
Total pot $3.56
Board [9c Kh Ac 5d 2h]
Seat 1: 832cd074 (button) folded before Flop (didn't bet)
Seat 2: 7ac43878 (small blind) folded before Flop
Seat 3: f66d5ebb (big blind) showed [Kc Qd] and won ($3.56) with Pair of Kings
Seat 4: 7bf7c8c9 folded before Flop (didn't bet)
Seat 5: bfa55601 folded before Flop (didn't bet)
Seat 6: Hero showed [Ts 9s] and lost with Pair of Nines


Poker Hand #RC95085973: Hold'em No Limit ($0.1/$0.25) - 2020/04/07 15:18:34
Table 'RushAndCash364087' 6-max Seat #1 is the button
Seat 1: Hero ($25 in chips)
Seat 2: caa68458 ($25 in chips)
Seat 3: 7c935d24 ($29.57 in chips)
Seat 4: d59ed63d ($9.46 in chips)
Seat 5: bfa55601 ($12.75 in chips)
Seat 6: 90ddca47 ($30.73 in chips)
caa68458: posts small blind $0.1
7c935d24: posts big blind $0.25
*** HOLE CARDS ***
Dealt to Hero [9d 5d]
Dealt to caa68458 
Dealt to 7c935d24 
Dealt to d59ed63d 
Dealt to bfa55601 
Dealt to 90ddca47 
d59ed63d: folds
bfa55601: folds
90ddca47: raises $0.25 to $0.5
Hero: folds
caa68458: folds
7c935d24: folds
Uncalled bet ($0.25) returned to 90ddca47
*** SHOWDOWN ***
90ddca47 collected $0.6 from pot
*** SUMMARY ***
Total pot $0.6
Seat 1: Hero (button) folded before Flop (didn't bet)
Seat 2: caa68458 (small blind) folded before Flop
Seat 3: 7c935d24 (big blind) folded before Flop
Seat 4: d59ed63d folded before Flop (didn't bet)
Seat 5: bfa55601 folded before Flop (didn't bet)
Seat 6: 90ddca47 collected ($0.6)


Poker Hand #RC95086003: Hold'em No Limit ($0.1/$0.25) - 2020/04/07 15:18:38
Table 'RushAndCash364091' 6-max Seat #1 is the button
Seat 1: 3ff56a6c ($24.23 in chips)
Seat 2: 103129d8 ($12.17 in chips)
Seat 3: Hero ($25 in chips)
Seat 4: 5794e88f ($39.65 in chips)
Seat 5: 7ed3ab6b ($69.98 in chips)
Seat 6: 603fb192 ($15.96 in chips)
103129d8: posts small blind $0.1
Hero: posts big blind $0.25
*** HOLE CARDS ***
Dealt to 3ff56a6c 
Dealt to 103129d8 
Dealt to Hero [Jh 7d]
Dealt to 5794e88f 
Dealt to 7ed3ab6b 
Dealt to 603fb192 
5794e88f: folds
7ed3ab6b: raises $0.38 to $0.63
603fb192: raises $1.77 to $2.4
3ff56a6c: folds
103129d8: folds
Hero: folds
7ed3ab6b: folds
Uncalled bet ($1.77) returned to 603fb192
*** SHOWDOWN ***
603fb192 collected $1.61 from pot
*** SUMMARY ***
Total pot $1.61
Seat 1: 3ff56a6c (button) folded before Flop (didn't bet)
Seat 2: 103129d8 (small blind) folded before Flop
Seat 3: Hero (big blind) folded before Flop
Seat 4: 5794e88f folded before Flop (didn't bet)
Seat 5: 7ed3ab6b folded before Flop
Seat 6: 603fb192 collected ($1.61)


Poker Hand #RC95086042: Hold'em No Limit ($0.1/$0.25) - 2020/04/07 15:18:43
Table 'RushAndCash364097' 6-max Seat #1 is the button
Seat 1: fe5b2431 ($12.5 in chips)
Seat 2: Hero ($25 in chips)
Seat 3: a75a3d24 ($31 in chips)
Seat 4: c88456c4 ($9.13 in chips)
Seat 5: 5794e88f ($39.65 in chips)
Seat 6: 3ff56a6c ($24.23 in chips)
Hero: posts small blind $0.1
a75a3d24: posts big blind $0.25
*** HOLE CARDS ***
Dealt to fe5b2431 
Dealt to Hero [Ks 2c]
Dealt to a75a3d24 
Dealt to c88456c4 
Dealt to 5794e88f 
Dealt to 3ff56a6c 
c88456c4: folds
5794e88f: folds
3ff56a6c: raises $0.38 to $0.63
fe5b2431: raises $1.67 to $2.3
Hero: folds
a75a3d24: folds
3ff56a6c: folds
Uncalled bet ($1.67) returned to fe5b2431
*** SHOWDOWN ***
fe5b2431 collected $1.61 from pot
*** SUMMARY ***
Total pot $1.61
Seat 1: fe5b2431 (button) collected ($1.61)
Seat 2: Hero (small blind) folded before Flop
Seat 3: a75a3d24 (big blind) folded before Flop
Seat 4: c88456c4 folded before Flop (didn't bet)
Seat 5: 5794e88f folded before Flop (didn't bet)
Seat 6: 3ff56a6c folded before Flop


Poker Hand #RC95086082: Hold'em No Limit ($0.1/$0.25) - 2020/04/07 15:18:49
Table 'RushAndCash364103' 6-max Seat #1 is the button
Seat 1: 832cd074 ($27.58 in chips)
Seat 2: 4dd920ba ($26.02 in chips)
Seat 3: dbf6981f ($48.68 in chips)
Seat 4: 24a8e574 ($30.51 in chips)
Seat 5: b92cc87c ($8.82 in chips)
Seat 6: Hero ($25 in chips)
4dd920ba: posts small blind $0.1
dbf6981f: posts big blind $0.25
*** HOLE CARDS ***
Dealt to 832cd074 
Dealt to 4dd920ba 
Dealt to dbf6981f 
Dealt to 24a8e574 
Dealt to b92cc87c 
Dealt to Hero [Tc 9c]
24a8e574: folds
b92cc87c: raises $0.38 to $0.63
Hero: folds
832cd074: folds
4dd920ba: folds
dbf6981f: calls $0.38
*** FLOP *** [Jh Qd Td]
dbf6981f: checks
b92cc87c: bets $0.5
dbf6981f: folds
Uncalled bet ($0.5) returned to b92cc87c
*** SHOWDOWN ***
b92cc87c collected $1.36 from pot
*** SUMMARY ***
Total pot $1.36
Board [Jh Qd Td]
Seat 1: 832cd074 (button) folded before Flop (didn't bet)
Seat 2: 4dd920ba (small blind) folded before Flop
Seat 3: dbf6981f (big blind) folded on the Flop
Seat 4: 24a8e574 folded before Flop (didn't bet)
Seat 5: b92cc87c won ($1.36)
Seat 6: Hero folded before Flop (didn't bet)


Poker Hand #RC95086154: Hold'em No Limit ($0.1/$0.25) - 2020/04/07 15:18:59
Table 'RushAndCash364116' 6-max Seat #1 is the button
Seat 1: 9d5a252c ($29.88 in chips)
Seat 2: 32953d2a ($12.5 in chips)
Seat 3: 2d45ce80 ($9.26 in chips)
Seat 4: 7c0ffa93 ($28.99 in chips)
Seat 5: 52ee6b3d ($25.69 in chips)
Seat 6: Hero ($25 in chips)
32953d2a: posts small blind $0.1
2d45ce80: posts big blind $0.25
*** HOLE CARDS ***
Dealt to 9d5a252c 
Dealt to 32953d2a 
Dealt to 2d45ce80 
Dealt to 7c0ffa93 
Dealt to 52ee6b3d 
Dealt to Hero [Ts 8s]
7c0ffa93: folds
52ee6b3d: folds
Hero: folds
9d5a252c: raises $0.38 to $0.63
32953d2a: folds
2d45ce80: folds
Uncalled bet ($0.38) returned to 9d5a252c
*** SHOWDOWN ***
9d5a252c collected $0.6 from pot
*** SUMMARY ***
Total pot $0.6
Seat 1: 9d5a252c (button) collected ($0.6)
Seat 2: 32953d2a (small blind) folded before Flop
Seat 3: 2d45ce80 (big blind) folded before Flop
Seat 4: 7c0ffa93 folded before Flop (didn't bet)
Seat 5: 52ee6b3d folded before Flop (didn't bet)
Seat 6: Hero folded before Flop (didn't bet)


Poker Hand #RC95086175: Hold'em No Limit ($0.1/$0.25) - 2020/04/07 15:19:02
Table 'RushAndCash364119' 6-max Seat #1 is the button
Seat 1: a75a3d24 ($30.75 in chips)
Seat 2: 20b62793 ($59.55 in chips)
Seat 3: 887f8eab ($9.7 in chips)
Seat 4: 45920dbc ($35.12 in chips)
Seat 5: Hero ($25 in chips)
Seat 6: bf64de7f ($8.92 in chips)
20b62793: posts small blind $0.1
887f8eab: posts big blind $0.25
*** HOLE CARDS ***
Dealt to a75a3d24 
Dealt to 20b62793 
Dealt to 887f8eab 
Dealt to 45920dbc 
Dealt to Hero [4h 2h]
Dealt to bf64de7f 
45920dbc: folds
Hero: folds
bf64de7f: folds
a75a3d24: raises $0.38 to $0.63
20b62793: folds
887f8eab: folds
Uncalled bet ($0.38) returned to a75a3d24
*** SHOWDOWN ***
a75a3d24 collected $0.6 from pot
*** SUMMARY ***
Total pot $0.6
Seat 1: a75a3d24 (button) collected ($0.6)
Seat 2: 20b62793 (small blind) folded before Flop
Seat 3: 887f8eab (big blind) folded before Flop
Seat 4: 45920dbc folded before Flop (didn't bet)
Seat 5: Hero folded before Flop (didn't bet)
Seat 6: bf64de7f folded before Flop (didn't bet)


Poker Hand #RC95086194: Hold'em No Limit ($0.1/$0.25) - 2020/04/07 15:19:05
Table 'RushAndCash364122' 6-max Seat #1 is the button
Seat 1: accea393 ($47.9 in chips)
Seat 2: 91c71347 ($25.45 in chips)
Seat 3: 6a4f7541 ($26.66 in chips)
Seat 4: Hero ($25 in chips)
Seat 5: 4c989e65 ($13.5 in chips)
Seat 6: 2d45ce80 ($9.01 in chips)
91c71347: posts small blind $0.1
6a4f7541: posts big blind $0.25
*** HOLE CARDS ***
Dealt to accea393 
Dealt to 91c71347 
Dealt to 6a4f7541 
Dealt to Hero [2s 2h]
Dealt to 4c989e65 
Dealt to 2d45ce80 
Hero: folds
4c989e65: folds
2d45ce80: folds
accea393: folds
91c71347: folds
Uncalled bet ($0.15) returned to 6a4f7541
*** SHOWDOWN ***
6a4f7541 collected $0.2 from pot
*** SUMMARY ***
Total pot $0.2
Seat 1: accea393 (button) folded before Flop (didn't bet)
Seat 2: 91c71347 (small blind) folded before Flop
Seat 3: 6a4f7541 (big blind) collected ($0.2)
Seat 4: Hero folded before Flop (didn't bet)
Seat 5: 4c989e65 folded before Flop (didn't bet)
Seat 6: 2d45ce80 folded before Flop (didn't bet)


Poker Hand #RC95086218: Hold'em No Limit ($0.1/$0.25) - 2020/04/07 15:19:08
Table 'RushAndCash364126' 6-max Seat #1 is the button
Seat 1: 91c71347 ($25.35 in chips)
Seat 2: b5d592d2 ($14.33 in chips)
Seat 3: Hero ($25 in chips)
Seat 4: f66d5ebb ($10.88 in chips)
Seat 5: d84d476b ($26.9 in chips)
Seat 6: 4c989e65 ($13.5 in chips)
b5d592d2: posts small blind $0.1
Hero: posts big blind $0.25
*** HOLE CARDS ***
Dealt to 91c71347 
Dealt to b5d592d2 
Dealt to Hero [Qs 2c]
Dealt to f66d5ebb 
Dealt to d84d476b 
Dealt to 4c989e65 
f66d5ebb: folds
d84d476b: folds
4c989e65: folds
91c71347: folds
b5d592d2: raises $0.38 to $0.63
Hero: folds
Uncalled bet ($0.38) returned to b5d592d2
*** SHOWDOWN ***
b5d592d2 collected $0.5 from pot
*** SUMMARY ***
Total pot $0.5
Seat 1: 91c71347 (button) folded before Flop (didn't bet)
Seat 2: b5d592d2 (small blind) collected ($0.5)
Seat 3: Hero (big blind) folded before Flop
Seat 4: f66d5ebb folded before Flop (didn't bet)
Seat 5: d84d476b folded before Flop (didn't bet)
Seat 6: 4c989e65 folded before Flop (didn't bet)


Poker Hand #RC95086287: Hold'em No Limit ($0.1/$0.25) - 2020/04/07 15:19:16
Table 'RushAndCash364137' 6-max Seat #1 is the button
Seat 1: d6f2a39c ($9.19 in chips)
Seat 2: Hero ($25 in chips)
Seat 3: fc5fc6fe ($12.5 in chips)
Seat 4: 7e4944ca ($24.11 in chips)
Seat 5: a4ba858f ($30.3 in chips)
Seat 6: cb835642 ($27.97 in chips)
Hero: posts small blind $0.1
fc5fc6fe: posts big blind $0.25
*** HOLE CARDS ***
Dealt to d6f2a39c 
Dealt to Hero [4d 2d]
Dealt to fc5fc6fe 
Dealt to 7e4944ca 
Dealt to a4ba858f 
Dealt to cb835642 
7e4944ca: raises $0.38 to $0.63
a4ba858f: folds
cb835642: folds
d6f2a39c: folds
Hero: folds
fc5fc6fe: folds
Uncalled bet ($0.38) returned to 7e4944ca
*** SHOWDOWN ***
7e4944ca collected $0.6 from pot
*** SUMMARY ***
Total pot $0.6
Seat 1: d6f2a39c (button) folded before Flop (didn't bet)
Seat 2: Hero (small blind) folded before Flop
Seat 3: fc5fc6fe (big blind) folded before Flop
Seat 4: 7e4944ca collected ($0.6)
Seat 5: a4ba858f folded before Flop (didn't bet)
Seat 6: cb835642 folded before Flop (didn't bet)


Poker Hand #RC95086330: Hold'em No Limit ($0.1/$0.25) - 2020/04/07 15:19:21
Table 'RushAndCash364144' 6-max Seat #1 is the button
Seat 1: Hero ($25 in chips)
Seat 2: bd460ce3 ($31.88 in chips)
Seat 3: 95083363 ($31.67 in chips)
Seat 4: 704a7fcf ($27.7 in chips)
Seat 5: 1780ed6 ($48.9 in chips)
Seat 6: fe5b2431 ($13.4 in chips)
bd460ce3: posts small blind $0.1
95083363: posts big blind $0.25
*** HOLE CARDS ***
Dealt to Hero [Kd 3h]
Dealt to bd460ce3 
Dealt to 95083363 
Dealt to 704a7fcf 
Dealt to 1780ed6 
Dealt to fe5b2431 
704a7fcf: folds
1780ed6: folds
fe5b2431: folds
Hero: folds
bd460ce3: folds
Uncalled bet ($0.15) returned to 95083363
*** SHOWDOWN ***
95083363 collected $0.2 from pot
*** SUMMARY ***
Total pot $0.2
Seat 1: Hero (button) folded before Flop (didn't bet)
Seat 2: bd460ce3 (small blind) folded before Flop
Seat 3: 95083363 (big blind) collected ($0.2)
Seat 4: 704a7fcf folded before Flop (didn't bet)
Seat 5: 1780ed6 folded before Flop (didn't bet)
Seat 6: fe5b2431 folded before Flop (didn't bet)


Poker Hand #RC95086355: Hold'em No Limit ($0.1/$0.25) - 2020/04/07 15:19:24
Table 'RushAndCash364149' 6-max Seat #1 is the button
Seat 1: b92cc87c ($9.49 in chips)
Seat 2: 3ff56a6c ($23.6 in chips)
Seat 3: dbf6981f ($48.05 in chips)
Seat 4: 432498db ($25.38 in chips)
Seat 5: Hero ($25 in chips)
Seat 6: 528a07f8 ($35.55 in chips)
3ff56a6c: posts small blind $0.1
dbf6981f: posts big blind $0.25
*** HOLE CARDS ***
Dealt to b92cc87c 
Dealt to 3ff56a6c 
Dealt to dbf6981f 
Dealt to 432498db 
Dealt to Hero [As 7h]
Dealt to 528a07f8 
432498db: folds
Hero: folds
528a07f8: folds
b92cc87c: raises $0.25 to $0.5
3ff56a6c: folds
dbf6981f: raises $1.65 to $2.15
b92cc87c: folds
Uncalled bet ($1.65) returned to dbf6981f
*** SHOWDOWN ***
dbf6981f collected $1.1 from pot
*** SUMMARY ***
Total pot $1.1
Seat 1: b92cc87c (button) folded before Flop
Seat 2: 3ff56a6c (small blind) folded before Flop
Seat 3: dbf6981f (big blind) collected ($1.1)
Seat 4: 432498db folded before Flop (didn't bet)
Seat 5: Hero folded before Flop (didn't bet)
Seat 6: 528a07f8 folded before Flop (didn't bet)


Poker Hand #RC95086380: Hold'em No Limit ($0.1/$0.25) - 2020/04/07 15:19:27
Table 'RushAndCash364153' 6-max Seat #1 is the button
Seat 1: 79cc211c ($26.56 in chips)
Seat 2: Hero ($25 in chips)
Seat 3: 895c14a7 ($12.6 in chips)
Seat 4: ce59b684 ($38.52 in chips)
Seat 5: 2dd038c3 ($10.43 in chips)
Seat 6: bf64de7f ($8.92 in chips)
Hero: posts small blind $0.1
895c14a7: posts big blind $0.25
*** HOLE CARDS ***
Dealt to 79cc211c 
Dealt to Hero [Js 5c]
Dealt to 895c14a7 
Dealt to ce59b684 
Dealt to 2dd038c3 
Dealt to bf64de7f 
ce59b684: folds
2dd038c3: folds
bf64de7f: folds
79cc211c: folds
Hero: folds
Uncalled bet ($0.15) returned to 895c14a7
*** SHOWDOWN ***
895c14a7 collected $0.2 from pot
*** SUMMARY ***
Total pot $0.2
Seat 1: 79cc211c (button) folded before Flop (didn't bet)
Seat 2: Hero (small blind) folded before Flop
Seat 3: 895c14a7 (big blind) collected ($0.2)
Seat 4: ce59b684 folded before Flop (didn't bet)
Seat 5: 2dd038c3 folded before Flop (didn't bet)
Seat 6: bf64de7f folded before Flop (didn't bet)


Poker Hand #RC95086437: Hold'em No Limit ($0.1/$0.25) - 2020/04/07 15:19:34
Table 'RushAndCash364164' 6-max Seat #1 is the button
Seat 1: Hero ($25 in chips)
Seat 2: a6fc3bd6 ($25.56 in chips)
Seat 3: 61ad32d ($14.06 in chips)
Seat 4: bd460ce3 ($31.78 in chips)
Seat 5: fd9dacc9 ($34.3 in chips)
Seat 6: 65837850 ($131.12 in chips)
a6fc3bd6: posts small blind $0.1
61ad32d: posts big blind $0.25
*** HOLE CARDS ***
Dealt to Hero [9h 5s]
Dealt to a6fc3bd6 
Dealt to 61ad32d 
Dealt to bd460ce3 
Dealt to fd9dacc9 
Dealt to 65837850 
bd460ce3: folds
fd9dacc9: folds
65837850: raises $0.38 to $0.63
Hero: folds
a6fc3bd6: folds
61ad32d: folds
Uncalled bet ($0.38) returned to 65837850
*** SHOWDOWN ***
65837850 collected $0.6 from pot
*** SUMMARY ***
Total pot $0.6
Seat 1: Hero (button) folded before Flop (didn't bet)
Seat 2: a6fc3bd6 (small blind) folded before Flop
Seat 3: 61ad32d (big blind) folded before Flop
Seat 4: bd460ce3 folded before Flop (didn't bet)
Seat 5: fd9dacc9 folded before Flop (didn't bet)
Seat 6: 65837850 collected ($0.6)


Poker Hand #RC95086461: Hold'em No Limit ($0.1/$0.25) - 2020/04/07 15:19:39
Table 'RushAndCash364168' 6-max Seat #1 is the button
Seat 1: 1780ed6 ($49.25 in chips)
Seat 2: f66d5ebb ($10.13 in chips)
Seat 3: 432498db ($25.38 in chips)
Seat 4: 2dd038c3 ($10.43 in chips)
Seat 5: Hero ($25 in chips)
Seat 6: a6fc3bd6 ($25.46 in chips)
f66d5ebb: posts small blind $0.1
432498db: posts big blind $0.25
*** HOLE CARDS ***
Dealt to 1780ed6 
Dealt to f66d5ebb 
Dealt to 432498db 
Dealt to 2dd038c3 
Dealt to Hero [Td 9s]
Dealt to a6fc3bd6 
2dd038c3: folds
Hero: folds
a6fc3bd6: folds
1780ed6: folds
f66d5ebb: folds
Uncalled bet ($0.15) returned to 432498db
*** SHOWDOWN ***
432498db collected $0.2 from pot
*** SUMMARY ***
Total pot $0.2
Seat 1: 1780ed6 (button) folded before Flop (didn't bet)
Seat 2: f66d5ebb (small blind) folded before Flop
Seat 3: 432498db (big blind) collected ($0.2)
Seat 4: 2dd038c3 folded before Flop (didn't bet)
Seat 5: Hero folded before Flop (didn't bet)
Seat 6: a6fc3bd6 folded before Flop (didn't bet)


Poker Hand #RC95086513: Hold'em No Limit ($0.1/$0.25) - 2020/04/07 15:19:45
Table 'RushAndCash364177' 6-max Seat #1 is the button
Seat 1: 61ad32d ($13.81 in chips)
Seat 2: 62eebc49 ($125.11 in chips)
Seat 3: 4dd920ba ($31 in chips)
Seat 4: Hero ($25 in chips)
Seat 5: 3c96062f ($22.76 in chips)
Seat 6: 8ebd1db4 ($28.77 in chips)
62eebc49: posts small blind $0.1
4dd920ba: posts big blind $0.25
*** HOLE CARDS ***
Dealt to 61ad32d 
Dealt to 62eebc49 
Dealt to 4dd920ba 
Dealt to Hero [As 9d]
Dealt to 3c96062f 
Dealt to 8ebd1db4 
Hero: folds
3c96062f: folds
8ebd1db4: folds
61ad32d: folds
62eebc49: calls $0.15
4dd920ba: checks
*** FLOP *** [Kh 4d Tc]
62eebc49: checks
4dd920ba: checks
*** TURN *** [Kh 4d Tc] [2d]
62eebc49: checks
4dd920ba: checks
*** RIVER *** [Kh 4d Tc 2d] [5h]
62eebc49: checks
4dd920ba: checks
62eebc49: shows [Qh 7h] (King-High)
4dd920ba: shows [2s 8h] (Pair of Twos)
*** SHOWDOWN ***
4dd920ba collected $0.5 from pot
*** SUMMARY ***
Total pot $0.5
Board [Kh 4d Tc 2d 5h]
Seat 1: 61ad32d (button) folded before Flop (didn't bet)
Seat 2: 62eebc49 (small blind) showed [Qh 7h] and lost with King-High
Seat 3: 4dd920ba (big blind) showed [8h 2s] and won ($0.5) with Pair of Twos
Seat 4: Hero folded before Flop (didn't bet)
Seat 5: 3c96062f folded before Flop (didn't bet)
Seat 6: 8ebd1db4 folded before Flop (didn't bet)


Poker Hand #RC95086544: Hold'em No Limit ($0.1/$0.25) - 2020/04/07 15:19:49
Table 'RushAndCash364182' 6-max Seat #1 is the button
Seat 1: 704a7fcf ($27.6 in chips)
Seat 2: 24a8e574 ($29.88 in chips)
Seat 3: Hero ($25 in chips)
Seat 4: 61ad32d ($13.81 in chips)
Seat 5: fc8a29ea ($87.48 in chips)
Seat 6: 3c96062f ($22.76 in chips)
24a8e574: posts small blind $0.1
Hero: posts big blind $0.25
*** HOLE CARDS ***
Dealt to 704a7fcf 
Dealt to 24a8e574 
Dealt to Hero [7d 7c]
Dealt to 61ad32d 
Dealt to fc8a29ea 
Dealt to 3c96062f 
61ad32d: folds
fc8a29ea: folds
3c96062f: folds
704a7fcf: raises $0.38 to $0.63
24a8e574: folds
Hero: calls $0.38
*** FLOP *** [3d Ac 5d]
Hero: checks
704a7fcf: bets $0.5
Hero: calls $0.5
*** TURN *** [3d Ac 5d] [Ks]
Hero: checks
704a7fcf: checks
*** RIVER *** [3d Ac 5d Ks] [5s]
Hero: checks
704a7fcf: checks
Hero: shows [7c 7d] (Pair of Sevens and Pair of Fives)
704a7fcf: shows [9d Kd] (Pair of Kings and Pair of Fives)
*** SHOWDOWN ***
704a7fcf collected $2.36 from pot
*** SUMMARY ***
Total pot $2.36
Board [3d Ac 5d Ks 5s]
Seat 1: 704a7fcf (button) showed [Kd 9d] and won ($2.36) with Pair of Kings and Pair of Fives
Seat 2: 24a8e574 (small blind) folded before Flop
Seat 3: Hero (big blind) showed [7d 7c] and lost with Pair of Sevens and Pair of Fives
Seat 4: 61ad32d folded before Flop (didn't bet)
Seat 5: fc8a29ea folded before Flop (didn't bet)
Seat 6: 3c96062f folded before Flop (didn't bet)


Poker Hand #RC95086907: Hold'em No Limit ($0.1/$0.25) - 2020/04/07 15:20:34
Table 'RushAndCash364244' 6-max Seat #1 is the button
Seat 1: d05d0db2 ($32.58 in chips)
Seat 2: 3cfd7308 ($40.99 in chips)
Seat 3: d2986703 ($39.5 in chips)
Seat 4: 103129d8 ($24.4 in chips)
Seat 5: Hero ($25 in chips)
Seat 6: 1055451d ($12.77 in chips)
3cfd7308: posts small blind $0.1
d2986703: posts big blind $0.25
*** HOLE CARDS ***
Dealt to d05d0db2 
Dealt to 3cfd7308 
Dealt to d2986703 
Dealt to 103129d8 
Dealt to Hero [9h 6d]
Dealt to 1055451d 
103129d8: raises $0.75 to $1
Hero: folds
1055451d: folds
d05d0db2: folds
3cfd7308: folds
d2986703: folds
Uncalled bet ($0.75) returned to 103129d8
*** SHOWDOWN ***
103129d8 collected $0.6 from pot
*** SUMMARY ***
Total pot $0.6
Seat 1: d05d0db2 (button) folded before Flop (didn't bet)
Seat 2: 3cfd7308 (small blind) folded before Flop
Seat 3: d2986703 (big blind) folded before Flop
Seat 4: 103129d8 collected ($0.6)
Seat 5: Hero folded before Flop (didn't bet)
Seat 6: 1055451d folded before Flop (didn't bet)


Poker Hand #RC95086937: Hold'em No Limit ($0.1/$0.25) - 2020/04/07 15:20:38
Table 'RushAndCash364249' 6-max Seat #1 is the button
Seat 1: f7ed681a ($13.68 in chips)
Seat 2: Hero ($25 in chips)
Seat 3: 6736194e ($24.65 in chips)
Seat 4: 528a07f8 ($35.98 in chips)
Seat 5: 49b3e425 ($22.19 in chips)
Seat 6: ce2bf8ea ($28.02 in chips)
Hero: posts small blind $0.1
6736194e: posts big blind $0.25
*** HOLE CARDS ***
Dealt to f7ed681a 
Dealt to Hero [Tc 5s]
Dealt to 6736194e 
Dealt to 528a07f8 
Dealt to 49b3e425 
Dealt to ce2bf8ea 
528a07f8: raises $0.38 to $0.63
49b3e425: folds
ce2bf8ea: raises $1.28 to $1.91
f7ed681a: folds
Hero: folds
6736194e: folds
528a07f8: folds
Uncalled bet ($1.28) returned to ce2bf8ea
*** SHOWDOWN ***
ce2bf8ea collected $1.61 from pot
*** SUMMARY ***
Total pot $1.61
Seat 1: f7ed681a (button) folded before Flop (didn't bet)
Seat 2: Hero (small blind) folded before Flop
Seat 3: 6736194e (big blind) folded before Flop
Seat 4: 528a07f8 folded before Flop
Seat 5: 49b3e425 folded before Flop (didn't bet)
Seat 6: ce2bf8ea collected ($1.61)


Poker Hand #RC95086968: Hold'em No Limit ($0.1/$0.25) - 2020/04/07 15:20:43
Table 'RushAndCash364256' 6-max Seat #1 is the button
Seat 1: dbf6981f ($49.67 in chips)
Seat 2: af84e661 ($5.97 in chips)
Seat 3: 49b3e425 ($22.19 in chips)
Seat 4: 7e4944ca ($23.58 in chips)
Seat 5: Hero ($25 in chips)
Seat 6: 7c0ffa93 ($28.14 in chips)
af84e661: posts small blind $0.1
49b3e425: posts big blind $0.25
*** HOLE CARDS ***
Dealt to dbf6981f 
Dealt to af84e661 
Dealt to 49b3e425 
Dealt to 7e4944ca 
Dealt to Hero [7s 3s]
Dealt to 7c0ffa93 
7e4944ca: folds
Hero: folds
7c0ffa93: raises $0.38 to $0.63
dbf6981f: folds
af84e661: folds
49b3e425: folds
Uncalled bet ($0.38) returned to 7c0ffa93
*** SHOWDOWN ***
7c0ffa93 collected $0.6 from pot
*** SUMMARY ***
Total pot $0.6
Seat 1: dbf6981f (button) folded before Flop (didn't bet)
Seat 2: af84e661 (small blind) folded before Flop
Seat 3: 49b3e425 (big blind) folded before Flop
Seat 4: 7e4944ca folded before Flop (didn't bet)
Seat 5: Hero folded before Flop (didn't bet)
Seat 6: 7c0ffa93 collected ($0.6)


Poker Hand #RC95087021: Hold'em No Limit ($0.1/$0.25) - 2020/04/07 15:20:50
Table 'RushAndCash364266' 6-max Seat #1 is the button
Seat 1: 6a4f7541 ($25.35 in chips)
Seat 2: 6736194e ($24.4 in chips)
Seat 3: 89387862 ($25 in chips)
Seat 4: Hero ($25 in chips)
Seat 5: a6fc3bd6 ($23.56 in chips)
Seat 6: 3f5f9735 ($21.14 in chips)
6736194e: posts small blind $0.1
89387862: posts big blind $0.25
*** HOLE CARDS ***
Dealt to 6a4f7541 
Dealt to 6736194e 
Dealt to 89387862 
Dealt to Hero [6h 5h]
Dealt to a6fc3bd6 
Dealt to 3f5f9735 
Hero: raises $0.38 to $0.63
a6fc3bd6: folds
3f5f9735: folds
6a4f7541: folds
6736194e: calls $0.53
89387862: folds
*** FLOP *** [Qs 9d 7d]
6736194e: checks
Hero: bets $1.05
6736194e: calls $1.05
*** TURN *** [Qs 9d 7d] [Kc]
6736194e: checks
Hero: checks
*** RIVER *** [Qs 9d 7d Kc] [3d]
6736194e: checks
Hero: bets $2.8
6736194e: calls $2.8
Hero: shows [6h 5h] (King-High)
6736194e: shows [Kh Qh] (Pair of Kings and Pair of Queens)
*** SHOWDOWN ***
6736194e collected $9.21 from pot
*** SUMMARY ***
Total pot $9.21
Board [Qs 9d 7d Kc 3d]
Seat 1: 6a4f7541 (button) folded before Flop (didn't bet)
Seat 2: 6736194e (small blind) showed [Kh Qh] and won ($9.21) with Pair of Kings and Pair of Queens
Seat 3: 89387862 (big blind) folded before Flop
Seat 4: Hero showed [6h 5h] and lost with King-High
Seat 5: a6fc3bd6 folded before Flop (didn't bet)
Seat 6: 3f5f9735 folded before Flop (didn't bet)


Poker Hand #RC95087436: Hold'em No Limit ($0.1/$0.25) - 2020/04/07 15:21:44
Table 'RushAndCash364330' 6-max Seat #1 is the button
Seat 1: 6736194e ($28.42 in chips)
Seat 2: cb835642 ($27.27 in chips)
Seat 3: Hero ($25 in chips)
Seat 4: 30cab83a ($25 in chips)
Seat 5: 1055451d ($12.5 in chips)
Seat 6: 32953d2a ($12.5 in chips)
cb835642: posts small blind $0.1
Hero: posts big blind $0.25
*** HOLE CARDS ***
Dealt to 6736194e 
Dealt to cb835642 
Dealt to Hero [4s 4h]
Dealt to 30cab83a 
Dealt to 1055451d 
Dealt to 32953d2a 
30cab83a: raises $0.38 to $0.63
1055451d: calls $0.63
32953d2a: folds
6736194e: folds
cb835642: folds
Hero: calls $0.38
*** FLOP *** [Qh 7c 2s]
Hero: checks
30cab83a: bets $0.7
1055451d: folds
Hero: calls $0.7
*** TURN *** [Qh 7c 2s] [Qc]
Hero: checks
30cab83a: bets $1.7
Hero: folds
Uncalled bet ($1.7) returned to 30cab83a
*** SHOWDOWN ***
30cab83a collected $3.39 from pot
*** SUMMARY ***
Total pot $3.39
Board [Qh 7c 2s Qc]
Seat 1: 6736194e (button) folded before Flop (didn't bet)
Seat 2: cb835642 (small blind) folded before Flop
Seat 3: Hero (big blind) folded on the Turn
Seat 4: 30cab83a won ($3.39)
Seat 5: 1055451d folded on the Flop
Seat 6: 32953d2a folded before Flop (didn't bet)


Poker Hand #RC95087924: Hold'em No Limit ($0.1/$0.25) - 2020/04/07 15:22:48
Table 'RushAndCash364404' 6-max Seat #1 is the button
Seat 1: Hero ($25 in chips)
Seat 2: fe3f48f4 ($25 in chips)
Seat 3: 79cc211c ($26.67 in chips)
Seat 4: e6c023d1 ($36.74 in chips)
Seat 5: c88456c4 ($6.3 in chips)
Seat 6: be711e9d ($30.74 in chips)
fe3f48f4: posts small blind $0.1
79cc211c: posts big blind $0.25
*** HOLE CARDS ***
Dealt to Hero [Qc Js]
Dealt to fe3f48f4 
Dealt to 79cc211c 
Dealt to e6c023d1 
Dealt to c88456c4 
Dealt to be711e9d 
e6c023d1: folds
c88456c4: folds
be711e9d: folds
Hero: raises $0.38 to $0.63
fe3f48f4: folds
79cc211c: folds
Uncalled bet ($0.38) returned to Hero
*** SHOWDOWN ***
Hero collected $0.6 from pot
*** SUMMARY ***
Total pot $0.6
Seat 1: Hero (button) collected ($0.6)
Seat 2: fe3f48f4 (small blind) folded before Flop
Seat 3: 79cc211c (big blind) folded before Flop
Seat 4: e6c023d1 folded before Flop (didn't bet)
Seat 5: c88456c4 folded before Flop (didn't bet)
Seat 6: be711e9d folded before Flop (didn't bet)


Poker Hand #RC95088014: Hold'em No Limit ($0.1/$0.25) - 2020/04/07 15:23:00
Table 'RushAndCash364418' 6-max Seat #1 is the button
Seat 1: fd9dacc9 ($45.63 in chips)
Seat 2: cfe992dd ($26.45 in chips)
Seat 3: fe5b2431 ($12.75 in chips)
Seat 4: 4dd920ba ($26.78 in chips)
Seat 5: Hero ($25.35 in chips)
Seat 6: deb69778 ($25 in chips)
cfe992dd: posts small blind $0.1
fe5b2431: posts big blind $0.25
*** HOLE CARDS ***
Dealt to fd9dacc9 
Dealt to cfe992dd 
Dealt to fe5b2431 
Dealt to 4dd920ba 
Dealt to Hero [Jh 2h]
Dealt to deb69778 
4dd920ba: folds
Hero: folds
deb69778: folds
fd9dacc9: folds
cfe992dd: raises $0.5 to $0.75
fe5b2431: folds
Uncalled bet ($0.5) returned to cfe992dd
*** SHOWDOWN ***
cfe992dd collected $0.5 from pot
*** SUMMARY ***
Total pot $0.5
Seat 1: fd9dacc9 (button) folded before Flop (didn't bet)
Seat 2: cfe992dd (small blind) collected ($0.5)
Seat 3: fe5b2431 (big blind) folded before Flop
Seat 4: 4dd920ba folded before Flop (didn't bet)
Seat 5: Hero folded before Flop (didn't bet)
Seat 6: deb69778 folded before Flop (didn't bet)


Poker Hand #RC95088037: Hold'em No Limit ($0.1/$0.25) - 2020/04/07 15:23:03
Table 'RushAndCash364421' 6-max Seat #1 is the button
Seat 1: Hero ($25.35 in chips)
Seat 2: d437c92d ($61.59 in chips)
Seat 3: 432498db ($25 in chips)
Seat 4: 7c0ffa93 ($28.23 in chips)
Seat 5: ce59b684 ($39.64 in chips)
Seat 6: 202599c6 ($25.35 in chips)
d437c92d: posts small blind $0.1
432498db: posts big blind $0.25
*** HOLE CARDS ***
Dealt to Hero [9s 4d]
Dealt to d437c92d 
Dealt to 432498db 
Dealt to 7c0ffa93 
Dealt to ce59b684 
Dealt to 202599c6 
7c0ffa93: folds
ce59b684: raises $0.38 to $0.63
202599c6: folds
Hero: folds
d437c92d: folds
432498db: calls $0.38
*** FLOP *** [Ts Ah Ad]
432498db: checks
ce59b684: checks
*** TURN *** [Ts Ah Ad] [Jd]
432498db: checks
ce59b684: bets $1.65
432498db: calls $1.65
*** RIVER *** [Ts Ah Ad Jd] [7s]
432498db: checks
ce59b684: checks
432498db: shows [Th Jh] (Pair of Aces and Pair of Jacks)
ce59b684: shows [4h 6h] (Pair of Aces)
*** SHOWDOWN ***
432498db collected $4.66 from pot
*** SUMMARY ***
Total pot $4.66
Board [Ts Ah Ad Jd 7s]
Seat 1: Hero (button) folded before Flop (didn't bet)
Seat 2: d437c92d (small blind) folded before Flop
Seat 3: 432498db (big blind) showed [Jh Th] and won ($4.66) with Pair of Aces and Pair of Jacks
Seat 4: 7c0ffa93 folded before Flop (didn't bet)
Seat 5: ce59b684 showed [6h 4h] and lost with Pair of Aces
Seat 6: 202599c6 folded before Flop (didn't bet)


Poker Hand #RC95088180: Hold'em No Limit ($0.1/$0.25) - 2020/04/07 15:23:21
Table 'RushAndCash364441' 6-max Seat #1 is the button
Seat 1: b5d592d2 ($11.93 in chips)
Seat 2: bd460ce3 ($19.23 in chips)
Seat 3: Hero ($25.35 in chips)
Seat 4: 518d077e ($34.72 in chips)
Seat 5: 528a07f8 ($35.35 in chips)
Seat 6: 3c96062f ($12.72 in chips)
bd460ce3: posts small blind $0.1
Hero: posts big blind $0.25
*** HOLE CARDS ***
Dealt to b5d592d2 
Dealt to bd460ce3 
Dealt to Hero [8s 3c]
Dealt to 518d077e 
Dealt to 528a07f8 
Dealt to 3c96062f 
518d077e: raises $0.38 to $0.63
528a07f8: folds
3c96062f: calls $0.63
b5d592d2: raises $1.87 to $2.5
bd460ce3: folds
Hero: folds
518d077e: folds
3c96062f: calls $1.87
*** FLOP *** [Kh Td 8c]
3c96062f: checks
b5d592d2: bets $2
3c96062f: folds
Uncalled bet ($2) returned to b5d592d2
*** SHOWDOWN ***
b5d592d2 collected $5.98 from pot
*** SUMMARY ***
Total pot $5.98
Board [Kh Td 8c]
Seat 1: b5d592d2 (button) won ($5.98)
Seat 2: bd460ce3 (small blind) folded before Flop
Seat 3: Hero (big blind) folded before Flop
Seat 4: 518d077e folded before Flop
Seat 5: 528a07f8 folded before Flop (didn't bet)
Seat 6: 3c96062f folded on the Flop


Poker Hand #RC95088238: Hold'em No Limit ($0.1/$0.25) - 2020/04/07 15:23:29
Table 'RushAndCash364448' 6-max Seat #1 is the button
Seat 1: 4dd920ba ($26.88 in chips)
Seat 2: 324d8e1d ($28.88 in chips)
Seat 3: 3f5f9735 ($25 in chips)
Seat 4: 5794e88f ($38.95 in chips)
Seat 5: Hero ($25.1 in chips)
Seat 6: 3ff56a6c ($24.92 in chips)
324d8e1d: posts small blind $0.1
3f5f9735: posts big blind $0.25
*** HOLE CARDS ***
Dealt to 4dd920ba 
Dealt to 324d8e1d 
Dealt to 3f5f9735 
Dealt to 5794e88f 
Dealt to Hero [Qs Th]
Dealt to 3ff56a6c 
5794e88f: folds
Hero: folds
3ff56a6c: raises $0.38 to $0.63
4dd920ba: calls $0.63
324d8e1d: folds
3f5f9735: calls $0.38
*** FLOP *** [8s 4d Ks]
3f5f9735: checks
3ff56a6c: bets $0.75
4dd920ba: calls $0.75
3f5f9735: calls $0.75
*** TURN *** [8s 4d Ks] [9s]
3f5f9735: checks
3ff56a6c: bets $2.75
4dd920ba: folds
3f5f9735: folds
Uncalled bet ($2.75) returned to 3ff56a6c
*** SHOWDOWN ***
3ff56a6c collected $4.24 from pot
*** SUMMARY ***
Total pot $4.24
Board [8s 4d Ks 9s]
Seat 1: 4dd920ba (button) folded on the Turn
Seat 2: 324d8e1d (small blind) folded before Flop
Seat 3: 3f5f9735 (big blind) folded on the Turn
Seat 4: 5794e88f folded before Flop (didn't bet)
Seat 5: Hero folded before Flop (didn't bet)
Seat 6: 3ff56a6c won ($4.24)


Poker Hand #RC95088270: Hold'em No Limit ($0.1/$0.25) - 2020/04/07 15:23:33
Table 'RushAndCash364451' 6-max Seat #1 is the button
Seat 1: 5794e88f ($38.95 in chips)
Seat 2: 1780ed6 ($48.95 in chips)
Seat 3: ce2bf8ea ($25.67 in chips)
Seat 4: Hero ($25.1 in chips)
Seat 5: 79cc211c ($26.77 in chips)
Seat 6: d437c92d ($61.39 in chips)
1780ed6: posts small blind $0.1
ce2bf8ea: posts big blind $0.25
*** HOLE CARDS ***
Dealt to 5794e88f 
Dealt to 1780ed6 
Dealt to ce2bf8ea 
Dealt to Hero [Qd 5d]
Dealt to 79cc211c 
Dealt to d437c92d 
Hero: folds
79cc211c: folds
d437c92d: folds
5794e88f: folds
1780ed6: raises $0.5 to $0.75
ce2bf8ea: folds
Uncalled bet ($0.5) returned to 1780ed6
*** SHOWDOWN ***
1780ed6 collected $0.5 from pot
*** SUMMARY ***
Total pot $0.5
Seat 1: 5794e88f (button) folded before Flop (didn't bet)
Seat 2: 1780ed6 (small blind) collected ($0.5)
Seat 3: ce2bf8ea (big blind) folded before Flop
Seat 4: Hero folded before Flop (didn't bet)
Seat 5: 79cc211c folded before Flop (didn't bet)
Seat 6: d437c92d folded before Flop (didn't bet)


Poker Hand #RC95088310: Hold'em No Limit ($0.1/$0.25) - 2020/04/07 15:23:38
Table 'RushAndCash364455' 6-max Seat #1 is the button
Seat 1: d6f2a39c ($8.2 in chips)
Seat 2: Hero ($25.1 in chips)
Seat 3: 704a7fcf ($28.62 in chips)
Seat 4: 6752758b ($16.76 in chips)
Seat 5: a0d04110 ($41.2 in chips)
Seat 6: d84d476b ($29.27 in chips)
Hero: posts small blind $0.1
704a7fcf: posts big blind $0.25
*** HOLE CARDS ***
Dealt to d6f2a39c 
Dealt to Hero [9d 5s]
Dealt to 704a7fcf 
Dealt to 6752758b 
Dealt to a0d04110 
Dealt to d84d476b 
6752758b: folds
a0d04110: raises $0.38 to $0.63
d84d476b: folds
d6f2a39c: folds
Hero: folds
704a7fcf: folds
Uncalled bet ($0.38) returned to a0d04110
*** SHOWDOWN ***
a0d04110 collected $0.6 from pot
*** SUMMARY ***
Total pot $0.6
Seat 1: d6f2a39c (button) folded before Flop (didn't bet)
Seat 2: Hero (small blind) folded before Flop
Seat 3: 704a7fcf (big blind) folded before Flop
Seat 4: 6752758b folded before Flop (didn't bet)
Seat 5: a0d04110 collected ($0.6)
Seat 6: d84d476b folded before Flop (didn't bet)


Poker Hand #RC95088367: Hold'em No Limit ($0.1/$0.25) - 2020/04/07 15:23:45
Table 'RushAndCash364463' 6-max Seat #1 is the button
Seat 1: bbb85b3f ($37.35 in chips)
Seat 2: 528a07f8 ($35.45 in chips)
Seat 3: cc092a76 ($10.84 in chips)
Seat 4: Hero ($25 in chips)
Seat 5: 2dd038c3 ($5.28 in chips)
Seat 6: bf64de7f ($9.25 in chips)
528a07f8: posts small blind $0.1
cc092a76: posts big blind $0.25
*** HOLE CARDS ***
Dealt to bbb85b3f 
Dealt to 528a07f8 
Dealt to cc092a76 
Dealt to Hero [Qc 3c]
Dealt to 2dd038c3 
Dealt to bf64de7f 
Hero: folds
2dd038c3: folds
bf64de7f: folds
bbb85b3f: folds
528a07f8: raises $0.5 to $0.75
cc092a76: calls $0.5
*** FLOP *** [5h Qs 7d]
528a07f8: checks
cc092a76: checks
*** TURN *** [5h Qs 7d] [Kh]
528a07f8: bets $1.5
cc092a76: calls $1.5
*** RIVER *** [5h Qs 7d Kh] [9c]
528a07f8: checks
cc092a76: bets $3.5
528a07f8: folds
Uncalled bet ($3.5) returned to cc092a76
*** SHOWDOWN ***
cc092a76 collected $4.5 from pot
*** SUMMARY ***
Total pot $4.5
Board [5h Qs 7d Kh 9c]
Seat 1: bbb85b3f (button) folded before Flop (didn't bet)
Seat 2: 528a07f8 (small blind) folded on the River
Seat 3: cc092a76 (big blind) won ($4.5)
Seat 4: Hero folded before Flop (didn't bet)
Seat 5: 2dd038c3 folded before Flop (didn't bet)
Seat 6: bf64de7f folded before Flop (didn't bet)


Poker Hand #RC95088412: Hold'em No Limit ($0.1/$0.25) - 2020/04/07 15:23:51
Table 'RushAndCash364467' 6-max Seat #1 is the button
Seat 1: Hero ($25 in chips)
Seat 2: a6fc3bd6 ($25 in chips)
Seat 3: 74937d40 ($29.94 in chips)
Seat 4: 275e7f74 ($34.97 in chips)
Seat 5: 91c71347 ($32.1 in chips)
Seat 6: 1055451d ($12.5 in chips)
a6fc3bd6: posts small blind $0.1
74937d40: posts big blind $0.25
*** HOLE CARDS ***
Dealt to Hero [9s 7c]
Dealt to a6fc3bd6 
Dealt to 74937d40 
Dealt to 275e7f74 
Dealt to 91c71347 
Dealt to 1055451d 
275e7f74: folds
91c71347: folds
1055451d: folds
Hero: folds
a6fc3bd6: folds
Uncalled bet ($0.15) returned to 74937d40
*** SHOWDOWN ***
74937d40 collected $0.2 from pot
*** SUMMARY ***
Total pot $0.2
Seat 1: Hero (button) folded before Flop (didn't bet)
Seat 2: a6fc3bd6 (small blind) folded before Flop
Seat 3: 74937d40 (big blind) collected ($0.2)
Seat 4: 275e7f74 folded before Flop (didn't bet)
Seat 5: 91c71347 folded before Flop (didn't bet)
Seat 6: 1055451d folded before Flop (didn't bet)


Poker Hand #RC95088443: Hold'em No Limit ($0.1/$0.25) - 2020/04/07 15:23:56
Table 'RushAndCash364470' 6-max Seat #1 is the button
Seat 1: 91c71347 ($32.1 in chips)
Seat 2: 275e7f74 ($34.97 in chips)
Seat 3: 6752758b ($16.76 in chips)
Seat 4: Hero ($25 in chips)
Seat 5: 6736194e ($27.67 in chips)
Seat 6: a2f2938c ($25 in chips)
275e7f74: posts small blind $0.1
6752758b: posts big blind $0.25
*** HOLE CARDS ***
Dealt to 91c71347 
Dealt to 275e7f74 
Dealt to 6752758b 
Dealt to Hero [Qh 4c]
Dealt to 6736194e 
Dealt to a2f2938c 
Hero: folds
6736194e: folds
a2f2938c: folds
91c71347: folds
275e7f74: raises $0.5 to $0.75
6752758b: folds
Uncalled bet ($0.5) returned to 275e7f74
*** SHOWDOWN ***
275e7f74 collected $0.5 from pot
*** SUMMARY ***
Total pot $0.5
Seat 1: 91c71347 (button) folded before Flop (didn't bet)
Seat 2: 275e7f74 (small blind) collected ($0.5)
Seat 3: 6752758b (big blind) folded before Flop
Seat 4: Hero folded before Flop (didn't bet)
Seat 5: 6736194e folded before Flop (didn't bet)
Seat 6: a2f2938c folded before Flop (didn't bet)


Poker Hand #RC95088470: Hold'em No Limit ($0.1/$0.25) - 2020/04/07 15:23:59
Table 'RushAndCash364475' 6-max Seat #1 is the button
Seat 1: 289f2e46 ($28.43 in chips)
Seat 2: 91c71347 ($32.1 in chips)
Seat 3: 4c989e65 ($1.36 in chips)
Seat 4: Hero ($25 in chips)
Seat 5: fc5fc6fe ($12.5 in chips)
Seat 6: bbb85b3f ($37.35 in chips)
91c71347: posts small blind $0.1
4c989e65: posts big blind $0.25
*** HOLE CARDS ***
Dealt to 289f2e46 
Dealt to 91c71347 
Dealt to 4c989e65 
Dealt to Hero [8h 5h]
Dealt to fc5fc6fe 
Dealt to bbb85b3f 
Hero: folds
fc5fc6fe: folds
bbb85b3f: folds
289f2e46: raises $0.5 to $0.75
91c71347: folds
4c989e65: folds
Uncalled bet ($0.5) returned to 289f2e46
*** SHOWDOWN ***
289f2e46 collected $0.6 from pot
*** SUMMARY ***
Total pot $0.6
Seat 1: 289f2e46 (button) collected ($0.6)
Seat 2: 91c71347 (small blind) folded before Flop
Seat 3: 4c989e65 (big blind) folded before Flop
Seat 4: Hero folded before Flop (didn't bet)
Seat 5: fc5fc6fe folded before Flop (didn't bet)
Seat 6: bbb85b3f folded before Flop (didn't bet)


Poker Hand #RC95088512: Hold'em No Limit ($0.1/$0.25) - 2020/04/07 15:24:05
Table 'RushAndCash364481' 6-max Seat #1 is the button
Seat 1: 6a4f7541 ($26.2 in chips)
Seat 2: Hero ($25 in chips)
Seat 3: e4c4c11e ($9.25 in chips)
Seat 4: d84d476b ($29.62 in chips)
Seat 5: 603fb192 ($17.14 in chips)
Seat 6: 704a7fcf ($28.37 in chips)
Hero: posts small blind $0.1
e4c4c11e: posts big blind $0.25
*** HOLE CARDS ***
Dealt to 6a4f7541 
Dealt to Hero [8h 7c]
Dealt to e4c4c11e 
Dealt to d84d476b 
Dealt to 603fb192 
Dealt to 704a7fcf 
d84d476b: folds
603fb192: folds
704a7fcf: folds
6a4f7541: raises $0.5 to $0.75
Hero: folds
e4c4c11e: folds
Uncalled bet ($0.5) returned to 6a4f7541
*** SHOWDOWN ***
6a4f7541 collected $0.6 from pot
*** SUMMARY ***
Total pot $0.6
Seat 1: 6a4f7541 (button) collected ($0.6)
Seat 2: Hero (small blind) folded before Flop
Seat 3: e4c4c11e (big blind) folded before Flop
Seat 4: d84d476b folded before Flop (didn't bet)
Seat 5: 603fb192 folded before Flop (didn't bet)
Seat 6: 704a7fcf folded before Flop (didn't bet)


Poker Hand #RC95088559: Hold'em No Limit ($0.1/$0.25) - 2020/04/07 15:24:10
Table 'RushAndCash364487' 6-max Seat #1 is the button
Seat 1: b31e5039 ($12.56 in chips)
Seat 2: 1055451d ($12.5 in chips)
Seat 3: Hero ($25 in chips)
Seat 4: 5d360146 ($11.14 in chips)
Seat 5: 52ee6b3d ($25 in chips)
Seat 6: 6736194e ($27.67 in chips)
1055451d: posts small blind $0.1
Hero: posts big blind $0.25
*** HOLE CARDS ***
Dealt to b31e5039 
Dealt to 1055451d 
Dealt to Hero [7h 7d]
Dealt to 5d360146 
Dealt to 52ee6b3d 
Dealt to 6736194e 
5d360146: raises $0.5 to $0.75
52ee6b3d: folds
6736194e: folds
b31e5039: calls $0.75
1055451d: folds
Hero: calls $0.5
*** FLOP *** [Qs Td 9c]
Hero: checks
5d360146: checks
b31e5039: checks
*** TURN *** [Qs Td 9c] [Js]
Hero: checks
5d360146: checks
b31e5039: checks
*** RIVER *** [Qs Td 9c Js] [6s]
Hero: checks
5d360146: checks
b31e5039: checks
Hero: shows [7d 7h] (Pair of Sevens)
5d360146: shows [5c 6c] (Pair of Sixes)
b31e5039: shows [5s 5h] (Pair of Fives)
*** SHOWDOWN ***
Hero collected $2.35 from pot
*** SUMMARY ***
Total pot $2.35
Board [Qs Td 9c Js 6s]
Seat 1: b31e5039 (button) showed [5s 5h] and lost with Pair of Fives
Seat 2: 1055451d (small blind) folded before Flop
Seat 3: Hero (big blind) showed [7h 7d] and won ($2.35) with Pair of Sevens
Seat 4: 5d360146 showed [6c 5c] and lost with Pair of Sixes
Seat 5: 52ee6b3d folded before Flop (didn't bet)
Seat 6: 6736194e folded before Flop (didn't bet)


Poker Hand #RC95089236: Hold'em No Limit ($0.1/$0.25) - 2020/04/07 15:25:33
Table 'RushAndCash364584' 6-max Seat #1 is the button
Seat 1: a296ff49 ($12.71 in chips)
Seat 2: a4ba858f ($29.36 in chips)
Seat 3: 7bf7c8c9 ($26.76 in chips)
Seat 4: b31e5039 ($11.81 in chips)
Seat 5: cfe992dd ($25 in chips)
Seat 6: Hero ($26.49 in chips)
a4ba858f: posts small blind $0.1
7bf7c8c9: posts big blind $0.25
*** HOLE CARDS ***
Dealt to a296ff49 
Dealt to a4ba858f 
Dealt to 7bf7c8c9 
Dealt to b31e5039 
Dealt to cfe992dd 
Dealt to Hero [Ks 3s]
b31e5039: folds
cfe992dd: folds
Hero: folds
a296ff49: folds
a4ba858f: folds
Uncalled bet ($0.15) returned to 7bf7c8c9
*** SHOWDOWN ***
7bf7c8c9 collected $0.2 from pot
*** SUMMARY ***
Total pot $0.2
Seat 1: a296ff49 (button) folded before Flop (didn't bet)
Seat 2: a4ba858f (small blind) folded before Flop
Seat 3: 7bf7c8c9 (big blind) collected ($0.2)
Seat 4: b31e5039 folded before Flop (didn't bet)
Seat 5: cfe992dd folded before Flop (didn't bet)
Seat 6: Hero folded before Flop (didn't bet)


Poker Hand #RC95089291: Hold'em No Limit ($0.1/$0.25) - 2020/04/07 15:25:39
Table 'RushAndCash364592' 6-max Seat #1 is the button
Seat 1: 258d376e ($25.25 in chips)
Seat 2: d84d476b ($29.62 in chips)
Seat 3: 8c86f461 ($41.95 in chips)
Seat 4: Hero ($26.49 in chips)
Seat 5: e1071a91 ($27.37 in chips)
Seat 6: b31e5039 ($11.81 in chips)
d84d476b: posts small blind $0.1
8c86f461: posts big blind $0.25
*** HOLE CARDS ***
Dealt to 258d376e 
Dealt to d84d476b 
Dealt to 8c86f461 
Dealt to Hero [Kd 2c]
Dealt to e1071a91 
Dealt to b31e5039 
Hero: folds
e1071a91: folds
b31e5039: folds
258d376e: raises $0.38 to $0.63
d84d476b: folds
8c86f461: folds
Uncalled bet ($0.38) returned to 258d376e
*** SHOWDOWN ***
258d376e collected $0.6 from pot
*** SUMMARY ***
Total pot $0.6
Seat 1: 258d376e (button) collected ($0.6)
Seat 2: d84d476b (small blind) folded before Flop
Seat 3: 8c86f461 (big blind) folded before Flop
Seat 4: Hero folded before Flop (didn't bet)
Seat 5: e1071a91 folded before Flop (didn't bet)
Seat 6: b31e5039 folded before Flop (didn't bet)


Poker Hand #RC95089315: Hold'em No Limit ($0.1/$0.25) - 2020/04/07 15:25:43
Table 'RushAndCash364596' 6-max Seat #1 is the button
Seat 1: Hero ($26.49 in chips)
Seat 2: 6736194e ($28.02 in chips)
Seat 3: cae4d8ce ($11.37 in chips)
Seat 4: e1071a91 ($27.37 in chips)
Seat 5: b431c8b6 ($34 in chips)
Seat 6: 62eebc49 ($120.41 in chips)
6736194e: posts small blind $0.1
cae4d8ce: posts big blind $0.25
*** HOLE CARDS ***
Dealt to Hero [4s 3h]
Dealt to 6736194e 
Dealt to cae4d8ce 
Dealt to e1071a91 
Dealt to b431c8b6 
Dealt to 62eebc49 
e1071a91: folds
b431c8b6: folds
62eebc49: folds
Hero: folds
6736194e: folds
Uncalled bet ($0.15) returned to cae4d8ce
*** SHOWDOWN ***
cae4d8ce collected $0.2 from pot
*** SUMMARY ***
Total pot $0.2
Seat 1: Hero (button) folded before Flop (didn't bet)
Seat 2: 6736194e (small blind) folded before Flop
Seat 3: cae4d8ce (big blind) collected ($0.2)
Seat 4: e1071a91 folded before Flop (didn't bet)
Seat 5: b431c8b6 folded before Flop (didn't bet)
Seat 6: 62eebc49 folded before Flop (didn't bet)


Poker Hand #RC95089353: Hold'em No Limit ($0.1/$0.25) - 2020/04/07 15:25:48
Table 'RushAndCash364600' 6-max Seat #1 is the button
Seat 1: e1071a91 ($27.37 in chips)
Seat 2: Hero ($26.49 in chips)
Seat 3: 91c71347 ($32 in chips)
Seat 4: a2f2938c ($25 in chips)
Seat 5: 3aba7ce9 ($9.51 in chips)
Seat 6: b31e5039 ($11.81 in chips)
Hero: posts small blind $0.1
91c71347: posts big blind $0.25
*** HOLE CARDS ***
Dealt to e1071a91 
Dealt to Hero [5c 2c]
Dealt to 91c71347 
Dealt to a2f2938c 
Dealt to 3aba7ce9 
Dealt to b31e5039 
a2f2938c: folds
3aba7ce9: folds
b31e5039: folds
e1071a91: raises $0.38 to $0.63
Hero: folds
91c71347: folds
Uncalled bet ($0.38) returned to e1071a91
*** SHOWDOWN ***
e1071a91 collected $0.6 from pot
*** SUMMARY ***
Total pot $0.6
Seat 1: e1071a91 (button) collected ($0.6)
Seat 2: Hero (small blind) folded before Flop
Seat 3: 91c71347 (big blind) folded before Flop
Seat 4: a2f2938c folded before Flop (didn't bet)
Seat 5: 3aba7ce9 folded before Flop (didn't bet)
Seat 6: b31e5039 folded before Flop (didn't bet)


Poker Hand #RC95089377: Hold'em No Limit ($0.1/$0.25) - 2020/04/07 15:25:51
Table 'RushAndCash364602' 6-max Seat #1 is the button
Seat 1: cfe992dd ($25 in chips)
Seat 2: a0d04110 ($41.55 in chips)
Seat 3: Hero ($26.39 in chips)
Seat 4: 4dd920ba ($25 in chips)
Seat 5: 62eebc49 ($120.41 in chips)
Seat 6: 2dd038c3 ($11.75 in chips)
a0d04110: posts small blind $0.1
Hero: posts big blind $0.25
*** HOLE CARDS ***
Dealt to cfe992dd 
Dealt to a0d04110 
Dealt to Hero [Ad 2d]
Dealt to 4dd920ba 
Dealt to 62eebc49 
Dealt to 2dd038c3 
4dd920ba: folds
62eebc49: folds
2dd038c3: raises $0.38 to $0.63
cfe992dd: folds
a0d04110: raises $1.37 to $2
Hero: folds
2dd038c3: folds
Uncalled bet ($1.37) returned to a0d04110
*** SHOWDOWN ***
a0d04110 collected $1.51 from pot
*** SUMMARY ***
Total pot $1.51
Seat 1: cfe992dd (button) folded before Flop (didn't bet)
Seat 2: a0d04110 (small blind) collected ($1.51)
Seat 3: Hero (big blind) folded before Flop
Seat 4: 4dd920ba folded before Flop (didn't bet)
Seat 5: 62eebc49 folded before Flop (didn't bet)
Seat 6: 2dd038c3 folded before Flop


Poker Hand #RC95089561: Hold'em No Limit ($0.1/$0.25) - 2020/04/07 15:26:13
Table 'RushAndCash364626' 6-max Seat #1 is the button
Seat 1: a4ba858f ($29.36 in chips)
Seat 2: 36017ad1 ($25 in chips)
Seat 3: 324d8e1d ($34 in chips)
Seat 4: 3c96062f ($14.49 in chips)
Seat 5: Hero ($26.14 in chips)
Seat 6: 45920dbc ($45.97 in chips)
36017ad1: posts small blind $0.1
324d8e1d: posts big blind $0.25
*** HOLE CARDS ***
Dealt to a4ba858f 
Dealt to 36017ad1 
Dealt to 324d8e1d 
Dealt to 3c96062f 
Dealt to Hero [8d 4c]
Dealt to 45920dbc 
3c96062f: raises $0.5 to $0.75
Hero: folds
45920dbc: folds
a4ba858f: folds
36017ad1: folds
324d8e1d: folds
Uncalled bet ($0.5) returned to 3c96062f
*** SHOWDOWN ***
3c96062f collected $0.6 from pot
*** SUMMARY ***
Total pot $0.6
Seat 1: a4ba858f (button) folded before Flop (didn't bet)
Seat 2: 36017ad1 (small blind) folded before Flop
Seat 3: 324d8e1d (big blind) folded before Flop
Seat 4: 3c96062f collected ($0.6)
Seat 5: Hero folded before Flop (didn't bet)
Seat 6: 45920dbc folded before Flop (didn't bet)


Poker Hand #RC95089635: Hold'em No Limit ($0.1/$0.25) - 2020/04/07 15:26:22
Table 'RushAndCash364636' 6-max Seat #1 is the button
Seat 1: 62eebc49 ($120.66 in chips)
Seat 2: 6a4f7541 ($25.57 in chips)
Seat 3: a4ba858f ($29.26 in chips)
Seat 4: f7ed681a ($13.82 in chips)
Seat 5: d2986703 ($38.29 in chips)
Seat 6: Hero ($26.14 in chips)
6a4f7541: posts small blind $0.1
a4ba858f: posts big blind $0.25
*** HOLE CARDS ***
Dealt to 62eebc49 
Dealt to 6a4f7541 
Dealt to a4ba858f 
Dealt to f7ed681a 
Dealt to d2986703 
Dealt to Hero [Kc 7h]
f7ed681a: folds
d2986703: folds
Hero: folds
62eebc49: folds
6a4f7541: folds
Uncalled bet ($0.15) returned to a4ba858f
*** SHOWDOWN ***
a4ba858f collected $0.2 from pot
*** SUMMARY ***
Total pot $0.2
Seat 1: 62eebc49 (button) folded before Flop (didn't bet)
Seat 2: 6a4f7541 (small blind) folded before Flop
Seat 3: a4ba858f (big blind) collected ($0.2)
Seat 4: f7ed681a folded before Flop (didn't bet)
Seat 5: d2986703 folded before Flop (didn't bet)
Seat 6: Hero folded before Flop (didn't bet)


Poker Hand #RC95089705: Hold'em No Limit ($0.1/$0.25) - 2020/04/07 15:26:31
Table 'RushAndCash364647' 6-max Seat #1 is the button
Seat 1: 3c96062f ($14.84 in chips)
Seat 2: 704c37d9 ($53.83 in chips)
Seat 3: a2f2938c ($25.25 in chips)
Seat 4: Hero ($26.14 in chips)
Seat 5: 966446c2 ($34.24 in chips)
Seat 6: 61ad32d ($18.29 in chips)
704c37d9: posts small blind $0.1
a2f2938c: posts big blind $0.25
*** HOLE CARDS ***
Dealt to 3c96062f 
Dealt to 704c37d9 
Dealt to a2f2938c 
Dealt to Hero [9h 2d]
Dealt to 966446c2 
Dealt to 61ad32d 
Hero: folds
966446c2: folds
61ad32d: folds
3c96062f: folds
704c37d9: folds
Uncalled bet ($0.15) returned to a2f2938c
*** SHOWDOWN ***
a2f2938c collected $0.2 from pot
*** SUMMARY ***
Total pot $0.2
Seat 1: 3c96062f (button) folded before Flop (didn't bet)
Seat 2: 704c37d9 (small blind) folded before Flop
Seat 3: a2f2938c (big blind) collected ($0.2)
Seat 4: Hero folded before Flop (didn't bet)
Seat 5: 966446c2 folded before Flop (didn't bet)
Seat 6: 61ad32d folded before Flop (didn't bet)


Poker Hand #RC95089740: Hold'em No Limit ($0.1/$0.25) - 2020/04/07 15:26:36
Table 'RushAndCash364652' 6-max Seat #1 is the button
Seat 1: b431c8b6 ($34 in chips)
Seat 2: Hero ($26.14 in chips)
Seat 3: cfe992dd ($25 in chips)
Seat 4: edde387a ($23.65 in chips)
Seat 5: 62eebc49 ($120.66 in chips)
Seat 6: 74937d40 ($28.16 in chips)
Hero: posts small blind $0.1
cfe992dd: posts big blind $0.25
*** HOLE CARDS ***
Dealt to b431c8b6 
Dealt to Hero [6h 3c]
Dealt to cfe992dd 
Dealt to edde387a 
Dealt to 62eebc49 
Dealt to 74937d40 
edde387a: folds
62eebc49: raises $0.38 to $0.63
74937d40: folds
b431c8b6: folds
Hero: folds
cfe992dd: folds
Uncalled bet ($0.38) returned to 62eebc49
*** SHOWDOWN ***
62eebc49 collected $0.6 from pot
*** SUMMARY ***
Total pot $0.6
Seat 1: b431c8b6 (button) folded before Flop (didn't bet)
Seat 2: Hero (small blind) folded before Flop
Seat 3: cfe992dd (big blind) folded before Flop
Seat 4: edde387a folded before Flop (didn't bet)
Seat 5: 62eebc49 collected ($0.6)
Seat 6: 74937d40 folded before Flop (didn't bet)


Poker Hand #RC95089833: Hold'em No Limit ($0.1/$0.25) - 2020/04/07 15:26:47
Table 'RushAndCash364664' 6-max Seat #1 is the button
Seat 1: 45920dbc ($45.62 in chips)
Seat 2: 704c37d9 ($53.73 in chips)
Seat 3: Hero ($26.04 in chips)
Seat 4: 3423a84d ($34.42 in chips)
Seat 5: a296ff49 ($9.46 in chips)
Seat 6: 258d376e ($25.6 in chips)
704c37d9: posts small blind $0.1
Hero: posts big blind $0.25
*** HOLE CARDS ***
Dealt to 45920dbc 
Dealt to 704c37d9 
Dealt to Hero [7d 3h]
Dealt to 3423a84d 
Dealt to a296ff49 
Dealt to 258d376e 
3423a84d: raises $0.25 to $0.5
a296ff49: folds
258d376e: folds
45920dbc: folds
704c37d9: folds
Hero: folds
Uncalled bet ($0.25) returned to 3423a84d
*** SHOWDOWN ***
3423a84d collected $0.6 from pot
*** SUMMARY ***
Total pot $0.6
Seat 1: 45920dbc (button) folded before Flop (didn't bet)
Seat 2: 704c37d9 (small blind) folded before Flop
Seat 3: Hero (big blind) folded before Flop
Seat 4: 3423a84d collected ($0.6)
Seat 5: a296ff49 folded before Flop (didn't bet)
Seat 6: 258d376e folded before Flop (didn't bet)


Poker Hand #RC95089879: Hold'em No Limit ($0.1/$0.25) - 2020/04/07 15:26:53
Table 'RushAndCash364670' 6-max Seat #1 is the button
Seat 1: Hero ($25.79 in chips)
Seat 2: a4ba858f ($29.36 in chips)
Seat 3: 258d376e ($25.6 in chips)
Seat 4: 5794e88f ($36.71 in chips)
Seat 5: 3c96062f ($14.84 in chips)
Seat 6: edde387a ($23.65 in chips)
a4ba858f: posts small blind $0.1
258d376e: posts big blind $0.25
*** HOLE CARDS ***
Dealt to Hero [8c 5c]
Dealt to a4ba858f 
Dealt to 258d376e 
Dealt to 5794e88f 
Dealt to 3c96062f 
Dealt to edde387a 
5794e88f: folds
3c96062f: folds
edde387a: folds
Hero: folds
a4ba858f: raises $0.5 to $0.75
258d376e: folds
Uncalled bet ($0.5) returned to a4ba858f
*** SHOWDOWN ***
a4ba858f collected $0.5 from pot
*** SUMMARY ***
Total pot $0.5
Seat 1: Hero (button) folded before Flop (didn't bet)
Seat 2: a4ba858f (small blind) collected ($0.5)
Seat 3: 258d376e (big blind) folded before Flop
Seat 4: 5794e88f folded before Flop (didn't bet)
Seat 5: 3c96062f folded before Flop (didn't bet)
Seat 6: edde387a folded before Flop (didn't bet)


Poker Hand #RC95089962: Hold'em No Limit ($0.1/$0.25) - 2020/04/07 15:27:03
Table 'RushAndCash364681' 6-max Seat #1 is the button
Seat 1: 704a7fcf ($29.83 in chips)
Seat 2: deb69778 ($26.48 in chips)
Seat 3: c88456c4 ($5.82 in chips)
Seat 4: Hero ($25.79 in chips)
Seat 5: a296ff49 ($9.46 in chips)
Seat 6: 3c96062f ($14.84 in chips)
deb69778: posts small blind $0.1
c88456c4: posts big blind $0.25
*** HOLE CARDS ***
Dealt to 704a7fcf 
Dealt to deb69778 
Dealt to c88456c4 
Dealt to Hero [Kc 6d]
Dealt to a296ff49 
Dealt to 3c96062f 
Hero: folds
a296ff49: folds
3c96062f: folds
704a7fcf: folds
deb69778: raises $0.5 to $0.75
c88456c4: calls $0.5
*** FLOP *** [4s 5h 3c]
deb69778: bets $0.8
c88456c4: raises $1.8 to $2.6
deb69778: raises $5.1 to $7.7
c88456c4: calls $2.47 and is all-in
Uncalled bet ($2.63) returned to deb69778
deb69778: shows [7h 7c] (Pair of Sevens)
c88456c4: shows [4c Ac] (Pair of Fours)
deb69778: get an all-in insurance (premium ($0/$0.1/$0) for ($0/$0.3/$0) - (Mandatory/Main/Sub))
*** TURN *** [4s 5h 3c] [Tc]
deb69778: pay premium of all-in insurance ($0.1)
deb69778: get an all-in insurance (premium ($0/$0.09/$0) for ($0/$0.1/$0) - (Mandatory/Main/Sub))
*** RIVER *** [4s 5h 3c Tc] [Jh]
deb69778: pay premium of all-in insurance ($0.09)
*** SHOWDOWN ***
deb69778 collected $11.64 from pot
*** SUMMARY ***
Total pot $11.64
Board [4s 5h 3c Tc Jh]
Seat 1: 704a7fcf (button) folded before Flop (didn't bet)
Seat 2: deb69778 (small blind) showed [7h 7c] and won ($11.64) with Pair of Sevens, AII Premium ($0.19)
Seat 3: c88456c4 (big blind) showed [Ac 4c] and lost with Pair of Fours
Seat 4: Hero folded before Flop (didn't bet)
Seat 5: a296ff49 folded before Flop (didn't bet)
Seat 6: 3c96062f folded before Flop (didn't bet)


Poker Hand #RC95090046: Hold'em No Limit ($0.1/$0.25) - 2020/04/07 15:27:13
Table 'RushAndCash364691' 6-max Seat #1 is the button
Seat 1: a4ba858f ($29.61 in chips)
Seat 2: d8859ee1 ($24.75 in chips)
Seat 3: 36017ad1 ($25 in chips)
Seat 4: ab29e296 ($13.93 in chips)
Seat 5: 7bf7c8c9 ($25 in chips)
Seat 6: Hero ($25.79 in chips)
d8859ee1: posts small blind $0.1
36017ad1: posts big blind $0.25
*** HOLE CARDS ***
Dealt to a4ba858f 
Dealt to d8859ee1 
Dealt to 36017ad1 
Dealt to ab29e296 
Dealt to 7bf7c8c9 
Dealt to Hero [Qc 2h]
ab29e296: folds
7bf7c8c9: folds
Hero: folds
a4ba858f: folds
d8859ee1: raises $0.5 to $0.75
36017ad1: folds
Uncalled bet ($0.5) returned to d8859ee1
*** SHOWDOWN ***
d8859ee1 collected $0.5 from pot
*** SUMMARY ***
Total pot $0.5
Seat 1: a4ba858f (button) folded before Flop (didn't bet)
Seat 2: d8859ee1 (small blind) collected ($0.5)
Seat 3: 36017ad1 (big blind) folded before Flop
Seat 4: ab29e296 folded before Flop (didn't bet)
Seat 5: 7bf7c8c9 folded before Flop (didn't bet)
Seat 6: Hero folded before Flop (didn't bet)


Poker Hand #RC95090094: Hold'em No Limit ($0.1/$0.25) - 2020/04/07 15:27:19
Table 'RushAndCash364696' 6-max Seat #1 is the button
Seat 1: Hero ($25.79 in chips)
Seat 2: 7bf7c8c9 ($25 in chips)
Seat 3: 7ed3ab6b ($64.2 in chips)
Seat 4: 6a4f7541 ($25.91 in chips)
Seat 5: 1780ed6 ($56.1 in chips)
Seat 6: 52ee6b3d ($25.67 in chips)
7bf7c8c9: posts small blind $0.1
7ed3ab6b: posts big blind $0.25
*** HOLE CARDS ***
Dealt to Hero [5s 3s]
Dealt to 7bf7c8c9 
Dealt to 7ed3ab6b 
Dealt to 6a4f7541 
Dealt to 1780ed6 
Dealt to 52ee6b3d 
6a4f7541: folds
1780ed6: folds
52ee6b3d: raises $0.38 to $0.63
Hero: folds
7bf7c8c9: folds
7ed3ab6b: folds
Uncalled bet ($0.38) returned to 52ee6b3d
*** SHOWDOWN ***
52ee6b3d collected $0.6 from pot
*** SUMMARY ***
Total pot $0.6
Seat 1: Hero (button) folded before Flop (didn't bet)
Seat 2: 7bf7c8c9 (small blind) folded before Flop
Seat 3: 7ed3ab6b (big blind) folded before Flop
Seat 4: 6a4f7541 folded before Flop (didn't bet)
Seat 5: 1780ed6 folded before Flop (didn't bet)
Seat 6: 52ee6b3d collected ($0.6)


Poker Hand #RC95090190: Hold'em No Limit ($0.1/$0.25) - 2020/04/07 15:27:30
Table 'RushAndCash364708' 6-max Seat #1 is the button
Seat 1: 4ab4e4a3 ($25.78 in chips)
Seat 2: Hero ($25.79 in chips)
Seat 3: 65837850 ($134.23 in chips)
Seat 4: cb835642 ($26.57 in chips)
Seat 5: d5989e2b ($24.36 in chips)
Seat 6: d8859ee1 ($25 in chips)
Hero: posts small blind $0.1
65837850: posts big blind $0.25
*** HOLE CARDS ***
Dealt to 4ab4e4a3 
Dealt to Hero [7h 2s]
Dealt to 65837850 
Dealt to cb835642 
Dealt to d5989e2b 
Dealt to d8859ee1 
cb835642: folds
d5989e2b: raises $0.5 to $0.75
d8859ee1: folds
4ab4e4a3: folds
Hero: folds
65837850: folds
Uncalled bet ($0.5) returned to d5989e2b
*** SHOWDOWN ***
d5989e2b collected $0.6 from pot
*** SUMMARY ***
Total pot $0.6
Seat 1: 4ab4e4a3 (button) folded before Flop (didn't bet)
Seat 2: Hero (small blind) folded before Flop
Seat 3: 65837850 (big blind) folded before Flop
Seat 4: cb835642 folded before Flop (didn't bet)
Seat 5: d5989e2b collected ($0.6)
Seat 6: d8859ee1 folded before Flop (didn't bet)


Poker Hand #RC95090260: Hold'em No Limit ($0.1/$0.25) - 2020/04/07 15:27:40
Table 'RushAndCash364717' 6-max Seat #1 is the button
Seat 1: acf1a889 ($14.38 in chips)
Seat 2: 3423a84d ($34.42 in chips)
Seat 3: Hero ($25.69 in chips)
Seat 4: d8859ee1 ($25 in chips)
Seat 5: 528a07f8 ($33.52 in chips)
Seat 6: 3c96062f ($14.49 in chips)
3423a84d: posts small blind $0.1
Hero: posts big blind $0.25
*** HOLE CARDS ***
Dealt to acf1a889 
Dealt to 3423a84d 
Dealt to Hero [Kh 3h]
Dealt to d8859ee1 
Dealt to 528a07f8 
Dealt to 3c96062f 
d8859ee1: folds
528a07f8: folds
3c96062f: raises $0.5 to $0.75
acf1a889: folds
3423a84d: folds
Hero: folds
Uncalled bet ($0.5) returned to 3c96062f
*** SHOWDOWN ***
3c96062f collected $0.6 from pot
*** SUMMARY ***
Total pot $0.6
Seat 1: acf1a889 (button) folded before Flop (didn't bet)
Seat 2: 3423a84d (small blind) folded before Flop
Seat 3: Hero (big blind) folded before Flop
Seat 4: d8859ee1 folded before Flop (didn't bet)
Seat 5: 528a07f8 folded before Flop (didn't bet)
Seat 6: 3c96062f collected ($0.6)


Poker Hand #RC95090297: Hold'em No Limit ($0.1/$0.25) - 2020/04/07 15:27:46
Table 'RushAndCash364722' 6-max Seat #1 is the button
Seat 1: 454abe8b ($25 in chips)
Seat 2: dbf6981f ($61.33 in chips)
Seat 3: d6f2a39c ($5.45 in chips)
Seat 4: bb849ffc ($5.87 in chips)
Seat 5: d5989e2b ($24.71 in chips)
Seat 6: Hero ($25.44 in chips)
dbf6981f: posts small blind $0.1
d6f2a39c: posts big blind $0.25
*** HOLE CARDS ***
Dealt to 454abe8b 
Dealt to dbf6981f 
Dealt to d6f2a39c 
Dealt to bb849ffc 
Dealt to d5989e2b 
Dealt to Hero [Qs 4h]
bb849ffc: folds
d5989e2b: folds
Hero: folds
454abe8b: folds
dbf6981f: calls $0.15
d6f2a39c: checks
*** FLOP *** [Ah 4d Jh]
dbf6981f: bets $0.25
d6f2a39c: folds
Uncalled bet ($0.25) returned to dbf6981f
*** SHOWDOWN ***
dbf6981f collected $0.5 from pot
*** SUMMARY ***
Total pot $0.5
Board [Ah 4d Jh]
Seat 1: 454abe8b (button) folded before Flop (didn't bet)
Seat 2: dbf6981f (small blind) won ($0.5)
Seat 3: d6f2a39c (big blind) folded on the Flop
Seat 4: bb849ffc folded before Flop (didn't bet)
Seat 5: d5989e2b folded before Flop (didn't bet)
Seat 6: Hero folded before Flop (didn't bet)


Poker Hand #RC95090327: Hold'em No Limit ($0.1/$0.25) - 2020/04/07 15:27:49
Table 'RushAndCash364726' 6-max Seat #1 is the button
Seat 1: 89387862 ($32.71 in chips)
Seat 2: 4dd920ba ($26.01 in chips)
Seat 3: cc092a76 ($10.99 in chips)
Seat 4: af84e661 ($5.27 in chips)
Seat 5: Hero ($25.44 in chips)
Seat 6: d2986703 ($39.07 in chips)
4dd920ba: posts small blind $0.1
cc092a76: posts big blind $0.25
*** HOLE CARDS ***
Dealt to 89387862 
Dealt to 4dd920ba 
Dealt to cc092a76 
Dealt to af84e661 
Dealt to Hero [Ac 4c]
Dealt to d2986703 
af84e661: folds
Hero: raises $0.38 to $0.63
d2986703: folds
89387862: folds
4dd920ba: folds
cc092a76: folds
Uncalled bet ($0.38) returned to Hero
*** SHOWDOWN ***
Hero collected $0.6 from pot
*** SUMMARY ***
Total pot $0.6
Seat 1: 89387862 (button) folded before Flop (didn't bet)
Seat 2: 4dd920ba (small blind) folded before Flop
Seat 3: cc092a76 (big blind) folded before Flop
Seat 4: af84e661 folded before Flop (didn't bet)
Seat 5: Hero collected ($0.6)
Seat 6: d2986703 folded before Flop (didn't bet)


Poker Hand #RC95090434: Hold'em No Limit ($0.1/$0.25) - 2020/04/07 15:28:03
Table 'RushAndCash364742' 6-max Seat #1 is the button
Seat 1: fc8a29ea ($68.88 in chips)
Seat 2: 103129d8 ($26.07 in chips)
Seat 3: 3c96062f ($14.84 in chips)
Seat 4: Hero ($25.79 in chips)
Seat 5: 3423a84d ($34.07 in chips)
Seat 6: 3cfd7308 ($41.36 in chips)
103129d8: posts small blind $0.1
3c96062f: posts big blind $0.25
*** HOLE CARDS ***
Dealt to fc8a29ea 
Dealt to 103129d8 
Dealt to 3c96062f 
Dealt to Hero [As 4s]
Dealt to 3423a84d 
Dealt to 3cfd7308 
Hero: raises $0.38 to $0.63
3423a84d: calls $0.63
3cfd7308: folds
fc8a29ea: folds
103129d8: folds
3c96062f: folds
*** FLOP *** [Td 8d Kc]
Hero: checks
3423a84d: bets $0.75
Hero: folds
Uncalled bet ($0.75) returned to 3423a84d
*** SHOWDOWN ***
3423a84d collected $1.61 from pot
*** SUMMARY ***
Total pot $1.61
Board [Td 8d Kc]
Seat 1: fc8a29ea (button) folded before Flop (didn't bet)
Seat 2: 103129d8 (small blind) folded before Flop
Seat 3: 3c96062f (big blind) folded before Flop
Seat 4: Hero folded on the Flop
Seat 5: 3423a84d won ($1.61)
Seat 6: 3cfd7308 folded before Flop (didn't bet)


Poker Hand #RC95090710: Hold'em No Limit ($0.1/$0.25) - 2020/04/07 15:28:38
Table 'RushAndCash364785' 6-max Seat #1 is the button
Seat 1: 1179c6f3 ($25 in chips)
Seat 2: 454abe8b ($25 in chips)
Seat 3: Hero ($25.16 in chips)
Seat 4: 4dd920ba ($25.91 in chips)
Seat 5: e6c023d1 ($34.05 in chips)
Seat 6: 3423a84d ($34.97 in chips)
454abe8b: posts small blind $0.1
Hero: posts big blind $0.25
*** HOLE CARDS ***
Dealt to 1179c6f3 
Dealt to 454abe8b 
Dealt to Hero [8d 5d]
Dealt to 4dd920ba 
Dealt to e6c023d1 
Dealt to 3423a84d 
4dd920ba: folds
e6c023d1: folds
3423a84d: raises $0.25 to $0.5
1179c6f3: folds
454abe8b: folds
Hero: folds
Uncalled bet ($0.25) returned to 3423a84d
*** SHOWDOWN ***
3423a84d collected $0.6 from pot
*** SUMMARY ***
Total pot $0.6
Seat 1: 1179c6f3 (button) folded before Flop (didn't bet)
Seat 2: 454abe8b (small blind) folded before Flop
Seat 3: Hero (big blind) folded before Flop
Seat 4: 4dd920ba folded before Flop (didn't bet)
Seat 5: e6c023d1 folded before Flop (didn't bet)
Seat 6: 3423a84d collected ($0.6)


Poker Hand #RC95090752: Hold'em No Limit ($0.1/$0.25) - 2020/04/07 15:28:43
Table 'RushAndCash364792' 6-max Seat #1 is the button
Seat 1: bb849ffc ($5.62 in chips)
Seat 2: 81c6db62 ($25 in chips)
Seat 3: fe3f48f4 ($28.59 in chips)
Seat 4: Hero ($25 in chips)
Seat 5: 7ac43878 ($37.04 in chips)
Seat 6: 49b3e425 ($27.44 in chips)
81c6db62: posts small blind $0.1
fe3f48f4: posts big blind $0.25
*** HOLE CARDS ***
Dealt to bb849ffc 
Dealt to 81c6db62 
Dealt to fe3f48f4 
Dealt to Hero [Qd Jd]
Dealt to 7ac43878 
Dealt to 49b3e425 
Hero: raises $0.38 to $0.63
7ac43878: calls $0.63
49b3e425: calls $0.63
bb849ffc: folds
81c6db62: folds
fe3f48f4: folds
*** FLOP *** [6h 9h Kc]
Hero: checks
7ac43878: bets $2.3
49b3e425: folds
Hero: folds
Uncalled bet ($2.3) returned to 7ac43878
*** SHOWDOWN ***
7ac43878 collected $2.24 from pot
*** SUMMARY ***
Total pot $2.24
Board [6h 9h Kc]
Seat 1: bb849ffc (button) folded before Flop (didn't bet)
Seat 2: 81c6db62 (small blind) folded before Flop
Seat 3: fe3f48f4 (big blind) folded before Flop
Seat 4: Hero folded on the Flop
Seat 5: 7ac43878 won ($2.24)
Seat 6: 49b3e425 folded on the Flop


Poker Hand #RC95090956: Hold'em No Limit ($0.1/$0.25) - 2020/04/07 15:29:11
Table 'RushAndCash364819' 6-max Seat #1 is the button
Seat 1: acf1a889 ($18.52 in chips)
Seat 2: Hero ($25 in chips)
Seat 3: 17388104 ($15.69 in chips)
Seat 4: cfe992dd ($26.94 in chips)
Seat 5: 368bffcd ($27.02 in chips)
Seat 6: b5d592d2 ($14.56 in chips)
Hero: posts small blind $0.1
17388104: posts big blind $0.25
*** HOLE CARDS ***
Dealt to acf1a889 
Dealt to Hero [Kd 9c]
Dealt to 17388104 
Dealt to cfe992dd 
Dealt to 368bffcd 
Dealt to b5d592d2 
cfe992dd: raises $0.45 to $0.7
368bffcd: folds
b5d592d2: calls $0.7
acf1a889: folds
Hero: folds
17388104: raises $1.1 to $1.8
cfe992dd: folds
b5d592d2: calls $1.1
*** FLOP *** [Kh 4d 4s]
17388104: bets $6.9
b5d592d2: folds
Uncalled bet ($6.9) returned to 17388104
*** SHOWDOWN ***
17388104 collected $4.4 from pot
*** SUMMARY ***
Total pot $4.4
Board [Kh 4d 4s]
Seat 1: acf1a889 (button) folded before Flop (didn't bet)
Seat 2: Hero (small blind) folded before Flop
Seat 3: 17388104 (big blind) won ($4.4)
Seat 4: cfe992dd folded before Flop
Seat 5: 368bffcd folded before Flop (didn't bet)
Seat 6: b5d592d2 folded on the Flop


Poker Hand #RC95090996: Hold'em No Limit ($0.1/$0.25) - 2020/04/07 15:29:16
Table 'RushAndCash364825' 6-max Seat #1 is the button
Seat 1: Hero ($25 in chips)
Seat 2: 4dd920ba ($25.21 in chips)
Seat 3: d437c92d ($63.16 in chips)
Seat 4: 366c47e0 ($11.62 in chips)
Seat 5: edde387a ($22.7 in chips)
Seat 6: acf1a889 ($18.52 in chips)
4dd920ba: posts small blind $0.1
d437c92d: posts big blind $0.25
*** HOLE CARDS ***
Dealt to Hero [Ks 3d]
Dealt to 4dd920ba 
Dealt to d437c92d 
Dealt to 366c47e0 
Dealt to edde387a 
Dealt to acf1a889 
366c47e0: raises $0.5 to $0.75
edde387a: folds
acf1a889: folds
Hero: folds
4dd920ba: raises $2.25 to $3
d437c92d: folds
366c47e0: calls $2.25
*** FLOP *** [7s 4s Ah]
4dd920ba: bets $2.5
366c47e0: folds
Uncalled bet ($2.5) returned to 4dd920ba
*** SHOWDOWN ***
4dd920ba collected $6.25 from pot
*** SUMMARY ***
Total pot $6.25
Board [7s 4s Ah]
Seat 1: Hero (button) folded before Flop (didn't bet)
Seat 2: 4dd920ba (small blind) won ($6.25)
Seat 3: d437c92d (big blind) folded before Flop
Seat 4: 366c47e0 folded on the Flop
Seat 5: edde387a folded before Flop (didn't bet)
Seat 6: acf1a889 folded before Flop (didn't bet)


Poker Hand #RC95091041: Hold'em No Limit ($0.1/$0.25) - 2020/04/07 15:29:22
Table 'RushAndCash364831' 6-max Seat #1 is the button
Seat 1: 36017ad1 ($27.91 in chips)
Seat 2: d2986703 ($42.07 in chips)
Seat 3: a2f2938c ($25 in chips)
Seat 4: Hero ($25 in chips)
Seat 5: 432498db ($26.63 in chips)
Seat 6: fe3f48f4 ($28.24 in chips)
d2986703: posts small blind $0.1
a2f2938c: posts big blind $0.25
*** HOLE CARDS ***
Dealt to 36017ad1 
Dealt to d2986703 
Dealt to a2f2938c 
Dealt to Hero [8h 4c]
Dealt to 432498db 
Dealt to fe3f48f4 
Hero: folds
432498db: folds
fe3f48f4: raises $0.38 to $0.63
36017ad1: calls $0.63
d2986703: folds
a2f2938c: raises $2.63 to $3.26
fe3f48f4: folds
36017ad1: folds
Uncalled bet ($2.63) returned to a2f2938c
*** SHOWDOWN ***
a2f2938c collected $1.99 from pot
*** SUMMARY ***
Total pot $1.99
Seat 1: 36017ad1 (button) folded before Flop
Seat 2: d2986703 (small blind) folded before Flop
Seat 3: a2f2938c (big blind) collected ($1.99)
Seat 4: Hero folded before Flop (didn't bet)
Seat 5: 432498db folded before Flop (didn't bet)
Seat 6: fe3f48f4 folded before Flop


Poker Hand #RC95091082: Hold'em No Limit ($0.1/$0.25) - 2020/04/07 15:29:27
Table 'RushAndCash364835' 6-max Seat #1 is the button
Seat 1: 432498db ($26.63 in chips)
Seat 2: 32953d2a ($13.65 in chips)
Seat 3: fc8a29ea ($69.13 in chips)
Seat 4: Hero ($25 in chips)
Seat 5: 81c6db62 ($26.01 in chips)
Seat 6: 258d376e ($25.7 in chips)
32953d2a: posts small blind $0.1
fc8a29ea: posts big blind $0.25
*** HOLE CARDS ***
Dealt to 432498db 
Dealt to 32953d2a 
Dealt to fc8a29ea 
Dealt to Hero [7h 6d]
Dealt to 81c6db62 
Dealt to 258d376e 
Hero: folds
81c6db62: folds
258d376e: calls $0.25
432498db: folds
32953d2a: calls $0.15
fc8a29ea: checks
*** FLOP *** [7c Kd 2c]
32953d2a: checks
fc8a29ea: checks
258d376e: checks
*** TURN *** [7c Kd 2c] [9c]
32953d2a: checks
fc8a29ea: bets $0.5
258d376e: folds
32953d2a: folds
Uncalled bet ($0.5) returned to fc8a29ea
*** SHOWDOWN ***
fc8a29ea collected $0.75 from pot
*** SUMMARY ***
Total pot $0.75
Board [7c Kd 2c 9c]
Seat 1: 432498db (button) folded before Flop (didn't bet)
Seat 2: 32953d2a (small blind) folded on the Turn
Seat 3: fc8a29ea (big blind) won ($0.75)
Seat 4: Hero folded before Flop (didn't bet)
Seat 5: 81c6db62 folded before Flop (didn't bet)
Seat 6: 258d376e folded on the Turn


Poker Hand #RC95091146: Hold'em No Limit ($0.1/$0.25) - 2020/04/07 15:29:34
Table 'RushAndCash364842' 6-max Seat #1 is the button
Seat 1: d437c92d ($62.81 in chips)
Seat 2: cc092a76 ($12.27 in chips)
Seat 3: acf1a889 ($18.52 in chips)
Seat 4: 528a07f8 ($33.52 in chips)
Seat 5: 61ad32d ($18.99 in chips)
Seat 6: Hero ($25 in chips)
cc092a76: posts small blind $0.1
acf1a889: posts big blind $0.25
*** HOLE CARDS ***
Dealt to d437c92d 
Dealt to cc092a76 
Dealt to acf1a889 
Dealt to 528a07f8 
Dealt to 61ad32d 
Dealt to Hero [Td 6h]
528a07f8: folds
61ad32d: folds
Hero: folds
d437c92d: folds
cc092a76: raises $0.25 to $0.5
acf1a889: calls $0.25
*** FLOP *** [7s 9s Qs]
cc092a76: bets $0.6
acf1a889: calls $0.6
*** TURN *** [7s 9s Qs] [6c]
cc092a76: bets $1.2
acf1a889: calls $1.2
*** RIVER *** [7s 9s Qs 6c] [Jd]
cc092a76: bets $2.5
acf1a889: calls $2.5
cc092a76: shows [Qd Ts] (Pair of Queens)
acf1a889: shows [Js 9h] (Pair of Jacks and Pair of Nines)
*** SHOWDOWN ***
acf1a889 collected $9.6 from pot
*** SUMMARY ***
Total pot $9.6
Board [7s 9s Qs 6c Jd]
Seat 1: d437c92d (button) folded before Flop (didn't bet)
Seat 2: cc092a76 (small blind) showed [Qd Ts] and lost with Pair of Queens
Seat 3: acf1a889 (big blind) showed [Js 9h] and won ($9.6) with Pair of Jacks and Pair of Nines
Seat 4: 528a07f8 folded before Flop (didn't bet)
Seat 5: 61ad32d folded before Flop (didn't bet)
Seat 6: Hero folded before Flop (didn't bet)


Poker Hand #RC95091189: Hold'em No Limit ($0.1/$0.25) - 2020/04/07 15:29:39
Table 'RushAndCash364847' 6-max Seat #1 is the button
Seat 1: 704a7fcf ($30.03 in chips)
Seat 2: Hero ($25 in chips)
Seat 3: 62eebc49 ($118.5 in chips)
Seat 4: af65165a ($13.49 in chips)
Seat 5: efdadab5 ($11.65 in chips)
Seat 6: 966446c2 ($33.86 in chips)
Hero: posts small blind $0.1
62eebc49: posts big blind $0.25
*** HOLE CARDS ***
Dealt to 704a7fcf 
Dealt to Hero [Ad 8c]
Dealt to 62eebc49 
Dealt to af65165a 
Dealt to efdadab5 
Dealt to 966446c2 
af65165a: folds
efdadab5: folds
966446c2: raises $0.5 to $0.75
704a7fcf: folds
Hero: folds
62eebc49: folds
Uncalled bet ($0.5) returned to 966446c2
*** SHOWDOWN ***
966446c2 collected $0.6 from pot
*** SUMMARY ***
Total pot $0.6
Seat 1: 704a7fcf (button) folded before Flop (didn't bet)
Seat 2: Hero (small blind) folded before Flop
Seat 3: 62eebc49 (big blind) folded before Flop
Seat 4: af65165a folded before Flop (didn't bet)
Seat 5: efdadab5 folded before Flop (didn't bet)
Seat 6: 966446c2 collected ($0.6)


Poker Hand #RC95091283: Hold'em No Limit ($0.1/$0.25) - 2020/04/07 15:29:51
Table 'RushAndCash364857' 6-max Seat #1 is the button
Seat 1: 49b3e425 ($26.81 in chips)
Seat 2: 1179c6f3 ($26.36 in chips)
Seat 3: d2f55a32 ($18.25 in chips)
Seat 4: Hero ($25 in chips)
Seat 5: a4ba858f ($27.46 in chips)
Seat 6: af65165a ($13.49 in chips)
1179c6f3: posts small blind $0.1
d2f55a32: posts big blind $0.25
*** HOLE CARDS ***
Dealt to 49b3e425 
Dealt to 1179c6f3 
Dealt to d2f55a32 
Dealt to Hero [7h 7c]
Dealt to a4ba858f 
Dealt to af65165a 
Hero: raises $0.38 to $0.63
a4ba858f: folds
af65165a: folds
49b3e425: folds
1179c6f3: folds
d2f55a32: folds
Uncalled bet ($0.38) returned to Hero
*** SHOWDOWN ***
Hero collected $0.6 from pot
*** SUMMARY ***
Total pot $0.6
Seat 1: 49b3e425 (button) folded before Flop (didn't bet)
Seat 2: 1179c6f3 (small blind) folded before Flop
Seat 3: d2f55a32 (big blind) folded before Flop
Seat 4: Hero collected ($0.6)
Seat 5: a4ba858f folded before Flop (didn't bet)
Seat 6: af65165a folded before Flop (didn't bet)


Poker Hand #RC95091368: Hold'em No Limit ($0.1/$0.25) - 2020/04/07 15:30:02
Table 'RushAndCash364870' 6-max Seat #1 is the button
Seat 1: 1780ed6 ($55.97 in chips)
Seat 2: 368bffcd ($27.12 in chips)
Seat 3: c4f78976 ($12 in chips)
Seat 4: 704a7fcf ($30.03 in chips)
Seat 5: 432498db ($26.28 in chips)
Seat 6: Hero ($25.35 in chips)
368bffcd: posts small blind $0.1
c4f78976: posts big blind $0.25
*** HOLE CARDS ***
Dealt to 1780ed6 
Dealt to 368bffcd 
Dealt to c4f78976 
Dealt to 704a7fcf 
Dealt to 432498db 
Dealt to Hero [9d 6c]
704a7fcf: folds
432498db: folds
Hero: folds
1780ed6: raises $0.38 to $0.63
368bffcd: folds
c4f78976: folds
Uncalled bet ($0.38) returned to 1780ed6
*** SHOWDOWN ***
1780ed6 collected $0.6 from pot
*** SUMMARY ***
Total pot $0.6
Seat 1: 1780ed6 (button) collected ($0.6)
Seat 2: 368bffcd (small blind) folded before Flop
Seat 3: c4f78976 (big blind) folded before Flop
Seat 4: 704a7fcf folded before Flop (didn't bet)
Seat 5: 432498db folded before Flop (didn't bet)
Seat 6: Hero folded before Flop (didn't bet)


Poker Hand #RC95091396: Hold'em No Limit ($0.1/$0.25) - 2020/04/07 15:30:06
Table 'RushAndCash364873' 6-max Seat #1 is the button
Seat 1: Hero ($25.35 in chips)
Seat 2: af84e661 ($3.82 in chips)
Seat 3: 103129d8 ($26.57 in chips)
Seat 4: ecd599c ($5.45 in chips)
Seat 5: be711e9d ($30.11 in chips)
Seat 6: e6c023d1 ($36.3 in chips)
af84e661: posts small blind $0.1
103129d8: posts big blind $0.25
*** HOLE CARDS ***
Dealt to Hero [9h 6c]
Dealt to af84e661 
Dealt to 103129d8 
Dealt to ecd599c 
Dealt to be711e9d 
Dealt to e6c023d1 
ecd599c: folds
be711e9d: folds
e6c023d1: raises $0.38 to $0.63
Hero: folds
af84e661: folds
103129d8: raises $1.37 to $2
e6c023d1: calls $1.37
*** FLOP *** [6d Qc Tc]
103129d8: checks
e6c023d1: bets $2.5
103129d8: folds
Uncalled bet ($2.5) returned to e6c023d1
*** SHOWDOWN ***
e6c023d1 collected $4.1 from pot
*** SUMMARY ***
Total pot $4.1
Board [6d Qc Tc]
Seat 1: Hero (button) folded before Flop (didn't bet)
Seat 2: af84e661 (small blind) folded before Flop
Seat 3: 103129d8 (big blind) folded on the Flop
Seat 4: ecd599c folded before Flop (didn't bet)
Seat 5: be711e9d folded before Flop (didn't bet)
Seat 6: e6c023d1 won ($4.1)


Poker Hand #RC95091428: Hold'em No Limit ($0.1/$0.25) - 2020/04/07 15:30:10
Table 'RushAndCash364878' 6-max Seat #1 is the button
Seat 1: 2d45ce80 ($8.76 in chips)
Seat 2: bda1b4ce ($25 in chips)
Seat 3: Hero ($25.35 in chips)
Seat 4: ecd599c ($5.45 in chips)
Seat 5: 36017ad1 ($27.53 in chips)
Seat 6: 3423a84d ($39.66 in chips)
bda1b4ce: posts small blind $0.1
Hero: posts big blind $0.25
*** HOLE CARDS ***
Dealt to 2d45ce80 
Dealt to bda1b4ce 
Dealt to Hero [5h 2h]
Dealt to ecd599c 
Dealt to 36017ad1 
Dealt to 3423a84d 
ecd599c: raises $0.25 to $0.5
36017ad1: folds
3423a84d: folds
2d45ce80: folds
bda1b4ce: raises $1.8 to $2.3
Hero: folds
ecd599c: raises $3.15 to $5.45 and is all-in
bda1b4ce: calls $3.15
ecd599c: shows [Kc Ks]
bda1b4ce: shows [Kh Ac]
*** FLOP *** [Tc 3h 8s]
*** TURN *** [Tc 3h 8s] [Ts]
*** RIVER *** [Tc 3h 8s Ts] [5c]
*** SHOWDOWN ***
ecd599c collected $11.15 from pot
*** SUMMARY ***
Total pot $11.15
Board [Tc 3h 8s Ts 5c]
Seat 1: 2d45ce80 (button) folded before Flop (didn't bet)
Seat 2: bda1b4ce (small blind) showed [Ac Kh] and lost with Pair of Tens
Seat 3: Hero (big blind) folded before Flop
Seat 4: ecd599c showed [Ks Kc] and won ($11.15) with Pair of Kings and Pair of Tens
Seat 5: 36017ad1 folded before Flop (didn't bet)
Seat 6: 3423a84d folded before Flop (didn't bet)


Poker Hand #RC95091526: Hold'em No Limit ($0.1/$0.25) - 2020/04/07 15:30:21
Table 'RushAndCash364888' 6-max Seat #1 is the button
Seat 1: 1179c6f3 ($26.61 in chips)
Seat 2: Hero ($25.1 in chips)
Seat 3: efdadab5 ($11.65 in chips)
Seat 4: 418ccf5b ($22.36 in chips)
Seat 5: b31e5039 ($14.97 in chips)
Seat 6: d437c92d ($61.71 in chips)
Hero: posts small blind $0.1
efdadab5: posts big blind $0.25
*** HOLE CARDS ***
Dealt to 1179c6f3 
Dealt to Hero [Ah 3c]
Dealt to efdadab5 
Dealt to 418ccf5b 
Dealt to b31e5039 
Dealt to d437c92d 
418ccf5b: raises $0.38 to $0.63
b31e5039: raises $1.37 to $2
d437c92d: folds
1179c6f3: folds
Hero: folds
efdadab5: folds
418ccf5b: calls $1.37
*** FLOP *** [8d 3h 7h]
418ccf5b: checks
b31e5039: bets $2.2
418ccf5b: calls $2.2
*** TURN *** [8d 3h 7h] [3d]
418ccf5b: checks
b31e5039: bets $7.5
418ccf5b: raises $10.66 to $18.16 and is all-in
b31e5039: calls $3.27 and is all-in
Uncalled bet ($7.39) returned to 418ccf5b
418ccf5b: shows [5d 5s] (Pair of Fives and Pair of Treys)
b31e5039: shows [Ad As] (Pair of Aces and Pair of Treys)
*** RIVER *** [8d 3h 7h 3d] [6c]
*** SHOWDOWN ***
b31e5039 collected $30.29 from pot
*** SUMMARY ***
Total pot $30.29
Board [8d 3h 7h 3d 6c]
Seat 1: 1179c6f3 (button) folded before Flop (didn't bet)
Seat 2: Hero (small blind) folded before Flop
Seat 3: efdadab5 (big blind) folded before Flop
Seat 4: 418ccf5b showed [5s 5d] and lost with Pair of Fives and Pair of Treys
Seat 5: b31e5039 showed [As Ad] and won ($30.29) with Pair of Aces and Pair of Treys
Seat 6: d437c92d folded before Flop (didn't bet)


Poker Hand #RC95091554: Hold'em No Limit ($0.1/$0.25) - 2020/04/07 15:30:25
Table 'RushAndCash364891' 6-max Seat #1 is the button
Seat 1: cc092a76 ($7.47 in chips)
Seat 2: 74937d40 ($28.26 in chips)
Seat 3: 1179c6f3 ($26.61 in chips)
Seat 4: Hero ($25 in chips)
Seat 5: acf1a889 ($22.59 in chips)
Seat 6: 49b3e425 ($27.06 in chips)
74937d40: posts small blind $0.1
1179c6f3: posts big blind $0.25
*** HOLE CARDS ***
Dealt to cc092a76 
Dealt to 74937d40 
Dealt to 1179c6f3 
Dealt to Hero [9c 8c]
Dealt to acf1a889 
Dealt to 49b3e425 
Hero: raises $0.38 to $0.63
acf1a889: folds
49b3e425: folds
cc092a76: raises $1.27 to $1.9
74937d40: folds
1179c6f3: folds
Hero: calls $1.27
*** FLOP *** [Ts 3c 3s]
Hero: checks
cc092a76: checks
*** TURN *** [Ts 3c 3s] [Td]
Hero: checks
cc092a76: bets $3.2
Hero: folds
Uncalled bet ($3.2) returned to cc092a76
*** SHOWDOWN ***
cc092a76 collected $4.15 from pot
*** SUMMARY ***
Total pot $4.15
Board [Ts 3c 3s Td]
Seat 1: cc092a76 (button) won ($4.15)
Seat 2: 74937d40 (small blind) folded before Flop
Seat 3: 1179c6f3 (big blind) folded before Flop
Seat 4: Hero folded on the Turn
Seat 5: acf1a889 folded before Flop (didn't bet)
Seat 6: 49b3e425 folded before Flop (didn't bet)


Poker Hand #RC95091812: Hold'em No Limit ($0.1/$0.25) - 2020/04/07 15:30:58
Table 'RushAndCash364920' 6-max Seat #1 is the button
Seat 1: c4f78976 ($11.12 in chips)
Seat 2: e131407f ($30.76 in chips)
Seat 3: Hero ($25 in chips)
Seat 4: 8004b155 ($12 in chips)
Seat 5: 889e7e90 ($28.59 in chips)
Seat 6: cc092a76 ($9.52 in chips)
e131407f: posts small blind $0.1
Hero: posts big blind $0.25
*** HOLE CARDS ***
Dealt to c4f78976 
Dealt to e131407f 
Dealt to Hero [9h 6c]
Dealt to 8004b155 
Dealt to 889e7e90 
Dealt to cc092a76 
8004b155: folds
889e7e90: folds
cc092a76: calls $0.25
c4f78976: folds
e131407f: folds
Hero: checks
*** FLOP *** [Qc 3s Ah]
Hero: checks
cc092a76: checks
*** TURN *** [Qc 3s Ah] [2d]
Hero: checks
cc092a76: checks
*** RIVER *** [Qc 3s Ah 2d] [Kh]
Hero: checks
cc092a76: checks
Hero: shows [6c 9h] (Ace-High)
cc092a76: shows [Ts 9c] (Ace-High)
*** SHOWDOWN ***
cc092a76 collected $0.6 from pot
*** SUMMARY ***
Total pot $0.6
Board [Qc 3s Ah 2d Kh]
Seat 1: c4f78976 (button) folded before Flop (didn't bet)
Seat 2: e131407f (small blind) folded before Flop
Seat 3: Hero (big blind) showed [9h 6c] and lost with Ace-High
Seat 4: 8004b155 folded before Flop (didn't bet)
Seat 5: 889e7e90 folded before Flop (didn't bet)
Seat 6: cc092a76 showed [Ts 9c] and won ($0.6) with Ace-High


Poker Hand #RC95091856: Hold'em No Limit ($0.1/$0.25) - 2020/04/07 15:31:03
Table 'RushAndCash364928' 6-max Seat #1 is the button
Seat 1: 366c47e0 ($8.27 in chips)
Seat 2: 36017ad1 ($28.84 in chips)
Seat 3: 966446c2 ($34.31 in chips)
Seat 4: fe3f48f4 ($25 in chips)
Seat 5: Hero ($25 in chips)
Seat 6: b5d592d2 ($12.41 in chips)
36017ad1: posts small blind $0.1
966446c2: posts big blind $0.25
*** HOLE CARDS ***
Dealt to 366c47e0 
Dealt to 36017ad1 
Dealt to 966446c2 
Dealt to fe3f48f4 
Dealt to Hero [Ac 2c]
Dealt to b5d592d2 
fe3f48f4: folds
Hero: raises $0.38 to $0.63
b5d592d2: folds
366c47e0: calls $0.63
36017ad1: folds
966446c2: folds
*** FLOP *** [Ad 8d 3s]
Hero: bets $0.87
366c47e0: folds
Uncalled bet ($0.87) returned to Hero
*** SHOWDOWN ***
Hero collected $1.61 from pot
*** SUMMARY ***
Total pot $1.61
Board [Ad 8d 3s]
Seat 1: 366c47e0 (button) folded on the Flop
Seat 2: 36017ad1 (small blind) folded before Flop
Seat 3: 966446c2 (big blind) folded before Flop
Seat 4: fe3f48f4 folded before Flop (didn't bet)
Seat 5: Hero won ($1.61)
Seat 6: b5d592d2 folded before Flop (didn't bet)


Poker Hand #RC95092045: Hold'em No Limit ($0.1/$0.25) - 2020/04/07 15:31:29
Table 'RushAndCash364956' 6-max Seat #1 is the button
Seat 1: Hero ($25.9 in chips)
Seat 2: 5ffa3a03 ($16.45 in chips)
Seat 3: 61ad32d ($18.82 in chips)
Seat 4: e814b201 ($25.2 in chips)
Seat 5: 81c6db62 ($29.82 in chips)
Seat 6: 8004b155 ($11.65 in chips)
5ffa3a03: posts small blind $0.1
61ad32d: posts big blind $0.25
*** HOLE CARDS ***
Dealt to Hero [Td 4s]
Dealt to 5ffa3a03 
Dealt to 61ad32d 
Dealt to e814b201 
Dealt to 81c6db62 
Dealt to 8004b155 
e814b201: folds
81c6db62: folds
8004b155: folds
Hero: folds
5ffa3a03: folds
Uncalled bet ($0.15) returned to 61ad32d
*** SHOWDOWN ***
61ad32d collected $0.2 from pot
*** SUMMARY ***
Total pot $0.2
Seat 1: Hero (button) folded before Flop (didn't bet)
Seat 2: 5ffa3a03 (small blind) folded before Flop
Seat 3: 61ad32d (big blind) collected ($0.2)
Seat 4: e814b201 folded before Flop (didn't bet)
Seat 5: 81c6db62 folded before Flop (didn't bet)
Seat 6: 8004b155 folded before Flop (didn't bet)


Poker Hand #RC95092074: Hold'em No Limit ($0.1/$0.25) - 2020/04/07 15:31:32
Table 'RushAndCash364960' 6-max Seat #1 is the button
Seat 1: 9c76a6c2 ($27.47 in chips)
Seat 2: fc8a29ea ($69.95 in chips)
Seat 3: 3d05956 ($19.56 in chips)
Seat 4: d3373005 ($13.16 in chips)
Seat 5: d8859ee1 ($26.38 in chips)
Seat 6: Hero ($25.9 in chips)
fc8a29ea: posts small blind $0.1
3d05956: posts big blind $0.25
*** HOLE CARDS ***
Dealt to 9c76a6c2 
Dealt to fc8a29ea 
Dealt to 3d05956 
Dealt to d3373005 
Dealt to d8859ee1 
Dealt to Hero [Ah 7s]
d3373005: folds
d8859ee1: folds
Hero: folds
9c76a6c2: folds
fc8a29ea: folds
Uncalled bet ($0.15) returned to 3d05956
*** SHOWDOWN ***
3d05956 collected $0.2 from pot
*** SUMMARY ***
Total pot $0.2
Seat 1: 9c76a6c2 (button) folded before Flop (didn't bet)
Seat 2: fc8a29ea (small blind) folded before Flop
Seat 3: 3d05956 (big blind) collected ($0.2)
Seat 4: d3373005 folded before Flop (didn't bet)
Seat 5: d8859ee1 folded before Flop (didn't bet)
Seat 6: Hero folded before Flop (didn't bet)


Poker Hand #RC95092111: Hold'em No Limit ($0.1/$0.25) - 2020/04/07 15:31:36
Table 'RushAndCash364964' 6-max Seat #1 is the button
Seat 1: d8859ee1 ($26.38 in chips)
Seat 2: Hero ($25.9 in chips)
Seat 3: acf1a889 ($19.74 in chips)
Seat 4: ec1c524d ($25 in chips)
Seat 5: 74937d40 ($27.91 in chips)
Seat 6: 5ffa3a03 ($16.7 in chips)
Hero: posts small blind $0.1
acf1a889: posts big blind $0.25
*** HOLE CARDS ***
Dealt to d8859ee1 
Dealt to Hero [7c 4s]
Dealt to acf1a889 
Dealt to ec1c524d 
Dealt to 74937d40 
Dealt to 5ffa3a03 
ec1c524d: folds
74937d40: folds
5ffa3a03: folds
d8859ee1: folds
Hero: folds
Uncalled bet ($0.15) returned to acf1a889
*** SHOWDOWN ***
acf1a889 collected $0.2 from pot
*** SUMMARY ***
Total pot $0.2
Seat 1: d8859ee1 (button) folded before Flop (didn't bet)
Seat 2: Hero (small blind) folded before Flop
Seat 3: acf1a889 (big blind) collected ($0.2)
Seat 4: ec1c524d folded before Flop (didn't bet)
Seat 5: 74937d40 folded before Flop (didn't bet)
Seat 6: 5ffa3a03 folded before Flop (didn't bet)


Poker Hand #RC95092140: Hold'em No Limit ($0.1/$0.25) - 2020/04/07 15:31:40
Table 'RushAndCash364968' 6-max Seat #1 is the button
Seat 1: Hero ($25.8 in chips)
Seat 2: af65165a ($12.23 in chips)
Seat 3: d8859ee1 ($26.38 in chips)
Seat 4: d5989e2b ($24.69 in chips)
Seat 5: fc8a29ea ($69.85 in chips)
Seat 6: bb849ffc ($10.84 in chips)
af65165a: posts small blind $0.1
d8859ee1: posts big blind $0.25
*** HOLE CARDS ***
Dealt to Hero [7c 4h]
Dealt to af65165a 
Dealt to d8859ee1 
Dealt to d5989e2b 
Dealt to fc8a29ea 
Dealt to bb849ffc 
d5989e2b: raises $0.5 to $0.75
fc8a29ea: folds
bb849ffc: folds
Hero: folds
af65165a: calls $0.65
d8859ee1: raises $1.75 to $2.5
d5989e2b: calls $1.75
af65165a: folds
*** FLOP *** [Tc Qc 2s]
d8859ee1: bets $4.4
d5989e2b: calls $4.4
*** TURN *** [Tc Qc 2s] [9s]
d8859ee1: bets $11
d5989e2b: folds
Uncalled bet ($11) returned to d8859ee1
*** SHOWDOWN ***
d8859ee1 collected $14.55 from pot
*** SUMMARY ***
Total pot $14.55
Board [Tc Qc 2s 9s]
Seat 1: Hero (button) folded before Flop (didn't bet)
Seat 2: af65165a (small blind) folded before Flop
Seat 3: d8859ee1 (big blind) won ($14.55)
Seat 4: d5989e2b folded on the Turn
Seat 5: fc8a29ea folded before Flop (didn't bet)
Seat 6: bb849ffc folded before Flop (didn't bet)


Poker Hand #RC95092173: Hold'em No Limit ($0.1/$0.25) - 2020/04/07 15:31:45
Table 'RushAndCash364972' 6-max Seat #1 is the button
Seat 1: ecd599c ($9.1 in chips)
Seat 2: 418ccf5b ($7.14 in chips)
Seat 3: 62eebc49 ($118.15 in chips)
Seat 4: 17388104 ($18.84 in chips)
Seat 5: Hero ($25.8 in chips)
Seat 6: ec1c524d ($25 in chips)
418ccf5b: posts small blind $0.1
62eebc49: posts big blind $0.25
*** HOLE CARDS ***
Dealt to ecd599c 
Dealt to 418ccf5b 
Dealt to 62eebc49 
Dealt to 17388104 
Dealt to Hero [Ks 6c]
Dealt to ec1c524d 
17388104: folds
Hero: folds
ec1c524d: folds
ecd599c: folds
418ccf5b: raises $0.5 to $0.75
62eebc49: folds
Uncalled bet ($0.5) returned to 418ccf5b
*** SHOWDOWN ***
418ccf5b collected $0.5 from pot
*** SUMMARY ***
Total pot $0.5
Seat 1: ecd599c (button) folded before Flop (didn't bet)
Seat 2: 418ccf5b (small blind) collected ($0.5)
Seat 3: 62eebc49 (big blind) folded before Flop
Seat 4: 17388104 folded before Flop (didn't bet)
Seat 5: Hero folded before Flop (didn't bet)
Seat 6: ec1c524d folded before Flop (didn't bet)


Poker Hand #RC95092206: Hold'em No Limit ($0.1/$0.25) - 2020/04/07 15:31:48
Table 'RushAndCash364976' 6-max Seat #1 is the button
Seat 1: 17388104 ($18.84 in chips)
Seat 2: caa68458 ($25.04 in chips)
Seat 3: Hero ($25.8 in chips)
Seat 4: 8b8d197c ($33.9 in chips)
Seat 5: 9c76a6c2 ($27.47 in chips)
Seat 6: dbf6981f ($57.6 in chips)
caa68458: posts small blind $0.1
Hero: posts big blind $0.25
*** HOLE CARDS ***
Dealt to 17388104 
Dealt to caa68458 
Dealt to Hero [5s 2h]
Dealt to 8b8d197c 
Dealt to 9c76a6c2 
Dealt to dbf6981f 
8b8d197c: folds
9c76a6c2: raises $0.25 to $0.5
dbf6981f: folds
17388104: calls $0.5
caa68458: folds
Hero: folds
*** FLOP *** [Jd 8h 2s]
9c76a6c2: bets $0.7
17388104: raises $1.4 to $2.1
9c76a6c2: folds
Uncalled bet ($1.4) returned to 17388104
*** SHOWDOWN ***
17388104 collected $2.75 from pot
*** SUMMARY ***
Total pot $2.75
Board [Jd 8h 2s]
Seat 1: 17388104 (button) won ($2.75)
Seat 2: caa68458 (small blind) folded before Flop
Seat 3: Hero (big blind) folded before Flop
Seat 4: 8b8d197c folded before Flop (didn't bet)
Seat 5: 9c76a6c2 folded on the Flop
Seat 6: dbf6981f folded before Flop (didn't bet)


Poker Hand #RC95092240: Hold'em No Limit ($0.1/$0.25) - 2020/04/07 15:31:53
Table 'RushAndCash364979' 6-max Seat #1 is the button
Seat 1: 98ddea23 ($17.31 in chips)
Seat 2: 8b8d197c ($33.9 in chips)
Seat 3: 7bf7c8c9 ($25 in chips)
Seat 4: 5ffa3a03 ($16.7 in chips)
Seat 5: Hero ($25.55 in chips)
Seat 6: cc092a76 ($9.84 in chips)
8b8d197c: posts small blind $0.1
7bf7c8c9: posts big blind $0.25
*** HOLE CARDS ***
Dealt to 98ddea23 
Dealt to 8b8d197c 
Dealt to 7bf7c8c9 
Dealt to 5ffa3a03 
Dealt to Hero [Qh Jd]
Dealt to cc092a76 
5ffa3a03: raises $0.5 to $0.75
Hero: folds
cc092a76: folds
98ddea23: calls $0.75
8b8d197c: folds
7bf7c8c9: raises $3 to $3.75
5ffa3a03: folds
98ddea23: folds
Uncalled bet ($3) returned to 7bf7c8c9
*** SHOWDOWN ***
7bf7c8c9 collected $2.35 from pot
*** SUMMARY ***
Total pot $2.35
Seat 1: 98ddea23 (button) folded before Flop
Seat 2: 8b8d197c (small blind) folded before Flop
Seat 3: 7bf7c8c9 (big blind) collected ($2.35)
Seat 4: 5ffa3a03 folded before Flop
Seat 5: Hero folded before Flop (didn't bet)
Seat 6: cc092a76 folded before Flop (didn't bet)


Poker Hand #RC95092279: Hold'em No Limit ($0.1/$0.25) - 2020/04/07 15:31:58
Table 'RushAndCash364983' 6-max Seat #1 is the button
Seat 1: 8004b155 ($11.3 in chips)
Seat 2: e131407f ($30.66 in chips)
Seat 3: d3373005 ($13.51 in chips)
Seat 4: Hero ($25.55 in chips)
Seat 5: 45920dbc ($47.99 in chips)
Seat 6: 49b3e425 ($27.52 in chips)
e131407f: posts small blind $0.1
d3373005: posts big blind $0.25
*** HOLE CARDS ***
Dealt to 8004b155 
Dealt to e131407f 
Dealt to d3373005 
Dealt to Hero [Th 4s]
Dealt to 45920dbc 
Dealt to 49b3e425 
Hero: folds
45920dbc: folds
49b3e425: folds
8004b155: folds
e131407f: calls $0.15
d3373005: checks
*** FLOP *** [Jh 6h Tc]
e131407f: bets $0.25
d3373005: folds
Uncalled bet ($0.25) returned to e131407f
*** SHOWDOWN ***
e131407f collected $0.5 from pot
*** SUMMARY ***
Total pot $0.5
Board [Jh 6h Tc]
Seat 1: 8004b155 (button) folded before Flop (didn't bet)
Seat 2: e131407f (small blind) won ($0.5)
Seat 3: d3373005 (big blind) folded on the Flop
Seat 4: Hero folded before Flop (didn't bet)
Seat 5: 45920dbc folded before Flop (didn't bet)
Seat 6: 49b3e425 folded before Flop (didn't bet)


Poker Hand #RC95092306: Hold'em No Limit ($0.1/$0.25) - 2020/04/07 15:32:02
Table 'RushAndCash364985' 6-max Seat #1 is the button
Seat 1: Hero ($25.55 in chips)
Seat 2: d437c92d ($65.44 in chips)
Seat 3: ec1c524d ($25 in chips)
Seat 4: bbb85b3f ($33.84 in chips)
Seat 5: ecd599c ($9 in chips)
Seat 6: 45920dbc ($47.99 in chips)
d437c92d: posts small blind $0.1
ec1c524d: posts big blind $0.25
*** HOLE CARDS ***
Dealt to Hero [8c 3h]
Dealt to d437c92d 
Dealt to ec1c524d 
Dealt to bbb85b3f 
Dealt to ecd599c 
Dealt to 45920dbc 
bbb85b3f: folds
ecd599c: folds
45920dbc: raises $0.38 to $0.63
Hero: folds
d437c92d: folds
ec1c524d: folds
Uncalled bet ($0.38) returned to 45920dbc
*** SHOWDOWN ***
45920dbc collected $0.6 from pot
*** SUMMARY ***
Total pot $0.6
Seat 1: Hero (button) folded before Flop (didn't bet)
Seat 2: d437c92d (small blind) folded before Flop
Seat 3: ec1c524d (big blind) folded before Flop
Seat 4: bbb85b3f folded before Flop (didn't bet)
Seat 5: ecd599c folded before Flop (didn't bet)
Seat 6: 45920dbc collected ($0.6)


Poker Hand #RC95092327: Hold'em No Limit ($0.1/$0.25) - 2020/04/07 15:32:05
Table 'RushAndCash364988' 6-max Seat #1 is the button
Seat 1: acf1a889 ($19.84 in chips)
Seat 2: a0d04110 ($43.69 in chips)
Seat 3: 9f138297 ($30.75 in chips)
Seat 4: 3cfd7308 ($47.96 in chips)
Seat 5: af65165a ($11.48 in chips)
Seat 6: Hero ($25.55 in chips)
a0d04110: posts small blind $0.1
9f138297: posts big blind $0.25
*** HOLE CARDS ***
Dealt to acf1a889 
Dealt to a0d04110 
Dealt to 9f138297 
Dealt to 3cfd7308 
Dealt to af65165a 
Dealt to Hero [Qh 7c]
3cfd7308: raises $0.38 to $0.63
af65165a: folds
Hero: folds
acf1a889: folds
a0d04110: folds
9f138297: folds
Uncalled bet ($0.38) returned to 3cfd7308
*** SHOWDOWN ***
3cfd7308 collected $0.6 from pot
*** SUMMARY ***
Total pot $0.6
Seat 1: acf1a889 (button) folded before Flop (didn't bet)
Seat 2: a0d04110 (small blind) folded before Flop
Seat 3: 9f138297 (big blind) folded before Flop
Seat 4: 3cfd7308 collected ($0.6)
Seat 5: af65165a folded before Flop (didn't bet)
Seat 6: Hero folded before Flop (didn't bet)


Poker Hand #RC95092355: Hold'em No Limit ($0.1/$0.25) - 2020/04/07 15:32:09
Table 'RushAndCash364992' 6-max Seat #1 is the button
Seat 1: bda1b4ce ($25 in chips)
Seat 2: 289f2e46 ($22.1 in chips)
Seat 3: d437c92d ($65.34 in chips)
Seat 4: 8c86f461 ($40.54 in chips)
Seat 5: d5989e2b ($17.79 in chips)
Seat 6: Hero ($25.55 in chips)
289f2e46: posts small blind $0.1
d437c92d: posts big blind $0.25
*** HOLE CARDS ***
Dealt to bda1b4ce 
Dealt to 289f2e46 
Dealt to d437c92d 
Dealt to 8c86f461 
Dealt to d5989e2b 
Dealt to Hero [Th Td]
8c86f461: folds
d5989e2b: folds
Hero: raises $0.38 to $0.63
bda1b4ce: folds
289f2e46: folds
d437c92d: folds
Uncalled bet ($0.38) returned to Hero
*** SHOWDOWN ***
Hero collected $0.6 from pot
*** SUMMARY ***
Total pot $0.6
Seat 1: bda1b4ce (button) folded before Flop (didn't bet)
Seat 2: 289f2e46 (small blind) folded before Flop
Seat 3: d437c92d (big blind) folded before Flop
Seat 4: 8c86f461 folded before Flop (didn't bet)
Seat 5: d5989e2b folded before Flop (didn't bet)
Seat 6: Hero collected ($0.6)


Poker Hand #RC95092486: Hold'em No Limit ($0.1/$0.25) - 2020/04/07 15:32:28
Table 'RushAndCash365008' 6-max Seat #1 is the button
Seat 1: ec1c524d ($25 in chips)
Seat 2: efdadab5 ($12.9 in chips)
Seat 3: 45920dbc ($48.34 in chips)
Seat 4: bf64de7f ($8.81 in chips)
Seat 5: cc092a76 ($9.34 in chips)
Seat 6: Hero ($25.9 in chips)
efdadab5: posts small blind $0.1
45920dbc: posts big blind $0.25
*** HOLE CARDS ***
Dealt to ec1c524d 
Dealt to efdadab5 
Dealt to 45920dbc 
Dealt to bf64de7f 
Dealt to cc092a76 
Dealt to Hero [Jd 5h]
bf64de7f: folds
cc092a76: calls $0.25
Hero: folds
ec1c524d: calls $0.25
efdadab5: folds
45920dbc: checks
*** FLOP *** [Ts 5c 7d]
45920dbc: checks
cc092a76: checks
ec1c524d: bets $0.5
45920dbc: calls $0.5
cc092a76: folds
*** TURN *** [Ts 5c 7d] [2s]
45920dbc: checks
ec1c524d: bets $1.4
45920dbc: folds
Uncalled bet ($1.4) returned to ec1c524d
*** SHOWDOWN ***
ec1c524d collected $1.85 from pot
*** SUMMARY ***
Total pot $1.85
Board [Ts 5c 7d 2s]
Seat 1: ec1c524d (button) won ($1.85)
Seat 2: efdadab5 (small blind) folded before Flop
Seat 3: 45920dbc (big blind) folded on the Turn
Seat 4: bf64de7f folded before Flop (didn't bet)
Seat 5: cc092a76 folded on the Flop
Seat 6: Hero folded before Flop (didn't bet)


Poker Hand #RC95092513: Hold'em No Limit ($0.1/$0.25) - 2020/04/07 15:32:32
Table 'RushAndCash365011' 6-max Seat #1 is the button
Seat 1: fe3f48f4 ($25 in chips)
Seat 2: d9a04cfb ($25 in chips)
Seat 3: 30cab83a ($28.76 in chips)
Seat 4: e814b201 ($25 in chips)
Seat 5: 3d395129 ($11.65 in chips)
Seat 6: Hero ($25.9 in chips)
d9a04cfb: posts small blind $0.1
30cab83a: posts big blind $0.25
*** HOLE CARDS ***
Dealt to fe3f48f4 
Dealt to d9a04cfb 
Dealt to 30cab83a 
Dealt to e814b201 
Dealt to 3d395129 
Dealt to Hero [9c 4d]
e814b201: folds
3d395129: folds
Hero: folds
fe3f48f4: folds
d9a04cfb: folds
Uncalled bet ($0.15) returned to 30cab83a
*** SHOWDOWN ***
30cab83a collected $0.2 from pot
*** SUMMARY ***
Total pot $0.2
Seat 1: fe3f48f4 (button) folded before Flop (didn't bet)
Seat 2: d9a04cfb (small blind) folded before Flop
Seat 3: 30cab83a (big blind) collected ($0.2)
Seat 4: e814b201 folded before Flop (didn't bet)
Seat 5: 3d395129 folded before Flop (didn't bet)
Seat 6: Hero folded before Flop (didn't bet)


Poker Hand #RC95092560: Hold'em No Limit ($0.1/$0.25) - 2020/04/07 15:32:38
Table 'RushAndCash365015' 6-max Seat #1 is the button
Seat 1: c535e341 ($29.14 in chips)
Seat 2: 704c37d9 ($45.72 in chips)
Seat 3: Hero ($25.9 in chips)
Seat 4: fe3f48f4 ($25 in chips)
Seat 5: 49b3e425 ($27.62 in chips)
Seat 6: 3d395129 ($11.65 in chips)
704c37d9: posts small blind $0.1
Hero: posts big blind $0.25
*** HOLE CARDS ***
Dealt to c535e341 
Dealt to 704c37d9 
Dealt to Hero [Kh 8c]
Dealt to fe3f48f4 
Dealt to 49b3e425 
Dealt to 3d395129 
fe3f48f4: raises $0.38 to $0.63
49b3e425: folds
3d395129: folds
c535e341: folds
704c37d9: folds
Hero: folds
Uncalled bet ($0.38) returned to fe3f48f4
*** SHOWDOWN ***
fe3f48f4 collected $0.6 from pot
*** SUMMARY ***
Total pot $0.6
Seat 1: c535e341 (button) folded before Flop (didn't bet)
Seat 2: 704c37d9 (small blind) folded before Flop
Seat 3: Hero (big blind) folded before Flop
Seat 4: fe3f48f4 collected ($0.6)
Seat 5: 49b3e425 folded before Flop (didn't bet)
Seat 6: 3d395129 folded before Flop (didn't bet)


Poker Hand #RC95092587: Hold'em No Limit ($0.1/$0.25) - 2020/04/07 15:32:42
Table 'RushAndCash365019' 6-max Seat #1 is the button
Seat 1: 49b3e425 ($27.62 in chips)
Seat 2: Hero ($25.65 in chips)
Seat 3: 3d395129 ($11.65 in chips)
Seat 4: 8b8d197c ($33.8 in chips)
Seat 5: 98ddea23 ($16.56 in chips)
Seat 6: acf1a889 ($19.74 in chips)
Hero: posts small blind $0.1
3d395129: posts big blind $0.25
*** HOLE CARDS ***
Dealt to 49b3e425 
Dealt to Hero [9h 3c]
Dealt to 3d395129 
Dealt to 8b8d197c 
Dealt to 98ddea23 
Dealt to acf1a889 
8b8d197c: folds
98ddea23: folds
acf1a889: folds
49b3e425: raises $0.25 to $0.5
Hero: folds
3d395129: folds
Uncalled bet ($0.25) returned to 49b3e425
*** SHOWDOWN ***
49b3e425 collected $0.6 from pot
*** SUMMARY ***
Total pot $0.6
Seat 1: 49b3e425 (button) collected ($0.6)
Seat 2: Hero (small blind) folded before Flop
Seat 3: 3d395129 (big blind) folded before Flop
Seat 4: 8b8d197c folded before Flop (didn't bet)
Seat 5: 98ddea23 folded before Flop (didn't bet)
Seat 6: acf1a889 folded before Flop (didn't bet)


Poker Hand #RC95092610: Hold'em No Limit ($0.1/$0.25) - 2020/04/07 15:32:45
Table 'RushAndCash365022' 6-max Seat #1 is the button
Seat 1: Hero ($25.55 in chips)
Seat 2: b31e5039 ($28.79 in chips)
Seat 3: bb849ffc ($11.29 in chips)
Seat 4: 98ddea23 ($16.56 in chips)
Seat 5: d3373005 ($13.16 in chips)
Seat 6: deb69778 ($37.79 in chips)
b31e5039: posts small blind $0.1
bb849ffc: posts big blind $0.25
*** HOLE CARDS ***
Dealt to Hero [Qs 9h]
Dealt to b31e5039 
Dealt to bb849ffc 
Dealt to 98ddea23 
Dealt to d3373005 
Dealt to deb69778 
98ddea23: calls $0.25
d3373005: folds
deb69778: raises $0.75 to $1
Hero: folds
b31e5039: calls $0.9
bb849ffc: folds
98ddea23: calls $0.75
*** FLOP *** [6h Js Qd]
b31e5039: checks
98ddea23: checks
deb69778: bets $1.7
b31e5039: folds
98ddea23: folds
Uncalled bet ($1.7) returned to deb69778
*** SHOWDOWN ***
deb69778 collected $3.25 from pot
*** SUMMARY ***
Total pot $3.25
Board [6h Js Qd]
Seat 1: Hero (button) folded before Flop (didn't bet)
Seat 2: b31e5039 (small blind) folded on the Flop
Seat 3: bb849ffc (big blind) folded before Flop
Seat 4: 98ddea23 folded on the Flop
Seat 5: d3373005 folded before Flop (didn't bet)
Seat 6: deb69778 won ($3.25)


Poker Hand #RC95092661: Hold'em No Limit ($0.1/$0.25) - 2020/04/07 15:32:52
Table 'RushAndCash365028' 6-max Seat #1 is the button
Seat 1: e131407f ($31.24 in chips)
Seat 2: Hero ($25.55 in chips)
Seat 3: 2d45ce80 ($7.86 in chips)
Seat 4: 5004602b ($12 in chips)
Seat 5: 3423a84d ($39.79 in chips)
Seat 6: 61ad32d ($19.72 in chips)
Hero: posts small blind $0.1
2d45ce80: posts big blind $0.25
*** HOLE CARDS ***
Dealt to e131407f 
Dealt to Hero [Qh Jh]
Dealt to 2d45ce80 
Dealt to 5004602b 
Dealt to 3423a84d 
Dealt to 61ad32d 
5004602b: folds
3423a84d: folds
61ad32d: folds
e131407f: folds
Hero: raises $0.5 to $0.75
2d45ce80: folds
Uncalled bet ($0.5) returned to Hero
*** SHOWDOWN ***
Hero collected $0.5 from pot
*** SUMMARY ***
Total pot $0.5
Seat 1: e131407f (button) folded before Flop (didn't bet)
Seat 2: Hero (small blind) collected ($0.5)
Seat 3: 2d45ce80 (big blind) folded before Flop
Seat 4: 5004602b folded before Flop (didn't bet)
Seat 5: 3423a84d folded before Flop (didn't bet)
Seat 6: 61ad32d folded before Flop (didn't bet)


Poker Hand #RC95092894: Hold'em No Limit ($0.1/$0.25) - 2020/04/07 15:33:23
Table 'RushAndCash365054' 6-max Seat #1 is the button
Seat 1: 17388104 ($19.66 in chips)
Seat 2: b3f0b9e0 ($11.07 in chips)
Seat 3: 98ddea23 ($15.56 in chips)
Seat 4: 889e7e90 ($24.27 in chips)
Seat 5: 32953d2a ($12.85 in chips)
Seat 6: Hero ($25.8 in chips)
b3f0b9e0: posts small blind $0.1
98ddea23: posts big blind $0.25
*** HOLE CARDS ***
Dealt to 17388104 
Dealt to b3f0b9e0 
Dealt to 98ddea23 
Dealt to 889e7e90 
Dealt to 32953d2a 
Dealt to Hero [Kd 5s]
889e7e90: folds
32953d2a: folds
Hero: folds
17388104: folds
b3f0b9e0: raises $0.38 to $0.63
98ddea23: folds
Uncalled bet ($0.38) returned to b3f0b9e0
*** SHOWDOWN ***
b3f0b9e0 collected $0.5 from pot
*** SUMMARY ***
Total pot $0.5
Seat 1: 17388104 (button) folded before Flop (didn't bet)
Seat 2: b3f0b9e0 (small blind) collected ($0.5)
Seat 3: 98ddea23 (big blind) folded before Flop
Seat 4: 889e7e90 folded before Flop (didn't bet)
Seat 5: 32953d2a folded before Flop (didn't bet)
Seat 6: Hero folded before Flop (didn't bet)


Poker Hand #RC95092926: Hold'em No Limit ($0.1/$0.25) - 2020/04/07 15:33:27
Table 'RushAndCash365058' 6-max Seat #1 is the button
Seat 1: 7c935d24 ($25 in chips)
Seat 2: 889e7e90 ($24.27 in chips)
Seat 3: 5ffa3a03 ($12.8 in chips)
Seat 4: 30cab83a ($28.86 in chips)
Seat 5: 45920dbc ($47.59 in chips)
Seat 6: Hero ($25.8 in chips)
889e7e90: posts small blind $0.1
5ffa3a03: posts big blind $0.25
*** HOLE CARDS ***
Dealt to 7c935d24 
Dealt to 889e7e90 
Dealt to 5ffa3a03 
Dealt to 30cab83a 
Dealt to 45920dbc 
Dealt to Hero [As 2d]
30cab83a: folds
45920dbc: folds
Hero: folds
7c935d24: folds
889e7e90: raises $0.5 to $0.75
5ffa3a03: raises $1.25 to $2
889e7e90: folds
Uncalled bet ($1.25) returned to 5ffa3a03
*** SHOWDOWN ***
5ffa3a03 collected $1.5 from pot
*** SUMMARY ***
Total pot $1.5
Seat 1: 7c935d24 (button) folded before Flop (didn't bet)
Seat 2: 889e7e90 (small blind) folded before Flop
Seat 3: 5ffa3a03 (big blind) collected ($1.5)
Seat 4: 30cab83a folded before Flop (didn't bet)
Seat 5: 45920dbc folded before Flop (didn't bet)
Seat 6: Hero folded before Flop (didn't bet)


Poker Hand #RC95092954: Hold'em No Limit ($0.1/$0.25) - 2020/04/07 15:33:31
Table 'RushAndCash365062' 6-max Seat #1 is the button
Seat 1: 7c935d24 ($25 in chips)
Seat 2: edde387a ($24.48 in chips)
Seat 3: ecd599c ($8.9 in chips)
Seat 4: ec1c524d ($26.01 in chips)
Seat 5: Hero ($25.8 in chips)
Seat 6: 7c0ffa93 ($33.19 in chips)
edde387a: posts small blind $0.1
ecd599c: posts big blind $0.25
*** HOLE CARDS ***
Dealt to 7c935d24 
Dealt to edde387a 
Dealt to ecd599c 
Dealt to ec1c524d 
Dealt to Hero [Td 8s]
Dealt to 7c0ffa93 
ec1c524d: folds
Hero: folds
7c0ffa93: folds
7c935d24: raises $0.38 to $0.63
edde387a: folds
ecd599c: folds
Uncalled bet ($0.38) returned to 7c935d24
*** SHOWDOWN ***
7c935d24 collected $0.6 from pot
*** SUMMARY ***
Total pot $0.6
Seat 1: 7c935d24 (button) collected ($0.6)
Seat 2: edde387a (small blind) folded before Flop
Seat 3: ecd599c (big blind) folded before Flop
Seat 4: ec1c524d folded before Flop (didn't bet)
Seat 5: Hero folded before Flop (didn't bet)
Seat 6: 7c0ffa93 folded before Flop (didn't bet)


Poker Hand #RC95092988: Hold'em No Limit ($0.1/$0.25) - 2020/04/07 15:33:35
Table 'RushAndCash365066' 6-max Seat #1 is the button
Seat 1: 5004602b ($11.3 in chips)
Seat 2: d07b3de1 ($31.27 in chips)
Seat 3: Hero ($25.8 in chips)
Seat 4: d6f2a39c ($6.31 in chips)
Seat 5: edde387a ($24.38 in chips)
Seat 6: 5794e88f ($39.53 in chips)
d07b3de1: posts small blind $0.1
Hero: posts big blind $0.25
*** HOLE CARDS ***
Dealt to 5004602b 
Dealt to d07b3de1 
Dealt to Hero [7h 6c]
Dealt to d6f2a39c 
Dealt to edde387a 
Dealt to 5794e88f 
d6f2a39c: raises $0.63 to $0.88
edde387a: folds
5794e88f: folds
5004602b: folds
d07b3de1: raises $2.62 to $3.5
Hero: folds
d6f2a39c: folds
Uncalled bet ($2.62) returned to d07b3de1
*** SHOWDOWN ***
d07b3de1 collected $2.01 from pot
*** SUMMARY ***
Total pot $2.01
Seat 1: 5004602b (button) folded before Flop (didn't bet)
Seat 2: d07b3de1 (small blind) collected ($2.01)
Seat 3: Hero (big blind) folded before Flop
Seat 4: d6f2a39c folded before Flop
Seat 5: edde387a folded before Flop (didn't bet)
Seat 6: 5794e88f folded before Flop (didn't bet)


Poker Hand #RC95093030: Hold'em No Limit ($0.1/$0.25) - 2020/04/07 15:33:40
Table 'RushAndCash365070' 6-max Seat #1 is the button
Seat 1: Hero ($25.55 in chips)
Seat 2: 61ad32d ($19.09 in chips)
Seat 3: 9f138297 ($30.15 in chips)
Seat 4: 40a91d41 ($25.67 in chips)
Seat 5: 52ee6b3d ($29.88 in chips)
Seat 6: 7ed3ab6b ($63.85 in chips)
61ad32d: posts small blind $0.1
9f138297: posts big blind $0.25
*** HOLE CARDS ***
Dealt to Hero [Ah Qc]
Dealt to 61ad32d 
Dealt to 9f138297 
Dealt to 40a91d41 
Dealt to 52ee6b3d 
Dealt to 7ed3ab6b 
40a91d41: folds
52ee6b3d: folds
7ed3ab6b: folds
Hero: raises $0.38 to $0.63
61ad32d: folds
9f138297: folds
Uncalled bet ($0.38) returned to Hero
*** SHOWDOWN ***
Hero collected $0.6 from pot
*** SUMMARY ***
Total pot $0.6
Seat 1: Hero (button) collected ($0.6)
Seat 2: 61ad32d (small blind) folded before Flop
Seat 3: 9f138297 (big blind) folded before Flop
Seat 4: 40a91d41 folded before Flop (didn't bet)
Seat 5: 52ee6b3d folded before Flop (didn't bet)
Seat 6: 7ed3ab6b folded before Flop (didn't bet)


Poker Hand #RC95093232: Hold'em No Limit ($0.1/$0.25) - 2020/04/07 15:34:06
Table 'RushAndCash365098' 6-max Seat #1 is the button
Seat 1: 3c96062f ($15.13 in chips)
Seat 2: caa68458 ($25 in chips)
Seat 3: 6736194e ($25.8 in chips)
Seat 4: 5ffa3a03 ($13.38 in chips)
Seat 5: 2d45ce80 ($7.76 in chips)
Seat 6: Hero ($25.9 in chips)
caa68458: posts small blind $0.1
6736194e: posts big blind $0.25
*** HOLE CARDS ***
Dealt to 3c96062f 
Dealt to caa68458 
Dealt to 6736194e 
Dealt to 5ffa3a03 
Dealt to 2d45ce80 
Dealt to Hero [Kd Qd]
5ffa3a03: raises $0.5 to $0.75
2d45ce80: folds
Hero: calls $0.75
3c96062f: calls $0.75
caa68458: folds
6736194e: folds
*** FLOP *** [3c Td 4c]
5ffa3a03: bets $0.75
Hero: calls $0.75
3c96062f: calls $0.75
*** TURN *** [3c Td 4c] [Jc]
5ffa3a03: checks
Hero: checks
3c96062f: checks
*** RIVER *** [3c Td 4c Jc] [Ah]
5ffa3a03: checks
Hero: bets $3.7
3c96062f: folds
5ffa3a03: folds
Uncalled bet ($3.7) returned to Hero
*** SHOWDOWN ***
Hero collected $4.85 from pot
*** SUMMARY ***
Total pot $4.85
Board [3c Td 4c Jc Ah]
Seat 1: 3c96062f (button) folded on the River
Seat 2: caa68458 (small blind) folded before Flop
Seat 3: 6736194e (big blind) folded before Flop
Seat 4: 5ffa3a03 folded on the River
Seat 5: 2d45ce80 folded before Flop (didn't bet)
Seat 6: Hero won ($4.85)


Poker Hand #RC95093556: Hold'em No Limit ($0.1/$0.25) - 2020/04/07 15:34:52
Table 'RushAndCash365137' 6-max Seat #1 is the button
Seat 1: 4dd920ba ($39.35 in chips)
Seat 2: Hero ($29.01 in chips)
Seat 3: 51c60a1c ($6.66 in chips)
Seat 4: 3c96062f ($13.63 in chips)
Seat 5: e131407f ($30.36 in chips)
Seat 6: 2dd038c3 ($11.92 in chips)
Hero: posts small blind $0.1
51c60a1c: posts big blind $0.25
*** HOLE CARDS ***
Dealt to 4dd920ba 
Dealt to Hero [Kh 5d]
Dealt to 51c60a1c 
Dealt to 3c96062f 
Dealt to e131407f 
Dealt to 2dd038c3 
3c96062f: folds
e131407f: folds
2dd038c3: folds
4dd920ba: folds
Hero: folds
Uncalled bet ($0.15) returned to 51c60a1c
*** SHOWDOWN ***
51c60a1c collected $0.2 from pot
*** SUMMARY ***
Total pot $0.2
Seat 1: 4dd920ba (button) folded before Flop (didn't bet)
Seat 2: Hero (small blind) folded before Flop
Seat 3: 51c60a1c (big blind) collected ($0.2)
Seat 4: 3c96062f folded before Flop (didn't bet)
Seat 5: e131407f folded before Flop (didn't bet)
Seat 6: 2dd038c3 folded before Flop (didn't bet)


Poker Hand #RC95093579: Hold'em No Limit ($0.1/$0.25) - 2020/04/07 15:34:56
Table 'RushAndCash365140' 6-max Seat #1 is the button
Seat 1: 51c60a1c ($6.41 in chips)
Seat 2: 103129d8 ($28.09 in chips)
Seat 3: Hero ($28.91 in chips)
Seat 4: d9a04cfb ($25.7 in chips)
Seat 5: 61ad32d ($18.74 in chips)
Seat 6: 49b3e425 ($26.32 in chips)
103129d8: posts small blind $0.1
Hero: posts big blind $0.25
*** HOLE CARDS ***
Dealt to 51c60a1c 
Dealt to 103129d8 
Dealt to Hero [Ks 9d]
Dealt to d9a04cfb 
Dealt to 61ad32d 
Dealt to 49b3e425 
d9a04cfb: raises $0.38 to $0.63
61ad32d: folds
49b3e425: folds
51c60a1c: folds
103129d8: folds
Hero: folds
Uncalled bet ($0.38) returned to d9a04cfb
*** SHOWDOWN ***
d9a04cfb collected $0.6 from pot
*** SUMMARY ***
Total pot $0.6
Seat 1: 51c60a1c (button) folded before Flop (didn't bet)
Seat 2: 103129d8 (small blind) folded before Flop
Seat 3: Hero (big blind) folded before Flop
Seat 4: d9a04cfb collected ($0.6)
Seat 5: 61ad32d folded before Flop (didn't bet)
Seat 6: 49b3e425 folded before Flop (didn't bet)


Poker Hand #RC95093608: Hold'em No Limit ($0.1/$0.25) - 2020/04/07 15:35:00
Table 'RushAndCash365144' 6-max Seat #1 is the button
Seat 1: 61ad32d ($18.74 in chips)
Seat 2: 74937d40 ($25.67 in chips)
Seat 3: f6150235 ($20 in chips)
Seat 4: 51c60a1c ($6.41 in chips)
Seat 5: Hero ($28.66 in chips)
Seat 6: 40a91d41 ($26.37 in chips)
74937d40: posts small blind $0.1
f6150235: posts big blind $0.25
*** HOLE CARDS ***
Dealt to 61ad32d 
Dealt to 74937d40 
Dealt to f6150235 
Dealt to 51c60a1c 
Dealt to Hero [9d 6s]
Dealt to 40a91d41 
51c60a1c: folds
Hero: folds
40a91d41: folds
61ad32d: raises $0.5 to $0.75
74937d40: folds
f6150235: calls $0.5
*** FLOP *** [Js 9c 3s]
f6150235: checks
61ad32d: bets $0.6
f6150235: calls $0.6
*** TURN *** [Js 9c 3s] [4c]
f6150235: checks
61ad32d: checks
*** RIVER *** [Js 9c 3s 4c] [Jd]
f6150235: bets $2.1
61ad32d: calls $2.1
f6150235: shows [Qs 7s] (Pair of Jacks)
61ad32d: shows [Th 9h] (Pair of Jacks and Pair of Nines)
*** SHOWDOWN ***
61ad32d collected $7 from pot
*** SUMMARY ***
Total pot $7
Board [Js 9c 3s 4c Jd]
Seat 1: 61ad32d (button) showed [Th 9h] and won ($7) with Pair of Jacks and Pair of Nines
Seat 2: 74937d40 (small blind) folded before Flop
Seat 3: f6150235 (big blind) showed [Qs 7s] and lost with Pair of Jacks
Seat 4: 51c60a1c folded before Flop (didn't bet)
Seat 5: Hero folded before Flop (didn't bet)
Seat 6: 40a91d41 folded before Flop (didn't bet)


Poker Hand #RC95093686: Hold'em No Limit ($0.1/$0.25) - 2020/04/07 15:35:10
Table 'RushAndCash365155' 6-max Seat #1 is the button
Seat 1: 52ee6b3d ($29.53 in chips)
Seat 2: Hero ($28.66 in chips)
Seat 3: bb849ffc ($10.34 in chips)
Seat 4: bf64de7f ($8.46 in chips)
Seat 5: cc092a76 ($8.54 in chips)
Seat 6: 3d05956 ($22.09 in chips)
Hero: posts small blind $0.1
bb849ffc: posts big blind $0.25
*** HOLE CARDS ***
Dealt to 52ee6b3d 
Dealt to Hero [Ts 5d]
Dealt to bb849ffc 
Dealt to bf64de7f 
Dealt to cc092a76 
Dealt to 3d05956 
bf64de7f: folds
cc092a76: folds
3d05956: folds
52ee6b3d: folds
Hero: folds
Uncalled bet ($0.15) returned to bb849ffc
*** SHOWDOWN ***
bb849ffc collected $0.2 from pot
*** SUMMARY ***
Total pot $0.2
Seat 1: 52ee6b3d (button) folded before Flop (didn't bet)
Seat 2: Hero (small blind) folded before Flop
Seat 3: bb849ffc (big blind) collected ($0.2)
Seat 4: bf64de7f folded before Flop (didn't bet)
Seat 5: cc092a76 folded before Flop (didn't bet)
Seat 6: 3d05956 folded before Flop (didn't bet)


Poker Hand #RC95093709: Hold'em No Limit ($0.1/$0.25) - 2020/04/07 15:35:13
Table 'RushAndCash365158' 6-max Seat #1 is the button
Seat 1: ab29e296 ($24.45 in chips)
Seat 2: 5ffa3a03 ($11.98 in chips)
Seat 3: 3d395129 ($24.15 in chips)
Seat 4: Hero ($28.56 in chips)
Seat 5: 289f2e46 ($24.37 in chips)
Seat 6: 17388104 ($16.34 in chips)
5ffa3a03: posts small blind $0.1
3d395129: posts big blind $0.25
*** HOLE CARDS ***
Dealt to ab29e296 
Dealt to 5ffa3a03 
Dealt to 3d395129 
Dealt to Hero [As Ac]
Dealt to 289f2e46 
Dealt to 17388104 
Hero: raises $0.38 to $0.63
289f2e46: folds
17388104: folds
ab29e296: folds
5ffa3a03: calls $0.53
3d395129: folds
*** FLOP *** [7c 3d 2d]
5ffa3a03: checks
Hero: bets $0.85
5ffa3a03: calls $0.85
*** TURN *** [7c 3d 2d] [Jd]
5ffa3a03: checks
Hero: bets $2.5
5ffa3a03: folds
Uncalled bet ($2.5) returned to Hero
*** SHOWDOWN ***
Hero collected $3.21 from pot
*** SUMMARY ***
Total pot $3.21
Board [7c 3d 2d Jd]
Seat 1: ab29e296 (button) folded before Flop (didn't bet)
Seat 2: 5ffa3a03 (small blind) folded on the Turn
Seat 3: 3d395129 (big blind) folded before Flop
Seat 4: Hero won ($3.21)
Seat 5: 289f2e46 folded before Flop (didn't bet)
Seat 6: 17388104 folded before Flop (didn't bet)


Poker Hand #RC95094050: Hold'em No Limit ($0.1/$0.25) - 2020/04/07 15:35:59
Table 'RushAndCash365200' 6-max Seat #1 is the button
Seat 1: 5ffa3a03 ($10.5 in chips)
Seat 2: 89387862 ($28.04 in chips)
Seat 3: d437c92d ($62.47 in chips)
Seat 4: Hero ($30.13 in chips)
Seat 5: ecd599c ($8.15 in chips)
Seat 6: acf1a889 ($18.42 in chips)
89387862: posts small blind $0.1
d437c92d: posts big blind $0.25
*** HOLE CARDS ***
Dealt to 5ffa3a03 
Dealt to 89387862 
Dealt to d437c92d 
Dealt to Hero [6s 5d]
Dealt to ecd599c 
Dealt to acf1a889 
Hero: folds
ecd599c: folds
acf1a889: folds
5ffa3a03: folds
89387862: folds
Uncalled bet ($0.15) returned to d437c92d
*** SHOWDOWN ***
d437c92d collected $0.2 from pot
*** SUMMARY ***
Total pot $0.2
Seat 1: 5ffa3a03 (button) folded before Flop (didn't bet)
Seat 2: 89387862 (small blind) folded before Flop
Seat 3: d437c92d (big blind) collected ($0.2)
Seat 4: Hero folded before Flop (didn't bet)
Seat 5: ecd599c folded before Flop (didn't bet)
Seat 6: acf1a889 folded before Flop (didn't bet)


Poker Hand #RC95094076: Hold'em No Limit ($0.1/$0.25) - 2020/04/07 15:36:03
Table 'RushAndCash365203' 6-max Seat #1 is the button
Seat 1: Hero ($30.13 in chips)
Seat 2: d3373005 ($12.53 in chips)
Seat 3: ecd599c ($8.15 in chips)
Seat 4: 49b3e425 ($24.92 in chips)
Seat 5: 37ae2dd7 ($27.01 in chips)
Seat 6: 57ff778 ($26.95 in chips)
d3373005: posts small blind $0.1
ecd599c: posts big blind $0.25
*** HOLE CARDS ***
Dealt to Hero [Th 4d]
Dealt to d3373005 
Dealt to ecd599c 
Dealt to 49b3e425 
Dealt to 37ae2dd7 
Dealt to 57ff778 
49b3e425: folds
37ae2dd7: folds
57ff778: raises $0.25 to $0.5
Hero: folds
d3373005: folds
ecd599c: folds
Uncalled bet ($0.25) returned to 57ff778
*** SHOWDOWN ***
57ff778 collected $0.6 from pot
*** SUMMARY ***
Total pot $0.6
Seat 1: Hero (button) folded before Flop (didn't bet)
Seat 2: d3373005 (small blind) folded before Flop
Seat 3: ecd599c (big blind) folded before Flop
Seat 4: 49b3e425 folded before Flop (didn't bet)
Seat 5: 37ae2dd7 folded before Flop (didn't bet)
Seat 6: 57ff778 collected ($0.6)


Poker Hand #RC95094105: Hold'em No Limit ($0.1/$0.25) - 2020/04/07 15:36:06
Table 'RushAndCash365207' 6-max Seat #1 is the button
Seat 1: e131407f ($30.69 in chips)
Seat 2: af84e661 ($5.94 in chips)
Seat 3: 704a7fcf ($30.23 in chips)
Seat 4: Hero ($30.13 in chips)
Seat 5: f6150235 ($16.45 in chips)
Seat 6: 98ddea23 ($13.82 in chips)
af84e661: posts small blind $0.1
704a7fcf: posts big blind $0.25
*** HOLE CARDS ***
Dealt to e131407f 
Dealt to af84e661 
Dealt to 704a7fcf 
Dealt to Hero [Qh 3h]
Dealt to f6150235 
Dealt to 98ddea23 
Hero: folds
f6150235: folds
98ddea23: folds
e131407f: raises $0.25 to $0.5
af84e661: folds
704a7fcf: calls $0.25
*** FLOP *** [5h Kc 3c]
704a7fcf: checks
e131407f: bets $0.4
704a7fcf: folds
Uncalled bet ($0.4) returned to e131407f
*** SHOWDOWN ***
e131407f collected $1.1 from pot
*** SUMMARY ***
Total pot $1.1
Board [5h Kc 3c]
Seat 1: e131407f (button) won ($1.1)
Seat 2: af84e661 (small blind) folded before Flop
Seat 3: 704a7fcf (big blind) folded on the Flop
Seat 4: Hero folded before Flop (didn't bet)
Seat 5: f6150235 folded before Flop (didn't bet)
Seat 6: 98ddea23 folded before Flop (didn't bet)


Poker Hand #RC95094139: Hold'em No Limit ($0.1/$0.25) - 2020/04/07 15:36:11
Table 'RushAndCash365212' 6-max Seat #1 is the button
Seat 1: 9f138297 ($32.27 in chips)
Seat 2: d437c92d ($62.57 in chips)
Seat 3: Hero ($30.13 in chips)
Seat 4: 3c96062f ($10.23 in chips)
Seat 5: 8004b155 ($12.29 in chips)
Seat 6: 966446c2 ($29.53 in chips)
d437c92d: posts small blind $0.1
Hero: posts big blind $0.25
*** HOLE CARDS ***
Dealt to 9f138297 
Dealt to d437c92d 
Dealt to Hero [3h 2s]
Dealt to 3c96062f 
Dealt to 8004b155 
Dealt to 966446c2 
3c96062f: folds
8004b155: folds
966446c2: raises $0.5 to $0.75
9f138297: calls $0.75
d437c92d: folds
Hero: folds
*** FLOP *** [Qd 9c Qc]
966446c2: bets $1
9f138297: folds
Uncalled bet ($1) returned to 966446c2
*** SHOWDOWN ***
966446c2 collected $1.85 from pot
*** SUMMARY ***
Total pot $1.85
Board [Qd 9c Qc]
Seat 1: 9f138297 (button) folded on the Flop
Seat 2: d437c92d (small blind) folded before Flop
Seat 3: Hero (big blind) folded before Flop
Seat 4: 3c96062f folded before Flop (didn't bet)
Seat 5: 8004b155 folded before Flop (didn't bet)
Seat 6: 966446c2 won ($1.85)


Poker Hand #RC95094175: Hold'em No Limit ($0.1/$0.25) - 2020/04/07 15:36:16
Table 'RushAndCash365216' 6-max Seat #1 is the button
Seat 1: ce59b684 ($38.29 in chips)
Seat 2: 6f1c538f ($12.5 in chips)
Seat 3: fc8a29ea ($68.05 in chips)
Seat 4: 40a91d41 ($26.22 in chips)
Seat 5: 3c96062f ($10.23 in chips)
Seat 6: Hero ($29.88 in chips)
6f1c538f: posts small blind $0.1
fc8a29ea: posts big blind $0.25
*** HOLE CARDS ***
Dealt to ce59b684 
Dealt to 6f1c538f 
Dealt to fc8a29ea 
Dealt to 40a91d41 
Dealt to 3c96062f 
Dealt to Hero [8s 6d]
40a91d41: folds
3c96062f: folds
Hero: folds
ce59b684: folds
6f1c538f: raises $0.38 to $0.63
fc8a29ea: calls $0.38
*** FLOP *** [7s 9s 4h]
6f1c538f: bets $0.5
fc8a29ea: folds
Uncalled bet ($0.5) returned to 6f1c538f
*** SHOWDOWN ***
6f1c538f collected $1.26 from pot
*** SUMMARY ***
Total pot $1.26
Board [7s 9s 4h]
Seat 1: ce59b684 (button) folded before Flop (didn't bet)
Seat 2: 6f1c538f (small blind) won ($1.26)
Seat 3: fc8a29ea (big blind) folded on the Flop
Seat 4: 40a91d41 folded before Flop (didn't bet)
Seat 5: 3c96062f folded before Flop (didn't bet)
Seat 6: Hero folded before Flop (didn't bet)


Poker Hand #RC95094298: Hold'em No Limit ($0.1/$0.25) - 2020/04/07 15:36:32
Table 'RushAndCash365233' 6-max Seat #1 is the button
Seat 1: 8c86f461 ($25 in chips)
Seat 2: Hero ($29.88 in chips)
Seat 3: a4ba858f ($32.48 in chips)
Seat 4: 889e7e90 ($24.07 in chips)
Seat 5: f178c62c ($12.5 in chips)
Seat 6: 37ae2dd7 ($27.01 in chips)
Hero: posts small blind $0.1
a4ba858f: posts big blind $0.25
*** HOLE CARDS ***
Dealt to 8c86f461 
Dealt to Hero [Ts 4h]
Dealt to a4ba858f 
Dealt to 889e7e90 
Dealt to f178c62c 
Dealt to 37ae2dd7 
889e7e90: folds
f178c62c: folds
37ae2dd7: folds
8c86f461: folds
Hero: folds
Uncalled bet ($0.15) returned to a4ba858f
*** SHOWDOWN ***
a4ba858f collected $0.2 from pot
*** SUMMARY ***
Total pot $0.2
Seat 1: 8c86f461 (button) folded before Flop (didn't bet)
Seat 2: Hero (small blind) folded before Flop
Seat 3: a4ba858f (big blind) collected ($0.2)
Seat 4: 889e7e90 folded before Flop (didn't bet)
Seat 5: f178c62c folded before Flop (didn't bet)
Seat 6: 37ae2dd7 folded before Flop (didn't bet)


Poker Hand #RC95094357: Hold'em No Limit ($0.1/$0.25) - 2020/04/07 15:36:41
Table 'RushAndCash365243' 6-max Seat #1 is the button
Seat 1: Hero ($29.78 in chips)
Seat 2: fe3f48f4 ($25.7 in chips)
Seat 3: ab29e296 ($23.65 in chips)
Seat 4: af84e661 ($6.19 in chips)
Seat 5: f178c62c ($12.5 in chips)
Seat 6: 4ab4e4a3 ($25 in chips)
fe3f48f4: posts small blind $0.1
ab29e296: posts big blind $0.25
*** HOLE CARDS ***
Dealt to Hero [7c 2c]
Dealt to fe3f48f4 
Dealt to ab29e296 
Dealt to af84e661 
Dealt to f178c62c 
Dealt to 4ab4e4a3 
af84e661: folds
f178c62c: folds
4ab4e4a3: folds
Hero: folds
fe3f48f4: folds
Uncalled bet ($0.15) returned to ab29e296
*** SHOWDOWN ***
ab29e296 collected $0.2 from pot
*** SUMMARY ***
Total pot $0.2
Seat 1: Hero (button) folded before Flop (didn't bet)
Seat 2: fe3f48f4 (small blind) folded before Flop
Seat 3: ab29e296 (big blind) collected ($0.2)
Seat 4: af84e661 folded before Flop (didn't bet)
Seat 5: f178c62c folded before Flop (didn't bet)
Seat 6: 4ab4e4a3 folded before Flop (didn't bet)


Poker Hand #RC95094383: Hold'em No Limit ($0.1/$0.25) - 2020/04/07 15:36:44
Table 'RushAndCash365247' 6-max Seat #1 is the button
Seat 1: 45920dbc ($48.38 in chips)
Seat 2: d2986703 ($42.66 in chips)
Seat 3: 4c91cf91 ($8.37 in chips)
Seat 4: Hero ($29.78 in chips)
Seat 5: a0d04110 ($66.36 in chips)
Seat 6: 492c0086 ($11.65 in chips)
d2986703: posts small blind $0.1
4c91cf91: posts big blind $0.25
*** HOLE CARDS ***
Dealt to 45920dbc 
Dealt to d2986703 
Dealt to 4c91cf91 
Dealt to Hero [Ac Ts]
Dealt to a0d04110 
Dealt to 492c0086 
Hero: folds
a0d04110: folds
492c0086: folds
45920dbc: raises $0.38 to $0.63
d2986703: folds
4c91cf91: folds
Uncalled bet ($0.38) returned to 45920dbc
*** SHOWDOWN ***
45920dbc collected $0.6 from pot
*** SUMMARY ***
Total pot $0.6
Seat 1: 45920dbc (button) collected ($0.6)
Seat 2: d2986703 (small blind) folded before Flop
Seat 3: 4c91cf91 (big blind) folded before Flop
Seat 4: Hero folded before Flop (didn't bet)
Seat 5: a0d04110 folded before Flop (didn't bet)
Seat 6: 492c0086 folded before Flop (didn't bet)


Poker Hand #RC95094418: Hold'em No Limit ($0.1/$0.25) - 2020/04/07 15:36:49
Table 'RushAndCash365252' 6-max Seat #1 is the button
Seat 1: d6f2a39c ($5.28 in chips)
Seat 2: 61ad32d ($21.59 in chips)
Seat 3: Hero ($29.78 in chips)
Seat 4: decd88e2 ($26.24 in chips)
Seat 5: 89387862 ($27.69 in chips)
Seat 6: ab29e296 ($23.4 in chips)
61ad32d: posts small blind $0.1
Hero: posts big blind $0.25
*** HOLE CARDS ***
Dealt to d6f2a39c 
Dealt to 61ad32d 
Dealt to Hero [Ac 8h]
Dealt to decd88e2 
Dealt to 89387862 
Dealt to ab29e296 
decd88e2: folds
89387862: folds
ab29e296: folds
d6f2a39c: folds
61ad32d: raises $0.5 to $0.75
Hero: calls $0.5
*** FLOP *** [Kd 8d Kh]
61ad32d: bets $0.5
Hero: raises $1.17 to $1.67
61ad32d: folds
Uncalled bet ($1.17) returned to Hero
*** SHOWDOWN ***
Hero collected $2.5 from pot
*** SUMMARY ***
Total pot $2.5
Board [Kd 8d Kh]
Seat 1: d6f2a39c (button) folded before Flop (didn't bet)
Seat 2: 61ad32d (small blind) folded on the Flop
Seat 3: Hero (big blind) won ($2.5)
Seat 4: decd88e2 folded before Flop (didn't bet)
Seat 5: 89387862 folded before Flop (didn't bet)
Seat 6: ab29e296 folded before Flop (didn't bet)


Poker Hand #RC95094629: Hold'em No Limit ($0.1/$0.25) - 2020/04/07 15:37:18
Table 'RushAndCash365282' 6-max Seat #1 is the button
Seat 1: 61ad32d ($20.34 in chips)
Seat 2: 966446c2 ($30.29 in chips)
Seat 3: 51c60a1c ($8.47 in chips)
Seat 4: dbf6981f ($64.63 in chips)
Seat 5: Hero ($30.91 in chips)
Seat 6: 9f138297 ($31.42 in chips)
966446c2: posts small blind $0.1
51c60a1c: posts big blind $0.25
*** HOLE CARDS ***
Dealt to 61ad32d 
Dealt to 966446c2 
Dealt to 51c60a1c 
Dealt to dbf6981f 
Dealt to Hero [7h 3c]
Dealt to 9f138297 
dbf6981f: folds
Hero: folds
9f138297: folds
61ad32d: folds
966446c2: calls $0.15
51c60a1c: checks
*** FLOP *** [4s Qc 6h]
966446c2: bets $0.3
51c60a1c: folds
Uncalled bet ($0.3) returned to 966446c2
*** SHOWDOWN ***
966446c2 collected $0.5 from pot
*** SUMMARY ***
Total pot $0.5
Board [4s Qc 6h]
Seat 1: 61ad32d (button) folded before Flop (didn't bet)
Seat 2: 966446c2 (small blind) won ($0.5)
Seat 3: 51c60a1c (big blind) folded on the Flop
Seat 4: dbf6981f folded before Flop (didn't bet)
Seat 5: Hero folded before Flop (didn't bet)
Seat 6: 9f138297 folded before Flop (didn't bet)


Poker Hand #RC95094665: Hold'em No Limit ($0.1/$0.25) - 2020/04/07 15:37:23
Table 'RushAndCash365287' 6-max Seat #1 is the button
Seat 1: 7ed3ab6b ($68.12 in chips)
Seat 2: 51c60a1c ($8.22 in chips)
Seat 3: 61ad32d ($20.34 in chips)
Seat 4: Hero ($30.91 in chips)
Seat 5: fe3f48f4 ($25.35 in chips)
Seat 6: 98ddea23 ($13.79 in chips)
51c60a1c: posts small blind $0.1
61ad32d: posts big blind $0.25
*** HOLE CARDS ***
Dealt to 7ed3ab6b 
Dealt to 51c60a1c 
Dealt to 61ad32d 
Dealt to Hero [Ac 4s]
Dealt to fe3f48f4 
Dealt to 98ddea23 
Hero: folds
fe3f48f4: raises $0.38 to $0.63
98ddea23: folds
7ed3ab6b: folds
51c60a1c: folds
61ad32d: folds
Uncalled bet ($0.38) returned to fe3f48f4
*** SHOWDOWN ***
fe3f48f4 collected $0.6 from pot
*** SUMMARY ***
Total pot $0.6
Seat 1: 7ed3ab6b (button) folded before Flop (didn't bet)
Seat 2: 51c60a1c (small blind) folded before Flop
Seat 3: 61ad32d (big blind) folded before Flop
Seat 4: Hero folded before Flop (didn't bet)
Seat 5: fe3f48f4 collected ($0.6)
Seat 6: 98ddea23 folded before Flop (didn't bet)


Poker Hand #RC95094694: Hold'em No Limit ($0.1/$0.25) - 2020/04/07 15:37:27
Table 'RushAndCash365291' 6-max Seat #1 is the button
Seat 1: 366c47e0 ($8.87 in chips)
Seat 2: 7ed3ab6b ($68.12 in chips)
Seat 3: 4ab4e4a3 ($25.25 in chips)
Seat 4: 51c60a1c ($8.12 in chips)
Seat 5: Hero ($30.91 in chips)
Seat 6: d2986703 ($42.21 in chips)
7ed3ab6b: posts small blind $0.1
4ab4e4a3: posts big blind $0.25
*** HOLE CARDS ***
Dealt to 366c47e0 
Dealt to 7ed3ab6b 
Dealt to 4ab4e4a3 
Dealt to 51c60a1c 
Dealt to Hero [Js 4c]
Dealt to d2986703 
51c60a1c: folds
Hero: folds
d2986703: folds
366c47e0: folds
7ed3ab6b: raises $0.5 to $0.75
4ab4e4a3: folds
Uncalled bet ($0.5) returned to 7ed3ab6b
*** SHOWDOWN ***
7ed3ab6b collected $0.5 from pot
*** SUMMARY ***
Total pot $0.5
Seat 1: 366c47e0 (button) folded before Flop (didn't bet)
Seat 2: 7ed3ab6b (small blind) collected ($0.5)
Seat 3: 4ab4e4a3 (big blind) folded before Flop
Seat 4: 51c60a1c folded before Flop (didn't bet)
Seat 5: Hero folded before Flop (didn't bet)
Seat 6: d2986703 folded before Flop (didn't bet)


Poker Hand #RC95094715: Hold'em No Limit ($0.1/$0.25) - 2020/04/07 15:37:30
Table 'RushAndCash365294' 6-max Seat #1 is the button
Seat 1: 89387862 ($27.34 in chips)
Seat 2: Hero ($30.91 in chips)
Seat 3: d437c92d ($60.77 in chips)
Seat 4: 8004b155 ($11.84 in chips)
Seat 5: dbf6981f ($64.63 in chips)
Seat 6: d6f2a39c ($4.93 in chips)
Hero: posts small blind $0.1
d437c92d: posts big blind $0.25
*** HOLE CARDS ***
Dealt to 89387862 
Dealt to Hero [Ac 6d]
Dealt to d437c92d 
Dealt to 8004b155 
Dealt to dbf6981f 
Dealt to d6f2a39c 
8004b155: folds
dbf6981f: folds
d6f2a39c: folds
89387862: folds
Hero: folds
Uncalled bet ($0.15) returned to d437c92d
*** SHOWDOWN ***
d437c92d collected $0.2 from pot
*** SUMMARY ***
Total pot $0.2
Seat 1: 89387862 (button) folded before Flop (didn't bet)
Seat 2: Hero (small blind) folded before Flop
Seat 3: d437c92d (big blind) collected ($0.2)
Seat 4: 8004b155 folded before Flop (didn't bet)
Seat 5: dbf6981f folded before Flop (didn't bet)
Seat 6: d6f2a39c folded before Flop (didn't bet)


Poker Hand #RC95094746: Hold'em No Limit ($0.1/$0.25) - 2020/04/07 15:37:34
Table 'RushAndCash365297' 6-max Seat #1 is the button
Seat 1: bb849ffc ($12 in chips)
Seat 2: dbf6981f ($64.63 in chips)
Seat 3: Hero ($30.81 in chips)
Seat 4: 57ff778 ($27.3 in chips)
Seat 5: d9a04cfb ($28.5 in chips)
Seat 6: 181b6319 ($13.2 in chips)
dbf6981f: posts small blind $0.1
Hero: posts big blind $0.25
*** HOLE CARDS ***
Dealt to bb849ffc 
Dealt to dbf6981f 
Dealt to Hero [9d 6c]
Dealt to 57ff778 
Dealt to d9a04cfb 
Dealt to 181b6319 
57ff778: raises $0.25 to $0.5
d9a04cfb: folds
181b6319: folds
bb849ffc: folds
dbf6981f: folds
Hero: folds
Uncalled bet ($0.25) returned to 57ff778
*** SHOWDOWN ***
57ff778 collected $0.6 from pot
*** SUMMARY ***
Total pot $0.6
Seat 1: bb849ffc (button) folded before Flop (didn't bet)
Seat 2: dbf6981f (small blind) folded before Flop
Seat 3: Hero (big blind) folded before Flop
Seat 4: 57ff778 collected ($0.6)
Seat 5: d9a04cfb folded before Flop (didn't bet)
Seat 6: 181b6319 folded before Flop (didn't bet)


Poker Hand #RC95094789: Hold'em No Limit ($0.1/$0.25) - 2020/04/07 15:37:40
Table 'RushAndCash365301' 6-max Seat #1 is the button
Seat 1: 51c60a1c ($8.12 in chips)
Seat 2: fc8a29ea ($67.32 in chips)
Seat 3: 45920dbc ($48.28 in chips)
Seat 4: 275e7f74 ($25 in chips)
Seat 5: 3423a84d ($29.41 in chips)
Seat 6: Hero ($30.56 in chips)
fc8a29ea: posts small blind $0.1
45920dbc: posts big blind $0.25
*** HOLE CARDS ***
Dealt to 51c60a1c 
Dealt to fc8a29ea 
Dealt to 45920dbc 
Dealt to 275e7f74 
Dealt to 3423a84d 
Dealt to Hero [9d 4s]
275e7f74: raises $0.38 to $0.63
3423a84d: folds
Hero: folds
51c60a1c: folds
fc8a29ea: raises $1.77 to $2.4
45920dbc: folds
275e7f74: calls $1.77
*** FLOP *** [6h 8c As]
fc8a29ea: bets $1.7
275e7f74: calls $1.7
*** TURN *** [6h 8c As] [Qc]
fc8a29ea: checks
275e7f74: bets $2.8
fc8a29ea: raises $3.1 to $5.9
275e7f74: raises $15 to $20.9 and is all-in
fc8a29ea: folds
Uncalled bet ($15) returned to 275e7f74
*** SHOWDOWN ***
275e7f74 collected $20.25 from pot
*** SUMMARY ***
Total pot $20.25
Board [6h 8c As Qc]
Seat 1: 51c60a1c (button) folded before Flop (didn't bet)
Seat 2: fc8a29ea (small blind) folded on the Turn
Seat 3: 45920dbc (big blind) folded before Flop
Seat 4: 275e7f74 won ($20.25)
Seat 5: 3423a84d folded before Flop (didn't bet)
Seat 6: Hero folded before Flop (didn't bet)


Poker Hand #RC95094818: Hold'em No Limit ($0.1/$0.25) - 2020/04/07 15:37:44
Table 'RushAndCash365305' 6-max Seat #1 is the button
Seat 1: Hero ($30.56 in chips)
Seat 2: 17388104 ($25.53 in chips)
Seat 3: 88709749 ($18.21 in chips)
Seat 4: 966446c2 ($30.52 in chips)
Seat 5: d6f2a39c ($4.93 in chips)
Seat 6: a4ba858f ($34.75 in chips)
17388104: posts small blind $0.1
88709749: posts big blind $0.25
*** HOLE CARDS ***
Dealt to Hero [Qd 4h]
Dealt to 17388104 
Dealt to 88709749 
Dealt to 966446c2 
Dealt to d6f2a39c 
Dealt to a4ba858f 
966446c2: folds
d6f2a39c: folds
a4ba858f: folds
Hero: folds
17388104: folds
Uncalled bet ($0.15) returned to 88709749
*** SHOWDOWN ***
88709749 collected $0.2 from pot
*** SUMMARY ***
Total pot $0.2
Seat 1: Hero (button) folded before Flop (didn't bet)
Seat 2: 17388104 (small blind) folded before Flop
Seat 3: 88709749 (big blind) collected ($0.2)
Seat 4: 966446c2 folded before Flop (didn't bet)
Seat 5: d6f2a39c folded before Flop (didn't bet)
Seat 6: a4ba858f folded before Flop (didn't bet)


Poker Hand #RC95094878: Hold'em No Limit ($0.1/$0.25) - 2020/04/07 15:37:53
Table 'RushAndCash365314' 6-max Seat #1 is the button
Seat 1: acf1a889 ($18.37 in chips)
Seat 2: b5d592d2 ($13.54 in chips)
Seat 3: bbb85b3f ($26.91 in chips)
Seat 4: Hero ($30.56 in chips)
Seat 5: bda1b4ce ($25 in chips)
Seat 6: 5004602b ($20.11 in chips)
b5d592d2: posts small blind $0.1
bbb85b3f: posts big blind $0.25
*** HOLE CARDS ***
Dealt to acf1a889 
Dealt to b5d592d2 
Dealt to bbb85b3f 
Dealt to Hero [Kc 9c]
Dealt to bda1b4ce 
Dealt to 5004602b 
Hero: raises $0.38 to $0.63
bda1b4ce: folds
5004602b: folds
acf1a889: folds
b5d592d2: folds
bbb85b3f: folds
Uncalled bet ($0.38) returned to Hero
*** SHOWDOWN ***
Hero collected $0.6 from pot
*** SUMMARY ***
Total pot $0.6
Seat 1: acf1a889 (button) folded before Flop (didn't bet)
Seat 2: b5d592d2 (small blind) folded before Flop
Seat 3: bbb85b3f (big blind) folded before Flop
Seat 4: Hero collected ($0.6)
Seat 5: bda1b4ce folded before Flop (didn't bet)
Seat 6: 5004602b folded before Flop (didn't bet)


Poker Hand #RC95095102: Hold'em No Limit ($0.1/$0.25) - 2020/04/07 15:38:21
Table 'RushAndCash365344' 6-max Seat #1 is the button
Seat 1: 8b8d197c ($33.94 in chips)
Seat 2: Hero ($30.91 in chips)
Seat 3: 5794e88f ($44.71 in chips)
Seat 4: 3cfd7308 ($47.83 in chips)
Seat 5: 811232a3 ($24.65 in chips)
Seat 6: 4c91cf91 ($7.84 in chips)
Hero: posts small blind $0.1
5794e88f: posts big blind $0.25
*** HOLE CARDS ***
Dealt to 8b8d197c 
Dealt to Hero [Ac 9d]
Dealt to 5794e88f 
Dealt to 3cfd7308 
Dealt to 811232a3 
Dealt to 4c91cf91 
3cfd7308: folds
811232a3: folds
4c91cf91: folds
8b8d197c: folds
Hero: raises $0.5 to $0.75
5794e88f: calls $0.5
*** FLOP *** [2h 7s 4h]
Hero: bets $0.5
5794e88f: folds
Uncalled bet ($0.5) returned to Hero
*** SHOWDOWN ***
Hero collected $1.5 from pot
*** SUMMARY ***
Total pot $1.5
Board [2h 7s 4h]
Seat 1: 8b8d197c (button) folded before Flop (didn't bet)
Seat 2: Hero (small blind) won ($1.5)
Seat 3: 5794e88f (big blind) folded on the Flop
Seat 4: 3cfd7308 folded before Flop (didn't bet)
Seat 5: 811232a3 folded before Flop (didn't bet)
Seat 6: 4c91cf91 folded before Flop (didn't bet)


Poker Hand #RC95095295: Hold'em No Limit ($0.1/$0.25) - 2020/04/07 15:38:45
Table 'RushAndCash365367' 6-max Seat #1 is the button
Seat 1: d2f55a32 ($12.66 in chips)
Seat 2: 65837850 ($127.41 in chips)
Seat 3: 6f1c538f ($25 in chips)
Seat 4: e131407f ($29.89 in chips)
Seat 5: Hero ($31.59 in chips)
Seat 6: 366c47e0 ($8.37 in chips)
65837850: posts small blind $0.1
6f1c538f: posts big blind $0.25
*** HOLE CARDS ***
Dealt to d2f55a32 
Dealt to 65837850 
Dealt to 6f1c538f 
Dealt to e131407f 
Dealt to Hero [Jc 2h]
Dealt to 366c47e0 
e131407f: folds
Hero: folds
366c47e0: folds
d2f55a32: folds
65837850: folds
Uncalled bet ($0.15) returned to 6f1c538f
*** SHOWDOWN ***
6f1c538f collected $0.2 from pot
*** SUMMARY ***
Total pot $0.2
Seat 1: d2f55a32 (button) folded before Flop (didn't bet)
Seat 2: 65837850 (small blind) folded before Flop
Seat 3: 6f1c538f (big blind) collected ($0.2)
Seat 4: e131407f folded before Flop (didn't bet)
Seat 5: Hero folded before Flop (didn't bet)
Seat 6: 366c47e0 folded before Flop (didn't bet)


Poker Hand #RC95095324: Hold'em No Limit ($0.1/$0.25) - 2020/04/07 15:38:49
Table 'RushAndCash365370' 6-max Seat #1 is the button
Seat 1: decd88e2 ($25.1 in chips)
Seat 2: f6150235 ($17.86 in chips)
Seat 3: 3fe95a27 ($12 in chips)
Seat 4: Hero ($31.59 in chips)
Seat 5: 32953d2a ($13.96 in chips)
Seat 6: 17388104 ($25.41 in chips)
f6150235: posts small blind $0.1
3fe95a27: posts big blind $0.25
*** HOLE CARDS ***
Dealt to decd88e2 
Dealt to f6150235 
Dealt to 3fe95a27 
Dealt to Hero [6s 2d]
Dealt to 32953d2a 
Dealt to 17388104 
Hero: folds
32953d2a: folds
17388104: calls $0.25
decd88e2: folds
f6150235: folds
3fe95a27: checks
*** FLOP *** [8d 3c As]
3fe95a27: checks
17388104: checks
*** TURN *** [8d 3c As] [7h]
3fe95a27: checks
17388104: bets $0.3
3fe95a27: folds
Uncalled bet ($0.3) returned to 17388104
*** SHOWDOWN ***
17388104 collected $0.6 from pot
*** SUMMARY ***
Total pot $0.6
Board [8d 3c As 7h]
Seat 1: decd88e2 (button) folded before Flop (didn't bet)
Seat 2: f6150235 (small blind) folded before Flop
Seat 3: 3fe95a27 (big blind) folded on the Turn
Seat 4: Hero folded before Flop (didn't bet)
Seat 5: 32953d2a folded before Flop (didn't bet)
Seat 6: 17388104 won ($0.6)


Poker Hand #RC95095349: Hold'em No Limit ($0.1/$0.25) - 2020/04/07 15:38:53
Table 'RushAndCash365373' 6-max Seat #1 is the button
Seat 1: 492c0086 ($11.3 in chips)
Seat 2: 889e7e90 ($11.99 in chips)
Seat 3: Hero ($31.59 in chips)
Seat 4: 57ff778 ($27.65 in chips)
Seat 5: ce59b684 ($32.84 in chips)
Seat 6: 8b8d197c ($33.94 in chips)
889e7e90: posts small blind $0.1
Hero: posts big blind $0.25
*** HOLE CARDS ***
Dealt to 492c0086 
Dealt to 889e7e90 
Dealt to Hero [Js 4s]
Dealt to 57ff778 
Dealt to ce59b684 
Dealt to 8b8d197c 
57ff778: folds
ce59b684: folds
8b8d197c: folds
492c0086: folds
889e7e90: folds
Uncalled bet ($0.15) returned to Hero
*** SHOWDOWN ***
Hero collected $0.2 from pot
*** SUMMARY ***
Total pot $0.2
Seat 1: 492c0086 (button) folded before Flop (didn't bet)
Seat 2: 889e7e90 (small blind) folded before Flop
Seat 3: Hero (big blind) collected ($0.2)
Seat 4: 57ff778 folded before Flop (didn't bet)
Seat 5: ce59b684 folded before Flop (didn't bet)
Seat 6: 8b8d197c folded before Flop (didn't bet)


Poker Hand #RC95095379: Hold'em No Limit ($0.1/$0.25) - 2020/04/07 15:38:57
Table 'RushAndCash365376' 6-max Seat #1 is the button
Seat 1: Hero ($31.34 in chips)
Seat 2: 88709749 ($8.03 in chips)
Seat 3: bf64de7f ($8.3 in chips)
Seat 4: d9a04cfb ($28.15 in chips)
Seat 5: 181b6319 ($24.65 in chips)
Seat 6: a4ba858f ($35.77 in chips)
88709749: posts small blind $0.1
bf64de7f: posts big blind $0.25
*** HOLE CARDS ***
Dealt to Hero [6d 2c]
Dealt to 88709749 
Dealt to bf64de7f 
Dealt to d9a04cfb 
Dealt to 181b6319 
Dealt to a4ba858f 
d9a04cfb: folds
181b6319: raises $0.38 to $0.63
a4ba858f: folds
Hero: folds
88709749: folds
bf64de7f: folds
Uncalled bet ($0.38) returned to 181b6319
*** SHOWDOWN ***
181b6319 collected $0.6 from pot
*** SUMMARY ***
Total pot $0.6
Seat 1: Hero (button) folded before Flop (didn't bet)
Seat 2: 88709749 (small blind) folded before Flop
Seat 3: bf64de7f (big blind) folded before Flop
Seat 4: d9a04cfb folded before Flop (didn't bet)
Seat 5: 181b6319 collected ($0.6)
Seat 6: a4ba858f folded before Flop (didn't bet)


Poker Hand #RC95095416: Hold'em No Limit ($0.1/$0.25) - 2020/04/07 15:39:02
Table 'RushAndCash365379' 6-max Seat #1 is the button
Seat 1: 52ee6b3d ($33 in chips)
Seat 2: 811232a3 ($25.2 in chips)
Seat 3: e131407f ($29.89 in chips)
Seat 4: Hero ($31.34 in chips)
Seat 5: ce59b684 ($32.84 in chips)
Seat 6: 8b8d197c ($33.94 in chips)
811232a3: posts small blind $0.1
e131407f: posts big blind $0.25
*** HOLE CARDS ***
Dealt to 52ee6b3d 
Dealt to 811232a3 
Dealt to e131407f 
Dealt to Hero [Kc Jh]
Dealt to ce59b684 
Dealt to 8b8d197c 
Hero: raises $0.38 to $0.63
ce59b684: folds
8b8d197c: calls $0.63
52ee6b3d: folds
811232a3: calls $0.53
e131407f: folds
*** FLOP *** [4s 9s 3s]
811232a3: checks
Hero: checks
8b8d197c: checks
*** TURN *** [4s 9s 3s] [Qs]
811232a3: checks
Hero: checks
8b8d197c: checks
*** RIVER *** [4s 9s 3s Qs] [9d]
811232a3: bets $2.2
Hero: folds
8b8d197c: folds
Uncalled bet ($2.2) returned to 811232a3
*** SHOWDOWN ***
811232a3 collected $2.14 from pot
*** SUMMARY ***
Total pot $2.14
Board [4s 9s 3s Qs 9d]
Seat 1: 52ee6b3d (button) folded before Flop (didn't bet)
Seat 2: 811232a3 (small blind) won ($2.14)
Seat 3: e131407f (big blind) folded before Flop
Seat 4: Hero folded on the River
Seat 5: ce59b684 folded before Flop (didn't bet)
Seat 6: 8b8d197c folded on the River


Poker Hand #RC95095803: Hold'em No Limit ($0.1/$0.25) - 2020/04/07 15:39:54
Table 'RushAndCash365424' 6-max Seat #1 is the button
Seat 1: d437c92d ($60.3 in chips)
Seat 2: 6736194e ($24.77 in chips)
Seat 3: 2c82afb5 ($12 in chips)
Seat 4: Hero ($31.06 in chips)
Seat 5: cf91ce53 ($25.25 in chips)
Seat 6: 7c0ffa93 ($35.28 in chips)
6736194e: posts small blind $0.1
2c82afb5: posts big blind $0.25
*** HOLE CARDS ***
Dealt to d437c92d 
Dealt to 6736194e 
Dealt to 2c82afb5 
Dealt to Hero [7c 3s]
Dealt to cf91ce53 
Dealt to 7c0ffa93 
Hero: folds
cf91ce53: folds
7c0ffa93: folds
d437c92d: raises $0.5 to $0.75
6736194e: folds
2c82afb5: folds
Uncalled bet ($0.5) returned to d437c92d
*** SHOWDOWN ***
d437c92d collected $0.6 from pot
*** SUMMARY ***
Total pot $0.6
Seat 1: d437c92d (button) collected ($0.6)
Seat 2: 6736194e (small blind) folded before Flop
Seat 3: 2c82afb5 (big blind) folded before Flop
Seat 4: Hero folded before Flop (didn't bet)
Seat 5: cf91ce53 folded before Flop (didn't bet)
Seat 6: 7c0ffa93 folded before Flop (didn't bet)


Poker Hand #RC95095855: Hold'em No Limit ($0.1/$0.25) - 2020/04/07 15:40:01
Table 'RushAndCash365431' 6-max Seat #1 is the button
Seat 1: Hero ($31.06 in chips)
Seat 2: 74937d40 ($34.1 in chips)
Seat 3: 6736194e ($24.67 in chips)
Seat 4: dbf6981f ($64.03 in chips)
Seat 5: bb849ffc ($11.3 in chips)
Seat 6: bdffd813 ($25 in chips)
74937d40: posts small blind $0.1
6736194e: posts big blind $0.25
*** HOLE CARDS ***
Dealt to Hero [6h 4c]
Dealt to 74937d40 
Dealt to 6736194e 
Dealt to dbf6981f 
Dealt to bb849ffc 
Dealt to bdffd813 
dbf6981f: folds
bb849ffc: folds
bdffd813: folds
Hero: folds
74937d40: raises $0.5 to $0.75
6736194e: calls $0.5
*** FLOP *** [8d 7c 2c]
74937d40: bets $0.8
6736194e: raises $0.8 to $1.6
74937d40: calls $0.8
*** TURN *** [8d 7c 2c] [7s]
74937d40: checks
6736194e: checks
*** RIVER *** [8d 7c 2c 7s] [9d]
74937d40: bets $3.6
6736194e: folds
Uncalled bet ($3.6) returned to 74937d40
*** SHOWDOWN ***
74937d40 collected $4.7 from pot
*** SUMMARY ***
Total pot $4.7
Board [8d 7c 2c 7s 9d]
Seat 1: Hero (button) folded before Flop (didn't bet)
Seat 2: 74937d40 (small blind) won ($4.7)
Seat 3: 6736194e (big blind) folded on the River
Seat 4: dbf6981f folded before Flop (didn't bet)
Seat 5: bb849ffc folded before Flop (didn't bet)
Seat 6: bdffd813 folded before Flop (didn't bet)


Poker Hand #RC95095879: Hold'em No Limit ($0.1/$0.25) - 2020/04/07 15:40:04
Table 'RushAndCash365436' 6-max Seat #1 is the button
Seat 1: 7c0ffa93 ($35.28 in chips)
Seat 2: Hero ($31.06 in chips)
Seat 3: 9f138297 ($31.82 in chips)
Seat 4: 49b3e425 ($24.85 in chips)
Seat 5: 4ab4e4a3 ($25 in chips)
Seat 6: dbf6981f ($64.03 in chips)
Hero: posts small blind $0.1
9f138297: posts big blind $0.25
*** HOLE CARDS ***
Dealt to 7c0ffa93 
Dealt to Hero [3d 2d]
Dealt to 9f138297 
Dealt to 49b3e425 
Dealt to 4ab4e4a3 
Dealt to dbf6981f 
49b3e425: folds
4ab4e4a3: raises $0.5 to $0.75
dbf6981f: folds
7c0ffa93: folds
Hero: folds
9f138297: folds
Uncalled bet ($0.5) returned to 4ab4e4a3
*** SHOWDOWN ***
4ab4e4a3 collected $0.6 from pot
*** SUMMARY ***
Total pot $0.6
Seat 1: 7c0ffa93 (button) folded before Flop (didn't bet)
Seat 2: Hero (small blind) folded before Flop
Seat 3: 9f138297 (big blind) folded before Flop
Seat 4: 49b3e425 folded before Flop (didn't bet)
Seat 5: 4ab4e4a3 collected ($0.6)
Seat 6: dbf6981f folded before Flop (didn't bet)


Poker Hand #RC95095912: Hold'em No Limit ($0.1/$0.25) - 2020/04/07 15:40:09
Table 'RushAndCash365440' 6-max Seat #1 is the button
Seat 1: d2986703 ($42.17 in chips)
Seat 2: 32953d2a ($13.96 in chips)
Seat 3: Hero ($30.96 in chips)
Seat 4: cf91ce53 ($25.25 in chips)
Seat 5: 93bbad06 ($18.03 in chips)
Seat 6: 7c0ffa93 ($35.28 in chips)
32953d2a: posts small blind $0.1
Hero: posts big blind $0.25
*** HOLE CARDS ***
Dealt to d2986703 
Dealt to 32953d2a 
Dealt to Hero [Jh 2h]
Dealt to cf91ce53 
Dealt to 93bbad06 
Dealt to 7c0ffa93 
cf91ce53: folds
93bbad06: folds
7c0ffa93: folds
d2986703: folds
32953d2a: folds
Uncalled bet ($0.15) returned to Hero
*** SHOWDOWN ***
Hero collected $0.2 from pot
*** SUMMARY ***
Total pot $0.2
Seat 1: d2986703 (button) folded before Flop (didn't bet)
Seat 2: 32953d2a (small blind) folded before Flop
Seat 3: Hero (big blind) collected ($0.2)
Seat 4: cf91ce53 folded before Flop (didn't bet)
Seat 5: 93bbad06 folded before Flop (didn't bet)
Seat 6: 7c0ffa93 folded before Flop (didn't bet)


Poker Hand #RC95095940: Hold'em No Limit ($0.1/$0.25) - 2020/04/07 15:40:13
Table 'RushAndCash365444' 6-max Seat #1 is the button
Seat 1: e131407f ($29.29 in chips)
Seat 2: bc3db224 ($25.1 in chips)
Seat 3: a0d04110 ($78.9 in chips)
Seat 4: Hero ($30.71 in chips)
Seat 5: 2d45ce80 ($8.47 in chips)
Seat 6: d9a04cfb ($28.7 in chips)
bc3db224: posts small blind $0.1
a0d04110: posts big blind $0.25
*** HOLE CARDS ***
Dealt to e131407f 
Dealt to bc3db224 
Dealt to a0d04110 
Dealt to Hero [Qs 2h]
Dealt to 2d45ce80 
Dealt to d9a04cfb 
Hero: folds
2d45ce80: raises $0.63 to $0.88
d9a04cfb: folds
e131407f: folds
bc3db224: folds
a0d04110: folds
Uncalled bet ($0.63) returned to 2d45ce80
*** SHOWDOWN ***
2d45ce80 collected $0.6 from pot
*** SUMMARY ***
Total pot $0.6
Seat 1: e131407f (button) folded before Flop (didn't bet)
Seat 2: bc3db224 (small blind) folded before Flop
Seat 3: a0d04110 (big blind) folded before Flop
Seat 4: Hero folded before Flop (didn't bet)
Seat 5: 2d45ce80 collected ($0.6)
Seat 6: d9a04cfb folded before Flop (didn't bet)


Poker Hand #RC95095973: Hold'em No Limit ($0.1/$0.25) - 2020/04/07 15:40:17
Table 'RushAndCash365449' 6-max Seat #1 is the button
Seat 1: Hero ($30.71 in chips)
Seat 2: d2f55a32 ($13.01 in chips)
Seat 3: be711e9d ($32.45 in chips)
Seat 4: 704c37d9 ($44.22 in chips)
Seat 5: 4dd920ba ($35.71 in chips)
Seat 6: 88709749 ($7.43 in chips)
d2f55a32: posts small blind $0.1
be711e9d: posts big blind $0.25
*** HOLE CARDS ***
Dealt to Hero [Jh 2h]
Dealt to d2f55a32 
Dealt to be711e9d 
Dealt to 704c37d9 
Dealt to 4dd920ba 
Dealt to 88709749 
704c37d9: raises $0.38 to $0.63
4dd920ba: calls $0.63
88709749: calls $0.63
Hero: folds
d2f55a32: folds
be711e9d: calls $0.38
*** FLOP *** [7c 2c 2d]
be711e9d: checks
704c37d9: bets $0.9
4dd920ba: folds
88709749: calls $0.9
be711e9d: calls $0.9
*** TURN *** [7c 2c 2d] [Tc]
be711e9d: bets $2.7
704c37d9: folds
88709749: raises $3.2 to $5.9 and is all-in
be711e9d: calls $3.2
88709749: shows [Qc Jc] (Queen High Flush)
be711e9d: shows [7h 7d] (Sevens Full over Twos)
*** RIVER *** [7c 2c 2d Tc] [Ac]
*** SHOWDOWN ***
be711e9d collected $17.12 from pot
*** SUMMARY ***
Total pot $17.12
Board [7c 2c 2d Tc Ac]
Seat 1: Hero (button) folded before Flop (didn't bet)
Seat 2: d2f55a32 (small blind) folded before Flop
Seat 3: be711e9d (big blind) showed [7h 7d] and won ($17.12) with Sevens Full over Twos
Seat 4: 704c37d9 folded on the Turn
Seat 5: 4dd920ba folded on the Flop
Seat 6: 88709749 showed [Qc Jc] and lost with Ace High Flush


Poker Hand #RC95096011: Hold'em No Limit ($0.1/$0.25) - 2020/04/07 15:40:21
Table 'RushAndCash365452' 6-max Seat #1 is the button
Seat 1: ce59b684 ($32.94 in chips)
Seat 2: 17388104 ($26.32 in chips)
Seat 3: bdffd813 ($25 in chips)
Seat 4: Hero ($30.71 in chips)
Seat 5: 966446c2 ($29.77 in chips)
Seat 6: af84e661 ($5.49 in chips)
17388104: posts small blind $0.1
bdffd813: posts big blind $0.25
*** HOLE CARDS ***
Dealt to ce59b684 
Dealt to 17388104 
Dealt to bdffd813 
Dealt to Hero [9s 6c]
Dealt to 966446c2 
Dealt to af84e661 
Hero: folds
966446c2: raises $0.5 to $0.75
af84e661: folds
ce59b684: folds
17388104: folds
bdffd813: calls $0.5
*** FLOP *** [4d 7s Td]
bdffd813: checks
966446c2: bets $0.8
bdffd813: calls $0.8
*** TURN *** [4d 7s Td] [6s]
bdffd813: checks
966446c2: bets $2.4
bdffd813: folds
Uncalled bet ($2.4) returned to 966446c2
*** SHOWDOWN ***
966446c2 collected $3.2 from pot
*** SUMMARY ***
Total pot $3.2
Board [4d 7s Td 6s]
Seat 1: ce59b684 (button) folded before Flop (didn't bet)
Seat 2: 17388104 (small blind) folded before Flop
Seat 3: bdffd813 (big blind) folded on the Turn
Seat 4: Hero folded before Flop (didn't bet)
Seat 5: 966446c2 won ($3.2)
Seat 6: af84e661 folded before Flop (didn't bet)


Poker Hand #RC95096040: Hold'em No Limit ($0.1/$0.25) - 2020/04/07 15:40:25
Table 'RushAndCash365455' 6-max Seat #1 is the button
Seat 1: 9f138297 ($31.57 in chips)
Seat 2: be3950eb ($27.96 in chips)
Seat 3: 17388104 ($26.22 in chips)
Seat 4: 8004b155 ($8.49 in chips)
Seat 5: Hero ($30.71 in chips)
Seat 6: acf1a889 ($19.14 in chips)
be3950eb: posts small blind $0.1
17388104: posts big blind $0.25
*** HOLE CARDS ***
Dealt to 9f138297 
Dealt to be3950eb 
Dealt to 17388104 
Dealt to 8004b155 
Dealt to Hero [Td 9d]
Dealt to acf1a889 
8004b155: folds
Hero: raises $0.38 to $0.63
acf1a889: folds
9f138297: folds
be3950eb: folds
17388104: folds
Uncalled bet ($0.38) returned to Hero
*** SHOWDOWN ***
Hero collected $0.6 from pot
*** SUMMARY ***
Total pot $0.6
Seat 1: 9f138297 (button) folded before Flop (didn't bet)
Seat 2: be3950eb (small blind) folded before Flop
Seat 3: 17388104 (big blind) folded before Flop
Seat 4: 8004b155 folded before Flop (didn't bet)
Seat 5: Hero collected ($0.6)
Seat 6: acf1a889 folded before Flop (didn't bet)


Poker Hand #RC95096172: Hold'em No Limit ($0.1/$0.25) - 2020/04/07 15:40:42
Table 'RushAndCash365470' 6-max Seat #1 is the button
Seat 1: 61ad32d ($19.46 in chips)
Seat 2: 7c935d24 ($25.35 in chips)
Seat 3: Hero ($31.41 in chips)
Seat 4: 3423a84d ($31.82 in chips)
Seat 5: 5d2a310d ($8.5 in chips)
Seat 6: e131407f ($29.29 in chips)
7c935d24: posts small blind $0.1
Hero: posts big blind $0.25
*** HOLE CARDS ***
Dealt to 61ad32d 
Dealt to 7c935d24 
Dealt to Hero [Qh 3h]
Dealt to 3423a84d 
Dealt to 5d2a310d 
Dealt to e131407f 
3423a84d: folds
5d2a310d: folds
e131407f: raises $0.25 to $0.5
61ad32d: folds
7c935d24: folds
Hero: folds
Uncalled bet ($0.25) returned to e131407f
*** SHOWDOWN ***
e131407f collected $0.6 from pot
*** SUMMARY ***
Total pot $0.6
Seat 1: 61ad32d (button) folded before Flop (didn't bet)
Seat 2: 7c935d24 (small blind) folded before Flop
Seat 3: Hero (big blind) folded before Flop
Seat 4: 3423a84d folded before Flop (didn't bet)
Seat 5: 5d2a310d folded before Flop (didn't bet)
Seat 6: e131407f collected ($0.6)


Poker Hand #RC95096197: Hold'em No Limit ($0.1/$0.25) - 2020/04/07 15:40:45
Table 'RushAndCash365474' 6-max Seat #1 is the button
Seat 1: 5794e88f ($43.61 in chips)
Seat 2: 8004b155 ($8.24 in chips)
Seat 3: b5d592d2 ($12.31 in chips)
Seat 4: 30cab83a ($28.48 in chips)
Seat 5: 8b8d197c ($33.56 in chips)
Seat 6: Hero ($31.16 in chips)
8004b155: posts small blind $0.1
b5d592d2: posts big blind $0.25
*** HOLE CARDS ***
Dealt to 5794e88f 
Dealt to 8004b155 
Dealt to b5d592d2 
Dealt to 30cab83a 
Dealt to 8b8d197c 
Dealt to Hero [8s 7h]
30cab83a: folds
8b8d197c: raises $0.38 to $0.63
Hero: folds
5794e88f: folds
8004b155: folds
b5d592d2: folds
Uncalled bet ($0.38) returned to 8b8d197c
*** SHOWDOWN ***
8b8d197c collected $0.6 from pot
*** SUMMARY ***
Total pot $0.6
Seat 1: 5794e88f (button) folded before Flop (didn't bet)
Seat 2: 8004b155 (small blind) folded before Flop
Seat 3: b5d592d2 (big blind) folded before Flop
Seat 4: 30cab83a folded before Flop (didn't bet)
Seat 5: 8b8d197c collected ($0.6)
Seat 6: Hero folded before Flop (didn't bet)


Poker Hand #RC95096223: Hold'em No Limit ($0.1/$0.25) - 2020/04/07 15:40:48
Table 'RushAndCash365478' 6-max Seat #1 is the button
Seat 1: 32953d2a ($13.51 in chips)
Seat 2: Hero ($31.16 in chips)
Seat 3: 40a91d41 ($27.94 in chips)
Seat 4: 2d45ce80 ($8.57 in chips)
Seat 5: 7ed3ab6b ($69.55 in chips)
Seat 6: 9f138297 ($31.57 in chips)
Hero: posts small blind $0.1
40a91d41: posts big blind $0.25
*** HOLE CARDS ***
Dealt to 32953d2a 
Dealt to Hero [Jd 3d]
Dealt to 40a91d41 
Dealt to 2d45ce80 
Dealt to 7ed3ab6b 
Dealt to 9f138297 
2d45ce80: folds
7ed3ab6b: folds
9f138297: folds
32953d2a: folds
Hero: folds
Uncalled bet ($0.15) returned to 40a91d41
*** SHOWDOWN ***
40a91d41 collected $0.2 from pot
*** SUMMARY ***
Total pot $0.2
Seat 1: 32953d2a (button) folded before Flop (didn't bet)
Seat 2: Hero (small blind) folded before Flop
Seat 3: 40a91d41 (big blind) collected ($0.2)
Seat 4: 2d45ce80 folded before Flop (didn't bet)
Seat 5: 7ed3ab6b folded before Flop (didn't bet)
Seat 6: 9f138297 folded before Flop (didn't bet)


Poker Hand #RC95096332: Hold'em No Limit ($0.1/$0.25) - 2020/04/07 15:41:03
Table 'RushAndCash365495' 6-max Seat #1 is the button
Seat 1: Hero ($31.06 in chips)
Seat 2: 181b6319 ($25.19 in chips)
Seat 3: 32953d2a ($13.51 in chips)
Seat 4: bc3db224 ($24.5 in chips)
Seat 5: 7c0ffa93 ($34.65 in chips)
Seat 6: 704c37d9 ($42.69 in chips)
181b6319: posts small blind $0.1
32953d2a: posts big blind $0.25
*** HOLE CARDS ***
Dealt to Hero [9h 4c]
Dealt to 181b6319 
Dealt to 32953d2a 
Dealt to bc3db224 
Dealt to 7c0ffa93 
Dealt to 704c37d9 
bc3db224: folds
7c0ffa93: folds
704c37d9: folds
Hero: folds
181b6319: folds
Uncalled bet ($0.15) returned to 32953d2a
*** SHOWDOWN ***
32953d2a collected $0.2 from pot
*** SUMMARY ***
Total pot $0.2
Seat 1: Hero (button) folded before Flop (didn't bet)
Seat 2: 181b6319 (small blind) folded before Flop
Seat 3: 32953d2a (big blind) collected ($0.2)
Seat 4: bc3db224 folded before Flop (didn't bet)
Seat 5: 7c0ffa93 folded before Flop (didn't bet)
Seat 6: 704c37d9 folded before Flop (didn't bet)


Poker Hand #RC95096353: Hold'em No Limit ($0.1/$0.25) - 2020/04/07 15:41:06
Table 'RushAndCash365499' 6-max Seat #1 is the button
Seat 1: ec1c524d ($25.7 in chips)
Seat 2: 40a91d41 ($28.04 in chips)
Seat 3: 492c0086 ($12.32 in chips)
Seat 4: 6736194e ($23.18 in chips)
Seat 5: 8004b155 ($7.89 in chips)
Seat 6: Hero ($31.06 in chips)
40a91d41: posts small blind $0.1
492c0086: posts big blind $0.25
*** HOLE CARDS ***
Dealt to ec1c524d 
Dealt to 40a91d41 
Dealt to 492c0086 
Dealt to 6736194e 
Dealt to 8004b155 
Dealt to Hero [Kh 2s]
6736194e: raises $0.75 to $1
8004b155: folds
Hero: folds
ec1c524d: folds
40a91d41: folds
492c0086: folds
Uncalled bet ($0.75) returned to 6736194e
*** SHOWDOWN ***
6736194e collected $0.6 from pot
*** SUMMARY ***
Total pot $0.6
Seat 1: ec1c524d (button) folded before Flop (didn't bet)
Seat 2: 40a91d41 (small blind) folded before Flop
Seat 3: 492c0086 (big blind) folded before Flop
Seat 4: 6736194e collected ($0.6)
Seat 5: 8004b155 folded before Flop (didn't bet)
Seat 6: Hero folded before Flop (didn't bet)


Poker Hand #RC95096382: Hold'em No Limit ($0.1/$0.25) - 2020/04/07 15:41:10
Table 'RushAndCash365504' 6-max Seat #1 is the button
Seat 1: 181b6319 ($25.09 in chips)
Seat 2: 9f138297 ($31.57 in chips)
Seat 3: 44d6b861 ($25 in chips)
Seat 4: be711e9d ($41.14 in chips)
Seat 5: db97ffd8 ($11.65 in chips)
Seat 6: Hero ($31.06 in chips)
9f138297: posts small blind $0.1
44d6b861: posts big blind $0.25
*** HOLE CARDS ***
Dealt to 181b6319 
Dealt to 9f138297 
Dealt to 44d6b861 
Dealt to be711e9d 
Dealt to db97ffd8 
Dealt to Hero [Qh 8d]
be711e9d: folds
db97ffd8: folds
Hero: folds
181b6319: raises $0.38 to $0.63
9f138297: folds
44d6b861: folds
Uncalled bet ($0.38) returned to 181b6319
*** SHOWDOWN ***
181b6319 collected $0.6 from pot
*** SUMMARY ***
Total pot $0.6
Seat 1: 181b6319 (button) collected ($0.6)
Seat 2: 9f138297 (small blind) folded before Flop
Seat 3: 44d6b861 (big blind) folded before Flop
Seat 4: be711e9d folded before Flop (didn't bet)
Seat 5: db97ffd8 folded before Flop (didn't bet)
Seat 6: Hero folded before Flop (didn't bet)


Poker Hand #RC95096414: Hold'em No Limit ($0.1/$0.25) - 2020/04/07 15:41:14
Table 'RushAndCash365510' 6-max Seat #1 is the button
Seat 1: 17388104 ($26.44 in chips)
Seat 2: Hero ($31.06 in chips)
Seat 3: bda1b4ce ($25 in chips)
Seat 4: db97ffd8 ($11.65 in chips)
Seat 5: cb3a82b2 ($11.65 in chips)
Seat 6: 32953d2a ($13.61 in chips)
Hero: posts small blind $0.1
bda1b4ce: posts big blind $0.25
*** HOLE CARDS ***
Dealt to 17388104 
Dealt to Hero [Ac 6h]
Dealt to bda1b4ce 
Dealt to db97ffd8 
Dealt to cb3a82b2 
Dealt to 32953d2a 
db97ffd8: folds
cb3a82b2: folds
32953d2a: raises $0.38 to $0.63
17388104: calls $0.63
Hero: folds
bda1b4ce: calls $0.38
*** FLOP *** [7h 8h 3s]
bda1b4ce: checks
32953d2a: checks
17388104: bets $1.99
bda1b4ce: calls $1.99
32953d2a: folds
*** TURN *** [7h 8h 3s] [3d]
bda1b4ce: checks
17388104: bets $1.8
bda1b4ce: calls $1.8
*** RIVER *** [7h 8h 3s 3d] [8s]
bda1b4ce: checks
17388104: bets $2.99
bda1b4ce: raises $7.81 to $10.8
17388104: folds
Uncalled bet ($7.81) returned to bda1b4ce
*** SHOWDOWN ***
bda1b4ce collected $15.55 from pot
*** SUMMARY ***
Total pot $15.55
Board [7h 8h 3s 3d 8s]
Seat 1: 17388104 (button) folded on the River
Seat 2: Hero (small blind) folded before Flop
Seat 3: bda1b4ce (big blind) won ($15.55)
Seat 4: db97ffd8 folded before Flop (didn't bet)
Seat 5: cb3a82b2 folded before Flop (didn't bet)
Seat 6: 32953d2a folded on the Flop


Poker Hand #RC95096443: Hold'em No Limit ($0.1/$0.25) - 2020/04/07 15:41:18
Table 'RushAndCash365514' 6-max Seat #1 is the button
Seat 1: acf1a889 ($19.14 in chips)
Seat 2: a4ba858f ($39.12 in chips)
Seat 3: Hero ($30.96 in chips)
Seat 4: 2d45ce80 ($8.47 in chips)
Seat 5: edde387a ($18.44 in chips)
Seat 6: bbb85b3f ($25.18 in chips)
a4ba858f: posts small blind $0.1
Hero: posts big blind $0.25
*** HOLE CARDS ***
Dealt to acf1a889 
Dealt to a4ba858f 
Dealt to Hero [Ac Jc]
Dealt to 2d45ce80 
Dealt to edde387a 
Dealt to bbb85b3f 
2d45ce80: folds
edde387a: raises $0.5 to $0.75
bbb85b3f: folds
acf1a889: folds
a4ba858f: calls $0.65
Hero: calls $0.5
*** FLOP *** [2h Qh Kc]
a4ba858f: checks
Hero: checks
edde387a: checks
*** TURN *** [2h Qh Kc] [6d]
a4ba858f: checks
Hero: checks
edde387a: checks
*** RIVER *** [2h Qh Kc 6d] [Td]
a4ba858f: checks
Hero: bets $1.7
edde387a: folds
a4ba858f: folds
Uncalled bet ($1.7) returned to Hero
*** SHOWDOWN ***
Hero collected $2.25 from pot
*** SUMMARY ***
Total pot $2.25
Board [2h Qh Kc 6d Td]
Seat 1: acf1a889 (button) folded before Flop (didn't bet)
Seat 2: a4ba858f (small blind) folded on the River
Seat 3: Hero (big blind) won ($2.25)
Seat 4: 2d45ce80 folded before Flop (didn't bet)
Seat 5: edde387a folded on the River
Seat 6: bbb85b3f folded before Flop (didn't bet)


Poker Hand #RC95096884: Hold'em No Limit ($0.1/$0.25) - 2020/04/07 15:42:16
Table 'RushAndCash365566' 6-max Seat #1 is the button
Seat 1: be3950eb ($28.06 in chips)
Seat 2: bc3db224 ($23.87 in chips)
Seat 3: 3f5f9735 ($20.83 in chips)
Seat 4: a4ba858f ($38.37 in chips)
Seat 5: Hero ($32.35 in chips)
Seat 6: 704c37d9 ($43.11 in chips)
bc3db224: posts small blind $0.1
3f5f9735: posts big blind $0.25
*** HOLE CARDS ***
Dealt to be3950eb 
Dealt to bc3db224 
Dealt to 3f5f9735 
Dealt to a4ba858f 
Dealt to Hero [6c 4c]
Dealt to 704c37d9 
a4ba858f: folds
Hero: folds
704c37d9: folds
be3950eb: folds
bc3db224: raises $0.5 to $0.75
3f5f9735: folds
Uncalled bet ($0.5) returned to bc3db224
*** SHOWDOWN ***
bc3db224 collected $0.5 from pot
*** SUMMARY ***
Total pot $0.5
Seat 1: be3950eb (button) folded before Flop (didn't bet)
Seat 2: bc3db224 (small blind) collected ($0.5)
Seat 3: 3f5f9735 (big blind) folded before Flop
Seat 4: a4ba858f folded before Flop (didn't bet)
Seat 5: Hero folded before Flop (didn't bet)
Seat 6: 704c37d9 folded before Flop (didn't bet)


Poker Hand #RC95096917: Hold'em No Limit ($0.1/$0.25) - 2020/04/07 15:42:21
Table 'RushAndCash365570' 6-max Seat #1 is the button
Seat 1: 6f1c538f ($25.6 in chips)
Seat 2: Hero ($32.35 in chips)
Seat 3: 3cfd7308 ($50.26 in chips)
Seat 4: bf64de7f ($8.29 in chips)
Seat 5: a4ba858f ($38.37 in chips)
Seat 6: af84e661 ($6.16 in chips)
Hero: posts small blind $0.1
3cfd7308: posts big blind $0.25
*** HOLE CARDS ***
Dealt to 6f1c538f 
Dealt to Hero [Qc Jh]
Dealt to 3cfd7308 
Dealt to bf64de7f 
Dealt to a4ba858f 
Dealt to af84e661 
bf64de7f: folds
a4ba858f: raises $0.5 to $0.75
af84e661: folds
6f1c538f: folds
Hero: folds
3cfd7308: folds
Uncalled bet ($0.5) returned to a4ba858f
*** SHOWDOWN ***
a4ba858f collected $0.6 from pot
*** SUMMARY ***
Total pot $0.6
Seat 1: 6f1c538f (button) folded before Flop (didn't bet)
Seat 2: Hero (small blind) folded before Flop
Seat 3: 3cfd7308 (big blind) folded before Flop
Seat 4: bf64de7f folded before Flop (didn't bet)
Seat 5: a4ba858f collected ($0.6)
Seat 6: af84e661 folded before Flop (didn't bet)


Poker Hand #RC95097057: Hold'em No Limit ($0.1/$0.25) - 2020/04/07 15:42:37
Table 'RushAndCash365590' 6-max Seat #1 is the button
Seat 1: 4ab4e4a3 ($25.9 in chips)
Seat 2: e6fa23c9 ($12.17 in chips)
Seat 3: 2dd038c3 ($9.46 in chips)
Seat 4: dbf6981f ($64.6 in chips)
Seat 5: Hero ($32.25 in chips)
Seat 6: 61ad32d ($19.46 in chips)
e6fa23c9: posts small blind $0.1
2dd038c3: posts big blind $0.25
*** HOLE CARDS ***
Dealt to 4ab4e4a3 
Dealt to e6fa23c9 
Dealt to 2dd038c3 
Dealt to dbf6981f 
Dealt to Hero [7s 3h]
Dealt to 61ad32d 
dbf6981f: raises $0.38 to $0.63
Hero: folds
61ad32d: folds
4ab4e4a3: calls $0.63
e6fa23c9: folds
2dd038c3: folds
*** FLOP *** [Td 5h Th]
dbf6981f: checks
4ab4e4a3: checks
*** TURN *** [Td 5h Th] [Kd]
dbf6981f: bets $0.9
4ab4e4a3: folds
Uncalled bet ($0.9) returned to dbf6981f
*** SHOWDOWN ***
dbf6981f collected $1.61 from pot
*** SUMMARY ***
Total pot $1.61
Board [Td 5h Th Kd]
Seat 1: 4ab4e4a3 (button) folded on the Turn
Seat 2: e6fa23c9 (small blind) folded before Flop
Seat 3: 2dd038c3 (big blind) folded before Flop
Seat 4: dbf6981f won ($1.61)
Seat 5: Hero folded before Flop (didn't bet)
Seat 6: 61ad32d folded before Flop (didn't bet)


Poker Hand #RC95097151: Hold'em No Limit ($0.1/$0.25) - 2020/04/07 15:42:49
Table 'RushAndCash365603' 6-max Seat #1 is the button
Seat 1: 7c935d24 ($25.25 in chips)
Seat 2: 4dd920ba ($35.08 in chips)
Seat 3: d2986703 ($40.62 in chips)
Seat 4: 3fe95a27 ($13.1 in chips)
Seat 5: ec1c524d ($25 in chips)
Seat 6: Hero ($32.25 in chips)
4dd920ba: posts small blind $0.1
d2986703: posts big blind $0.25
*** HOLE CARDS ***
Dealt to 7c935d24 
Dealt to 4dd920ba 
Dealt to d2986703 
Dealt to 3fe95a27 
Dealt to ec1c524d 
Dealt to Hero [Td 6s]
3fe95a27: raises $0.5 to $0.75
ec1c524d: folds
Hero: folds
7c935d24: folds
4dd920ba: raises $1.75 to $2.5
d2986703: folds
3fe95a27: calls $1.75
*** FLOP *** [Ts 7h 9h]
4dd920ba: bets $3.75
3fe95a27: raises $6.85 to $10.6 and is all-in
4dd920ba: calls $6.85
3fe95a27: shows [Qh Ah] (Ace-High)
4dd920ba: shows [Kd Ks] (Pair of Kings)
*** FIRST TURN *** [Ts 7h 9h] [8d]
*** FIRST RIVER *** [Ts 7h 9h 8d] [4s]
*** SECOND TURN *** [Ts 7h 9h] [7s]
*** SECOND RIVER *** [Ts 7h 9h 7s] [2h]
*** FIRST SHOWDOWN ***
4dd920ba collected $13.22 from pot
*** SECOND SHOWDOWN ***
3fe95a27 collected $13.22 from pot
*** SUMMARY ***
Total pot $26.45
Hand was run two times
FIRST Board [Ts 7h 9h 8d 4s]
SECOND Board [Ts 7h 9h 7s 2h]
Seat 1: 7c935d24 (button) folded before Flop (didn't bet)
Seat 2: 4dd920ba (small blind) showed [Ks Kd] and won ($13.22) with Pair of Kings, and lost with Pair of Kings and Pair of Sevens
Seat 3: d2986703 (big blind) folded before Flop
Seat 4: 3fe95a27 showed [Ah Qh] and lost with Ace-High, and won ($13.22) with Ace High Flush
Seat 5: ec1c524d folded before Flop (didn't bet)
Seat 6: Hero folded before Flop (didn't bet)


Poker Hand #RC95097209: Hold'em No Limit ($0.1/$0.25) - 2020/04/07 15:42:57
Table 'RushAndCash365612' 6-max Seat #1 is the button
Seat 1: fc8a29ea ($57.72 in chips)
Seat 2: dc1d83ec ($24.75 in chips)
Seat 3: Hero ($32.25 in chips)
Seat 4: 3d05956 ($41.14 in chips)
Seat 5: fe3f48f4 ($25 in chips)
Seat 6: a4ba858f ($38.37 in chips)
dc1d83ec: posts small blind $0.1
Hero: posts big blind $0.25
*** HOLE CARDS ***
Dealt to fc8a29ea 
Dealt to dc1d83ec 
Dealt to Hero [Qs 4c]
Dealt to 3d05956 
Dealt to fe3f48f4 
Dealt to a4ba858f 
3d05956: folds
fe3f48f4: folds
a4ba858f: raises $0.5 to $0.75
fc8a29ea: folds
dc1d83ec: calls $0.65
Hero: folds
*** FLOP *** [7d Qd 7c]
dc1d83ec: checks
a4ba858f: checks
*** TURN *** [7d Qd 7c] [As]
dc1d83ec: bets $0.9
a4ba858f: folds
Uncalled bet ($0.9) returned to dc1d83ec
*** SHOWDOWN ***
dc1d83ec collected $1.75 from pot
*** SUMMARY ***
Total pot $1.75
Board [7d Qd 7c As]
Seat 1: fc8a29ea (button) folded before Flop (didn't bet)
Seat 2: dc1d83ec (small blind) won ($1.75)
Seat 3: Hero (big blind) folded before Flop
Seat 4: 3d05956 folded before Flop (didn't bet)
Seat 5: fe3f48f4 folded before Flop (didn't bet)
Seat 6: a4ba858f folded on the Turn


Poker Hand #RC95097236: Hold'em No Limit ($0.1/$0.25) - 2020/04/07 15:43:00
Table 'RushAndCash365615' 6-max Seat #1 is the button
Seat 1: Hero ($32 in chips)
Seat 2: 2c82afb5 ($12.19 in chips)
Seat 3: b58bfe0f ($25.65 in chips)
Seat 4: 32953d2a ($13.3 in chips)
Seat 5: ac90cf4e ($10.15 in chips)
Seat 6: 3cfd7308 ($49.91 in chips)
2c82afb5: posts small blind $0.1
b58bfe0f: posts big blind $0.25
*** HOLE CARDS ***
Dealt to Hero [Jh 5h]
Dealt to 2c82afb5 
Dealt to b58bfe0f 
Dealt to 32953d2a 
Dealt to ac90cf4e 
Dealt to 3cfd7308 
32953d2a: raises $0.38 to $0.63
ac90cf4e: folds
3cfd7308: folds
Hero: folds
2c82afb5: folds
b58bfe0f: calls $0.38
*** FLOP *** [Qs Kh 2s]
b58bfe0f: checks
32953d2a: bets $0.5
b58bfe0f: calls $0.5
*** TURN *** [Qs Kh 2s] [9c]
b58bfe0f: checks
32953d2a: checks
*** RIVER *** [Qs Kh 2s 9c] [4s]
b58bfe0f: bets $1.8
32953d2a: folds
Uncalled bet ($1.8) returned to b58bfe0f
*** SHOWDOWN ***
b58bfe0f collected $2.36 from pot
*** SUMMARY ***
Total pot $2.36
Board [Qs Kh 2s 9c 4s]
Seat 1: Hero (button) folded before Flop (didn't bet)
Seat 2: 2c82afb5 (small blind) folded before Flop
Seat 3: b58bfe0f (big blind) won ($2.36)
Seat 4: 32953d2a folded on the River
Seat 5: ac90cf4e folded before Flop (didn't bet)
Seat 6: 3cfd7308 folded before Flop (didn't bet)


Poker Hand #RC95097290: Hold'em No Limit ($0.1/$0.25) - 2020/04/07 15:43:07
Table 'RushAndCash365620' 6-max Seat #1 is the button
Seat 1: 52ee6b3d ($31 in chips)
Seat 2: 8b8d197c ($33.73 in chips)
Seat 3: ec1c524d ($25 in chips)
Seat 4: 89387862 ($28.55 in chips)
Seat 5: 966446c2 ($32.71 in chips)
Seat 6: Hero ($32 in chips)
8b8d197c: posts small blind $0.1
ec1c524d: posts big blind $0.25
*** HOLE CARDS ***
Dealt to 52ee6b3d 
Dealt to 8b8d197c 
Dealt to ec1c524d 
Dealt to 89387862 
Dealt to 966446c2 
Dealt to Hero [Kc 5h]
89387862: folds
966446c2: folds
Hero: folds
52ee6b3d: raises $0.38 to $0.63
8b8d197c: folds
ec1c524d: folds
Uncalled bet ($0.38) returned to 52ee6b3d
*** SHOWDOWN ***
52ee6b3d collected $0.6 from pot
*** SUMMARY ***
Total pot $0.6
Seat 1: 52ee6b3d (button) collected ($0.6)
Seat 2: 8b8d197c (small blind) folded before Flop
Seat 3: ec1c524d (big blind) folded before Flop
Seat 4: 89387862 folded before Flop (didn't bet)
Seat 5: 966446c2 folded before Flop (didn't bet)
Seat 6: Hero folded before Flop (didn't bet)


Poker Hand #RC95097359: Hold'em No Limit ($0.1/$0.25) - 2020/04/07 15:43:17
Table 'RushAndCash365629' 6-max Seat #1 is the button
Seat 1: 2c82afb5 ($12.09 in chips)
Seat 2: Hero ($32 in chips)
Seat 3: 45920dbc ($48.67 in chips)
Seat 4: 966446c2 ($32.71 in chips)
Seat 5: 40a91d41 ($26.46 in chips)
Seat 6: 8c86f461 ($30.53 in chips)
Hero: posts small blind $0.1
45920dbc: posts big blind $0.25
*** HOLE CARDS ***
Dealt to 2c82afb5 
Dealt to Hero [Td 2s]
Dealt to 45920dbc 
Dealt to 966446c2 
Dealt to 40a91d41 
Dealt to 8c86f461 
966446c2: folds
40a91d41: folds
8c86f461: raises $0.38 to $0.63
2c82afb5: raises $1.37 to $2
Hero: folds
45920dbc: folds
8c86f461: folds
Uncalled bet ($1.37) returned to 2c82afb5
*** SHOWDOWN ***
2c82afb5 collected $1.61 from pot
*** SUMMARY ***
Total pot $1.61
Seat 1: 2c82afb5 (button) collected ($1.61)
Seat 2: Hero (small blind) folded before Flop
Seat 3: 45920dbc (big blind) folded before Flop
Seat 4: 966446c2 folded before Flop (didn't bet)
Seat 5: 40a91d41 folded before Flop (didn't bet)
Seat 6: 8c86f461 folded before Flop


Poker Hand #RC95097485: Hold'em No Limit ($0.1/$0.25) - 2020/04/07 15:43:34
Table 'RushAndCash365647' 6-max Seat #1 is the button
Seat 1: d1e73b0b ($9.29 in chips)
Seat 2: 3423a84d ($35.28 in chips)
Seat 3: 17388104 ($18.93 in chips)
Seat 4: 966446c2 ($32.71 in chips)
Seat 5: 3d05956 ($41.49 in chips)
Seat 6: Hero ($31.9 in chips)
3423a84d: posts small blind $0.1
17388104: posts big blind $0.25
*** HOLE CARDS ***
Dealt to d1e73b0b 
Dealt to 3423a84d 
Dealt to 17388104 
Dealt to 966446c2 
Dealt to 3d05956 
Dealt to Hero [8d 3h]
966446c2: folds
3d05956: folds
Hero: folds
d1e73b0b: folds
3423a84d: calls $0.15
17388104: checks
*** FLOP *** [Jc Ad Th]
3423a84d: bets $0.25
17388104: folds
Uncalled bet ($0.25) returned to 3423a84d
*** SHOWDOWN ***
3423a84d collected $0.5 from pot
*** SUMMARY ***
Total pot $0.5
Board [Jc Ad Th]
Seat 1: d1e73b0b (button) folded before Flop (didn't bet)
Seat 2: 3423a84d (small blind) won ($0.5)
Seat 3: 17388104 (big blind) folded on the Flop
Seat 4: 966446c2 folded before Flop (didn't bet)
Seat 5: 3d05956 folded before Flop (didn't bet)
Seat 6: Hero folded before Flop (didn't bet)


Poker Hand #RC95097574: Hold'em No Limit ($0.1/$0.25) - 2020/04/07 15:43:46
Table 'RushAndCash365659' 6-max Seat #1 is the button
Seat 1: 5b62270e ($27.92 in chips)
Seat 2: d3a18552 ($12.5 in chips)
Seat 3: d6f2a39c ($5.03 in chips)
Seat 4: 3f5f9735 ($18.63 in chips)
Seat 5: be711e9d ($39.46 in chips)
Seat 6: Hero ($31.9 in chips)
d3a18552: posts small blind $0.1
d6f2a39c: posts big blind $0.25
*** HOLE CARDS ***
Dealt to 5b62270e 
Dealt to d3a18552 
Dealt to d6f2a39c 
Dealt to 3f5f9735 
Dealt to be711e9d 
Dealt to Hero [As 3h]
3f5f9735: folds
be711e9d: folds
Hero: folds
5b62270e: folds
d3a18552: raises $0.38 to $0.63
d6f2a39c: folds
Uncalled bet ($0.38) returned to d3a18552
*** SHOWDOWN ***
d3a18552 collected $0.5 from pot
*** SUMMARY ***
Total pot $0.5
Seat 1: 5b62270e (button) folded before Flop (didn't bet)
Seat 2: d3a18552 (small blind) collected ($0.5)
Seat 3: d6f2a39c (big blind) folded before Flop
Seat 4: 3f5f9735 folded before Flop (didn't bet)
Seat 5: be711e9d folded before Flop (didn't bet)
Seat 6: Hero folded before Flop (didn't bet)


Poker Hand #RC95097639: Hold'em No Limit ($0.1/$0.25) - 2020/04/07 15:43:54
Table 'RushAndCash365668' 6-max Seat #1 is the button
Seat 1: e6fa23c9 ($12.07 in chips)
Seat 2: 2c82afb5 ($12.99 in chips)
Seat 3: ce59b684 ($25 in chips)
Seat 4: ecd599c ($12 in chips)
Seat 5: 3dafe47e ($12.5 in chips)
Seat 6: Hero ($31.9 in chips)
2c82afb5: posts small blind $0.1
ce59b684: posts big blind $0.25
*** HOLE CARDS ***
Dealt to e6fa23c9 
Dealt to 2c82afb5 
Dealt to ce59b684 
Dealt to ecd599c 
Dealt to 3dafe47e 
Dealt to Hero [8s 3h]
ecd599c: raises $0.25 to $0.5
3dafe47e: raises $1.9 to $2.4
Hero: folds
e6fa23c9: folds
2c82afb5: folds
ce59b684: folds
ecd599c: folds
Uncalled bet ($1.9) returned to 3dafe47e
*** SHOWDOWN ***
3dafe47e collected $1.35 from pot
*** SUMMARY ***
Total pot $1.35
Seat 1: e6fa23c9 (button) folded before Flop (didn't bet)
Seat 2: 2c82afb5 (small blind) folded before Flop
Seat 3: ce59b684 (big blind) folded before Flop
Seat 4: ecd599c folded before Flop
Seat 5: 3dafe47e collected ($1.35)
Seat 6: Hero folded before Flop (didn't bet)


Poker Hand #RC95097668: Hold'em No Limit ($0.1/$0.25) - 2020/04/07 15:43:59
Table 'RushAndCash365672' 6-max Seat #1 is the button
Seat 1: adb51d54 ($32.12 in chips)
Seat 2: d6f2a39c ($4.78 in chips)
Seat 3: fb4a5e69 ($25 in chips)
Seat 4: Hero ($31.9 in chips)
Seat 5: 62eebc49 ($120.62 in chips)
Seat 6: f178c62c ($27.53 in chips)
d6f2a39c: posts small blind $0.1
fb4a5e69: posts big blind $0.25
*** HOLE CARDS ***
Dealt to adb51d54 
Dealt to d6f2a39c 
Dealt to fb4a5e69 
Dealt to Hero [9d 5s]
Dealt to 62eebc49 
Dealt to f178c62c 
Hero: folds
62eebc49: raises $0.38 to $0.63
f178c62c: folds
adb51d54: folds
d6f2a39c: folds
fb4a5e69: folds
Uncalled bet ($0.38) returned to 62eebc49
*** SHOWDOWN ***
62eebc49 collected $0.6 from pot
*** SUMMARY ***
Total pot $0.6
Seat 1: adb51d54 (button) folded before Flop (didn't bet)
Seat 2: d6f2a39c (small blind) folded before Flop
Seat 3: fb4a5e69 (big blind) folded before Flop
Seat 4: Hero folded before Flop (didn't bet)
Seat 5: 62eebc49 collected ($0.6)
Seat 6: f178c62c folded before Flop (didn't bet)


Poker Hand #RC95097701: Hold'em No Limit ($0.1/$0.25) - 2020/04/07 15:44:02
Table 'RushAndCash365677' 6-max Seat #1 is the button
Seat 1: Hero ($31.9 in chips)
Seat 2: 289f2e46 ($26.34 in chips)
Seat 3: 3d05956 ($41.84 in chips)
Seat 4: 7bf7c8c9 ($25.35 in chips)
Seat 5: 36017ad1 ($36.31 in chips)
Seat 6: dc1d83ec ($25.67 in chips)
289f2e46: posts small blind $0.1
3d05956: posts big blind $0.25
*** HOLE CARDS ***
Dealt to Hero [Jd 7h]
Dealt to 289f2e46 
Dealt to 3d05956 
Dealt to 7bf7c8c9 
Dealt to 36017ad1 
Dealt to dc1d83ec 
7bf7c8c9: folds
36017ad1: folds
dc1d83ec: folds
Hero: folds
289f2e46: raises $0.5 to $0.75
3d05956: folds
Uncalled bet ($0.5) returned to 289f2e46
*** SHOWDOWN ***
289f2e46 collected $0.5 from pot
*** SUMMARY ***
Total pot $0.5
Seat 1: Hero (button) folded before Flop (didn't bet)
Seat 2: 289f2e46 (small blind) collected ($0.5)
Seat 3: 3d05956 (big blind) folded before Flop
Seat 4: 7bf7c8c9 folded before Flop (didn't bet)
Seat 5: 36017ad1 folded before Flop (didn't bet)
Seat 6: dc1d83ec folded before Flop (didn't bet)


Poker Hand #RC95097734: Hold'em No Limit ($0.1/$0.25) - 2020/04/07 15:44:06
Table 'RushAndCash365681' 6-max Seat #1 is the button
Seat 1: fc8a29ea ($57.95 in chips)
Seat 2: 6736194e ($23.53 in chips)
Seat 3: Hero ($31.9 in chips)
Seat 4: bc3db224 ($26.81 in chips)
Seat 5: 3423a84d ($35.76 in chips)
Seat 6: 366c47e0 ($5.93 in chips)
6736194e: posts small blind $0.1
Hero: posts big blind $0.25
*** HOLE CARDS ***
Dealt to fc8a29ea 
Dealt to 6736194e 
Dealt to Hero [Qc 8s]
Dealt to bc3db224 
Dealt to 3423a84d 
Dealt to 366c47e0 
bc3db224: folds
3423a84d: folds
366c47e0: folds
fc8a29ea: raises $0.38 to $0.63
6736194e: raises $1.57 to $2.2
Hero: folds
fc8a29ea: folds
Uncalled bet ($1.57) returned to 6736194e
*** SHOWDOWN ***
6736194e collected $1.51 from pot
*** SUMMARY ***
Total pot $1.51
Seat 1: fc8a29ea (button) folded before Flop
Seat 2: 6736194e (small blind) collected ($1.51)
Seat 3: Hero (big blind) folded before Flop
Seat 4: bc3db224 folded before Flop (didn't bet)
Seat 5: 3423a84d folded before Flop (didn't bet)
Seat 6: 366c47e0 folded before Flop (didn't bet)


Poker Hand #RC95097863: Hold'em No Limit ($0.1/$0.25) - 2020/04/07 15:44:22
Table 'RushAndCash365701' 6-max Seat #1 is the button
Seat 1: af84e661 ($7.52 in chips)
Seat 2: 32953d2a ($12.5 in chips)
Seat 3: ecd599c ($11.4 in chips)
Seat 4: da17c979 ($13.42 in chips)
Seat 5: Hero ($31.65 in chips)
Seat 6: fb4a5e69 ($25 in chips)
32953d2a: posts small blind $0.1
ecd599c: posts big blind $0.25
*** HOLE CARDS ***
Dealt to af84e661 
Dealt to 32953d2a 
Dealt to ecd599c 
Dealt to da17c979 
Dealt to Hero [Tc 3c]
Dealt to fb4a5e69 
da17c979: folds
Hero: folds
fb4a5e69: folds
af84e661: folds
32953d2a: folds
Uncalled bet ($0.15) returned to ecd599c
*** SHOWDOWN ***
ecd599c collected $0.2 from pot
*** SUMMARY ***
Total pot $0.2
Seat 1: af84e661 (button) folded before Flop (didn't bet)
Seat 2: 32953d2a (small blind) folded before Flop
Seat 3: ecd599c (big blind) collected ($0.2)
Seat 4: da17c979 folded before Flop (didn't bet)
Seat 5: Hero folded before Flop (didn't bet)
Seat 6: fb4a5e69 folded before Flop (didn't bet)


Poker Hand #RC95097927: Hold'em No Limit ($0.1/$0.25) - 2020/04/07 15:44:30
Table 'RushAndCash365711' 6-max Seat #1 is the button
Seat 1: 966446c2 ($32.71 in chips)
Seat 2: Hero ($31.65 in chips)
Seat 3: decd88e2 ($29.08 in chips)
Seat 4: fb4a5e69 ($25 in chips)
Seat 5: da17c979 ($13.42 in chips)
Seat 6: 89387862 ($28.65 in chips)
Hero: posts small blind $0.1
decd88e2: posts big blind $0.25
*** HOLE CARDS ***
Dealt to 966446c2 
Dealt to Hero [8h 8d]
Dealt to decd88e2 
Dealt to fb4a5e69 
Dealt to da17c979 
Dealt to 89387862 
fb4a5e69: folds
da17c979: raises $0.38 to $0.63
89387862: folds
966446c2: folds
Hero: calls $0.53
decd88e2: folds
*** FLOP *** [Qc Qd 7s]
Hero: checks
da17c979: checks
*** TURN *** [Qc Qd 7s] [Kc]
Hero: checks
da17c979: checks
*** RIVER *** [Qc Qd 7s Kc] [Ac]
Hero: checks
da17c979: checks
Hero: shows [8h 8d] (Pair of Queens and Pair of Eights)
da17c979: shows [Th Tc] (Pair of Queens and Pair of Tens)
*** SHOWDOWN ***
da17c979 collected $1.51 from pot
*** SUMMARY ***
Total pot $1.51
Board [Qc Qd 7s Kc Ac]
Seat 1: 966446c2 (button) folded before Flop (didn't bet)
Seat 2: Hero (small blind) showed [8h 8d] and lost with Pair of Queens and Pair of Eights
Seat 3: decd88e2 (big blind) folded before Flop
Seat 4: fb4a5e69 folded before Flop (didn't bet)
Seat 5: da17c979 showed [Th Tc] and won ($1.51) with Pair of Queens and Pair of Tens
Seat 6: 89387862 folded before Flop (didn't bet)


Poker Hand #RC95098210: Hold'em No Limit ($0.1/$0.25) - 2020/04/07 15:45:07
Table 'RushAndCash365749' 6-max Seat #1 is the button
Seat 1: be3950eb ($27.23 in chips)
Seat 2: 65837850 ($126.11 in chips)
Seat 3: 40a91d41 ($27.04 in chips)
Seat 4: Hero ($31.02 in chips)
Seat 5: da17c979 ($14.23 in chips)
Seat 6: 9f138297 ($28.83 in chips)
65837850: posts small blind $0.1
40a91d41: posts big blind $0.25
*** HOLE CARDS ***
Dealt to be3950eb 
Dealt to 65837850 
Dealt to 40a91d41 
Dealt to Hero [9c 6c]
Dealt to da17c979 
Dealt to 9f138297 
Hero: folds
da17c979: raises $0.38 to $0.63
9f138297: folds
be3950eb: folds
65837850: folds
40a91d41: calls $0.38
*** FLOP *** [Td 4s Th]
40a91d41: checks
da17c979: checks
*** TURN *** [Td 4s Th] [Tc]
40a91d41: checks
da17c979: checks
*** RIVER *** [Td 4s Th Tc] [2s]
40a91d41: checks
da17c979: checks
40a91d41: shows [3h Kh] (Three Tens)
da17c979: shows [Ad Qc] (Three Tens)
*** SHOWDOWN ***
da17c979 collected $1.36 from pot
*** SUMMARY ***
Total pot $1.36
Board [Td 4s Th Tc 2s]
Seat 1: be3950eb (button) folded before Flop (didn't bet)
Seat 2: 65837850 (small blind) folded before Flop
Seat 3: 40a91d41 (big blind) showed [Kh 3h] and lost with Three Tens
Seat 4: Hero folded before Flop (didn't bet)
Seat 5: da17c979 showed [Ad Qc] and won ($1.36) with Three Tens
Seat 6: 9f138297 folded before Flop (didn't bet)


Poker Hand #RC95098240: Hold'em No Limit ($0.1/$0.25) - 2020/04/07 15:45:12
Table 'RushAndCash365753' 6-max Seat #1 is the button
Seat 1: Hero ($31.02 in chips)
Seat 2: 32953d2a ($12.5 in chips)
Seat 3: 9c76a6c2 ($27.44 in chips)
Seat 4: 51c60a1c ($8.39 in chips)
Seat 5: 2c82afb5 ($12.99 in chips)
Seat 6: d9a04cfb ($30.1 in chips)
32953d2a: posts small blind $0.1
9c76a6c2: posts big blind $0.25
*** HOLE CARDS ***
Dealt to Hero [As 3d]
Dealt to 32953d2a 
Dealt to 9c76a6c2 
Dealt to 51c60a1c 
Dealt to 2c82afb5 
Dealt to d9a04cfb 
51c60a1c: folds
2c82afb5: folds
d9a04cfb: folds
Hero: folds
32953d2a: raises $0.5 to $0.75
9c76a6c2: raises $1.5 to $2.25
32953d2a: raises $10.25 to $12.5 and is all-in
9c76a6c2: calls $10.25
32953d2a: shows [Qh Qc]
9c76a6c2: shows [Ts Tc]
*** FLOP *** [5c 4s 8h]
*** TURN *** [5c 4s 8h] [Th]
*** RIVER *** [5c 4s 8h Th] [4d]
*** SHOWDOWN ***
9c76a6c2 collected $25 from pot
*** SUMMARY ***
Total pot $25
Board [5c 4s 8h Th 4d]
Seat 1: Hero (button) folded before Flop (didn't bet)
Seat 2: 32953d2a (small blind) showed [Qh Qc] and lost with Pair of Queens and Pair of Fours
Seat 3: 9c76a6c2 (big blind) showed [Ts Tc] and won ($25) with Tens Full over Fours
Seat 4: 51c60a1c folded before Flop (didn't bet)
Seat 5: 2c82afb5 folded before Flop (didn't bet)
Seat 6: d9a04cfb folded before Flop (didn't bet)


Poker Hand #RC95098284: Hold'em No Limit ($0.1/$0.25) - 2020/04/07 15:45:17
Table 'RushAndCash365758' 6-max Seat #1 is the button
Seat 1: 2dd038c3 ($8.86 in chips)
Seat 2: 57ff778 ($25 in chips)
Seat 3: b56c4622 ($19.4 in chips)
Seat 4: Hero ($31.02 in chips)
Seat 5: 47b5d422 ($11.65 in chips)
Seat 6: 4aa8d4e8 ($12.5 in chips)
57ff778: posts small blind $0.1
b56c4622: posts big blind $0.25
*** HOLE CARDS ***
Dealt to 2dd038c3 
Dealt to 57ff778 
Dealt to b56c4622 
Dealt to Hero [8h 3c]
Dealt to 47b5d422 
Dealt to 4aa8d4e8 
Hero: folds
47b5d422: folds
4aa8d4e8: folds
2dd038c3: folds
57ff778: calls $0.15
b56c4622: checks
*** FLOP *** [8d As 4h]
57ff778: bets $0.25
b56c4622: folds
Uncalled bet ($0.25) returned to 57ff778
*** SHOWDOWN ***
57ff778 collected $0.5 from pot
*** SUMMARY ***
Total pot $0.5
Board [8d As 4h]
Seat 1: 2dd038c3 (button) folded before Flop (didn't bet)
Seat 2: 57ff778 (small blind) won ($0.5)
Seat 3: b56c4622 (big blind) folded on the Flop
Seat 4: Hero folded before Flop (didn't bet)
Seat 5: 47b5d422 folded before Flop (didn't bet)
Seat 6: 4aa8d4e8 folded before Flop (didn't bet)


Poker Hand #RC95098313: Hold'em No Limit ($0.1/$0.25) - 2020/04/07 15:45:21
Table 'RushAndCash365762' 6-max Seat #1 is the button
Seat 1: f178c62c ($25.65 in chips)
Seat 2: 289f2e46 ($50.69 in chips)
Seat 3: Hero ($31.02 in chips)
Seat 4: 89387862 ($28.3 in chips)
Seat 5: 47b5d422 ($11.65 in chips)
Seat 6: 4dd920ba ($81.85 in chips)
289f2e46: posts small blind $0.1
Hero: posts big blind $0.25
*** HOLE CARDS ***
Dealt to f178c62c 
Dealt to 289f2e46 
Dealt to Hero [Qd 5d]
Dealt to 89387862 
Dealt to 47b5d422 
Dealt to 4dd920ba 
89387862: folds
47b5d422: folds
4dd920ba: folds
f178c62c: folds
289f2e46: raises $0.5 to $0.75
Hero: folds
Uncalled bet ($0.5) returned to 289f2e46
*** SHOWDOWN ***
289f2e46 collected $0.5 from pot
*** SUMMARY ***
Total pot $0.5
Seat 1: f178c62c (button) folded before Flop (didn't bet)
Seat 2: 289f2e46 (small blind) collected ($0.5)
Seat 3: Hero (big blind) folded before Flop
Seat 4: 89387862 folded before Flop (didn't bet)
Seat 5: 47b5d422 folded before Flop (didn't bet)
Seat 6: 4dd920ba folded before Flop (didn't bet)


Poker Hand #RC95098337: Hold'em No Limit ($0.1/$0.25) - 2020/04/07 15:45:25
Table 'RushAndCash365767' 6-max Seat #1 is the button
Seat 1: Hero ($30.77 in chips)
Seat 2: 103129d8 ($21.96 in chips)
Seat 3: bda1b4ce ($32.39 in chips)
Seat 4: af84e661 ($7.17 in chips)
Seat 5: bc3db224 ($27.72 in chips)
Seat 6: 6185872b ($13.29 in chips)
103129d8: posts small blind $0.1
bda1b4ce: posts big blind $0.25
*** HOLE CARDS ***
Dealt to Hero [Qd 4d]
Dealt to 103129d8 
Dealt to bda1b4ce 
Dealt to af84e661 
Dealt to bc3db224 
Dealt to 6185872b 
af84e661: folds
bc3db224: folds
6185872b: raises $0.54 to $0.79
Hero: folds
103129d8: raises $1.91 to $2.7
bda1b4ce: folds
6185872b: folds
Uncalled bet ($1.91) returned to 103129d8
*** SHOWDOWN ***
103129d8 collected $1.83 from pot
*** SUMMARY ***
Total pot $1.83
Seat 1: Hero (button) folded before Flop (didn't bet)
Seat 2: 103129d8 (small blind) collected ($1.83)
Seat 3: bda1b4ce (big blind) folded before Flop
Seat 4: af84e661 folded before Flop (didn't bet)
Seat 5: bc3db224 folded before Flop (didn't bet)
Seat 6: 6185872b folded before Flop


Poker Hand #RC95098413: Hold'em No Limit ($0.1/$0.25) - 2020/04/07 15:45:37
Table 'RushAndCash365781' 6-max Seat #1 is the button
Seat 1: 47b5d422 ($11.3 in chips)
Seat 2: bb849ffc ($12.86 in chips)
Seat 3: 966446c2 ($31.16 in chips)
Seat 4: 6bf543f8 ($25 in chips)
Seat 5: 289f2e46 ($50.94 in chips)
Seat 6: Hero ($30.77 in chips)
bb849ffc: posts small blind $0.1
966446c2: posts big blind $0.25
*** HOLE CARDS ***
Dealt to 47b5d422 
Dealt to bb849ffc 
Dealt to 966446c2 
Dealt to 6bf543f8 
Dealt to 289f2e46 
Dealt to Hero [As Ts]
6bf543f8: folds
289f2e46: folds
Hero: raises $0.38 to $0.63
47b5d422: folds
bb849ffc: folds
966446c2: folds
Uncalled bet ($0.38) returned to Hero
*** SHOWDOWN ***
Hero collected $0.6 from pot
*** SUMMARY ***
Total pot $0.6
Seat 1: 47b5d422 (button) folded before Flop (didn't bet)
Seat 2: bb849ffc (small blind) folded before Flop
Seat 3: 966446c2 (big blind) folded before Flop
Seat 4: 6bf543f8 folded before Flop (didn't bet)
Seat 5: 289f2e46 folded before Flop (didn't bet)
Seat 6: Hero collected ($0.6)


Poker Hand #RC95098516: Hold'em No Limit ($0.1/$0.25) - 2020/04/07 15:45:51
Table 'RushAndCash365795' 6-max Seat #1 is the button
Seat 1: 37ae2dd7 ($29.42 in chips)
Seat 2: a5268365 ($26.94 in chips)
Seat 3: Hero ($31.12 in chips)
Seat 4: adb51d54 ($25 in chips)
Seat 5: 811232a3 ($31.57 in chips)
Seat 6: 8c86f461 ($29.3 in chips)
a5268365: posts small blind $0.1
Hero: posts big blind $0.25
*** HOLE CARDS ***
Dealt to 37ae2dd7 
Dealt to a5268365 
Dealt to Hero [Ad 7d]
Dealt to adb51d54 
Dealt to 811232a3 
Dealt to 8c86f461 
adb51d54: folds
811232a3: folds
8c86f461: raises $0.38 to $0.63
37ae2dd7: raises $1.63 to $2.26
a5268365: calls $2.16
Hero: folds
8c86f461: calls $1.63
*** FLOP *** [Jd Ac 4c]
a5268365: checks
8c86f461: checks
37ae2dd7: checks
*** TURN *** [Jd Ac 4c] [5c]
a5268365: checks
8c86f461: bets $4.2
37ae2dd7: folds
a5268365: folds
Uncalled bet ($4.2) returned to 8c86f461
*** SHOWDOWN ***
8c86f461 collected $7.03 from pot
*** SUMMARY ***
Total pot $7.03
Board [Jd Ac 4c 5c]
Seat 1: 37ae2dd7 (button) folded on the Turn
Seat 2: a5268365 (small blind) folded on the Turn
Seat 3: Hero (big blind) folded before Flop
Seat 4: adb51d54 folded before Flop (didn't bet)
Seat 5: 811232a3 folded before Flop (didn't bet)
Seat 6: 8c86f461 won ($7.03)


Poker Hand #RC95098696: Hold'em No Limit ($0.1/$0.25) - 2020/04/07 15:46:13
Table 'RushAndCash365822' 6-max Seat #1 is the button
Seat 1: fc8a29ea ($57.8 in chips)
Seat 2: da17c979 ($14.65 in chips)
Seat 3: b56c4622 ($18.8 in chips)
Seat 4: a0d04110 ($78.19 in chips)
Seat 5: Hero ($30.87 in chips)
Seat 6: bdffd813 ($25.07 in chips)
da17c979: posts small blind $0.1
b56c4622: posts big blind $0.25
*** HOLE CARDS ***
Dealt to fc8a29ea 
Dealt to da17c979 
Dealt to b56c4622 
Dealt to a0d04110 
Dealt to Hero [9c 7c]
Dealt to bdffd813 
a0d04110: folds
Hero: folds
bdffd813: folds
fc8a29ea: raises $0.38 to $0.63
da17c979: folds
b56c4622: calls $0.38
*** FLOP *** [Jd 3s Ts]
b56c4622: checks
fc8a29ea: checks
*** TURN *** [Jd 3s Ts] [Ad]
b56c4622: bets $0.7
fc8a29ea: folds
Uncalled bet ($0.7) returned to b56c4622
*** SHOWDOWN ***
b56c4622 collected $1.36 from pot
*** SUMMARY ***
Total pot $1.36
Board [Jd 3s Ts Ad]
Seat 1: fc8a29ea (button) folded on the Turn
Seat 2: da17c979 (small blind) folded before Flop
Seat 3: b56c4622 (big blind) won ($1.36)
Seat 4: a0d04110 folded before Flop (didn't bet)
Seat 5: Hero folded before Flop (didn't bet)
Seat 6: bdffd813 folded before Flop (didn't bet)


Poker Hand #RC95098728: Hold'em No Limit ($0.1/$0.25) - 2020/04/07 15:46:17
Table 'RushAndCash365827' 6-max Seat #1 is the button
Seat 1: 4dd920ba ($82.42 in chips)
Seat 2: 30b2e4b4 ($10.97 in chips)
Seat 3: adb51d54 ($25 in chips)
Seat 4: Hero ($30.87 in chips)
Seat 5: cf91ce53 ($27.47 in chips)
Seat 6: 9f138297 ($28.58 in chips)
30b2e4b4: posts small blind $0.1
adb51d54: posts big blind $0.25
*** HOLE CARDS ***
Dealt to 4dd920ba 
Dealt to 30b2e4b4 
Dealt to adb51d54 
Dealt to Hero [Jh 4s]
Dealt to cf91ce53 
Dealt to 9f138297 
Hero: folds
cf91ce53: folds
9f138297: raises $0.25 to $0.5
4dd920ba: folds
30b2e4b4: calls $0.4
adb51d54: calls $0.25
*** FLOP *** [Kc 6d Ac]
30b2e4b4: checks
adb51d54: checks
9f138297: checks
*** TURN *** [Kc 6d Ac] [7d]
30b2e4b4: checks
adb51d54: bets $2
9f138297: folds
30b2e4b4: folds
Uncalled bet ($2) returned to adb51d54
*** SHOWDOWN ***
adb51d54 collected $1.5 from pot
*** SUMMARY ***
Total pot $1.5
Board [Kc 6d Ac 7d]
Seat 1: 4dd920ba (button) folded before Flop (didn't bet)
Seat 2: 30b2e4b4 (small blind) folded on the Turn
Seat 3: adb51d54 (big blind) won ($1.5)
Seat 4: Hero folded before Flop (didn't bet)
Seat 5: cf91ce53 folded before Flop (didn't bet)
Seat 6: 9f138297 folded on the Turn


Poker Hand #RC95098762: Hold'em No Limit ($0.1/$0.25) - 2020/04/07 15:46:21
Table 'RushAndCash365832' 6-max Seat #1 is the button
Seat 1: b5d592d2 ($13.22 in chips)
Seat 2: Hero ($30.87 in chips)
Seat 3: a4ba858f ($38.17 in chips)
Seat 4: a0d04110 ($78.19 in chips)
Seat 5: dbf6981f ($63.77 in chips)
Seat 6: fe3f48f4 ($27.31 in chips)
Hero: posts small blind $0.1
a4ba858f: posts big blind $0.25
*** HOLE CARDS ***
Dealt to b5d592d2 
Dealt to Hero [Ts 9h]
Dealt to a4ba858f 
Dealt to a0d04110 
Dealt to dbf6981f 
Dealt to fe3f48f4 
a0d04110: folds
dbf6981f: raises $0.38 to $0.63
fe3f48f4: raises $1.37 to $2
b5d592d2: folds
Hero: folds
a4ba858f: folds
dbf6981f: folds
Uncalled bet ($1.37) returned to fe3f48f4
*** SHOWDOWN ***
fe3f48f4 collected $1.61 from pot
*** SUMMARY ***
Total pot $1.61
Seat 1: b5d592d2 (button) folded before Flop (didn't bet)
Seat 2: Hero (small blind) folded before Flop
Seat 3: a4ba858f (big blind) folded before Flop
Seat 4: a0d04110 folded before Flop (didn't bet)
Seat 5: dbf6981f folded before Flop
Seat 6: fe3f48f4 collected ($1.61)


Poker Hand #RC95098795: Hold'em No Limit ($0.1/$0.25) - 2020/04/07 15:46:25
Table 'RushAndCash365836' 6-max Seat #1 is the button
Seat 1: 1cf2736e ($25 in chips)
Seat 2: bad0409c ($15.43 in chips)
Seat 3: 403fa816 ($12.69 in chips)
Seat 4: 3d05956 ($41.84 in chips)
Seat 5: 8004b155 ($6.23 in chips)
Seat 6: Hero ($30.77 in chips)
bad0409c: posts small blind $0.1
403fa816: posts big blind $0.25
*** HOLE CARDS ***
Dealt to 1cf2736e 
Dealt to bad0409c 
Dealt to 403fa816 
Dealt to 3d05956 
Dealt to 8004b155 
Dealt to Hero [8d 6s]
3d05956: folds
8004b155: folds
Hero: folds
1cf2736e: folds
bad0409c: folds
Uncalled bet ($0.15) returned to 403fa816
*** SHOWDOWN ***
403fa816 collected $0.2 from pot
*** SUMMARY ***
Total pot $0.2
Seat 1: 1cf2736e (button) folded before Flop (didn't bet)
Seat 2: bad0409c (small blind) folded before Flop
Seat 3: 403fa816 (big blind) collected ($0.2)
Seat 4: 3d05956 folded before Flop (didn't bet)
Seat 5: 8004b155 folded before Flop (didn't bet)
Seat 6: Hero folded before Flop (didn't bet)


Poker Hand #RC95098903: Hold'em No Limit ($0.1/$0.25) - 2020/04/07 15:46:38
Table 'RushAndCash365849' 6-max Seat #1 is the button
Seat 1: Hero ($30.77 in chips)
Seat 2: b58bfe0f ($27.97 in chips)
Seat 3: 36017ad1 ($42.33 in chips)
Seat 4: d07b3de1 ($32.7 in chips)
Seat 5: 3cfd7308 ($51.36 in chips)
Seat 6: a0d04110 ($78.19 in chips)
b58bfe0f: posts small blind $0.1
36017ad1: posts big blind $0.25
*** HOLE CARDS ***
Dealt to Hero [Qs 6s]
Dealt to b58bfe0f 
Dealt to 36017ad1 
Dealt to d07b3de1 
Dealt to 3cfd7308 
Dealt to a0d04110 
d07b3de1: folds
3cfd7308: folds
a0d04110: raises $0.38 to $0.63
Hero: folds
b58bfe0f: folds
36017ad1: folds
Uncalled bet ($0.38) returned to a0d04110
*** SHOWDOWN ***
a0d04110 collected $0.6 from pot
*** SUMMARY ***
Total pot $0.6
Seat 1: Hero (button) folded before Flop (didn't bet)
Seat 2: b58bfe0f (small blind) folded before Flop
Seat 3: 36017ad1 (big blind) folded before Flop
Seat 4: d07b3de1 folded before Flop (didn't bet)
Seat 5: 3cfd7308 folded before Flop (didn't bet)
Seat 6: a0d04110 collected ($0.6)


Poker Hand #RC95098991: Hold'em No Limit ($0.1/$0.25) - 2020/04/07 15:46:49
Table 'RushAndCash365861' 6-max Seat #1 is the button
Seat 1: d07b3de1 ($32.7 in chips)
Seat 2: 8c4d6eff ($35.33 in chips)
Seat 3: 3dafe47e ($14.89 in chips)
Seat 4: 30cab83a ($42.52 in chips)
Seat 5: Hero ($30.77 in chips)
Seat 6: 5794e88f ($35.9 in chips)
8c4d6eff: posts small blind $0.1
3dafe47e: posts big blind $0.25
*** HOLE CARDS ***
Dealt to d07b3de1 
Dealt to 8c4d6eff 
Dealt to 3dafe47e 
Dealt to 30cab83a 
Dealt to Hero [8c 7d]
Dealt to 5794e88f 
30cab83a: folds
Hero: folds
5794e88f: folds
d07b3de1: raises $0.25 to $0.5
8c4d6eff: folds
3dafe47e: folds
Uncalled bet ($0.25) returned to d07b3de1
*** SHOWDOWN ***
d07b3de1 collected $0.6 from pot
*** SUMMARY ***
Total pot $0.6
Seat 1: d07b3de1 (button) collected ($0.6)
Seat 2: 8c4d6eff (small blind) folded before Flop
Seat 3: 3dafe47e (big blind) folded before Flop
Seat 4: 30cab83a folded before Flop (didn't bet)
Seat 5: Hero folded before Flop (didn't bet)
Seat 6: 5794e88f folded before Flop (didn't bet)


Poker Hand #RC95099025: Hold'em No Limit ($0.1/$0.25) - 2020/04/07 15:46:53
Table 'RushAndCash365866' 6-max Seat #1 is the button
Seat 1: cdd7700a ($12.5 in chips)
Seat 2: b56c4622 ($19.47 in chips)
Seat 3: 4dd920ba ($82.32 in chips)
Seat 4: acf1a889 ($22.5 in chips)
Seat 5: 492c0086 ($14.42 in chips)
Seat 6: Hero ($30.77 in chips)
b56c4622: posts small blind $0.1
4dd920ba: posts big blind $0.25
*** HOLE CARDS ***
Dealt to cdd7700a 
Dealt to b56c4622 
Dealt to 4dd920ba 
Dealt to acf1a889 
Dealt to 492c0086 
Dealt to Hero [Qc 9h]
acf1a889: folds
492c0086: folds
Hero: folds
cdd7700a: folds
b56c4622: folds
Uncalled bet ($0.15) returned to 4dd920ba
*** SHOWDOWN ***
4dd920ba collected $0.2 from pot
*** SUMMARY ***
Total pot $0.2
Seat 1: cdd7700a (button) folded before Flop (didn't bet)
Seat 2: b56c4622 (small blind) folded before Flop
Seat 3: 4dd920ba (big blind) collected ($0.2)
Seat 4: acf1a889 folded before Flop (didn't bet)
Seat 5: 492c0086 folded before Flop (didn't bet)
Seat 6: Hero folded before Flop (didn't bet)


Poker Hand #RC95099114: Hold'em No Limit ($0.1/$0.25) - 2020/04/07 15:47:04
Table 'RushAndCash365879' 6-max Seat #1 is the button
Seat 1: d2986703 ($39.72 in chips)
Seat 2: 22be9faa ($17.48 in chips)
Seat 3: 811232a3 ($38.81 in chips)
Seat 4: ce59b684 ($26.21 in chips)
Seat 5: Hero ($30.77 in chips)
Seat 6: 8c4d6eff ($35.23 in chips)
22be9faa: posts small blind $0.1
811232a3: posts big blind $0.25
*** HOLE CARDS ***
Dealt to d2986703 
Dealt to 22be9faa 
Dealt to 811232a3 
Dealt to ce59b684 
Dealt to Hero [Tc 3h]
Dealt to 8c4d6eff 
ce59b684: folds
Hero: folds
8c4d6eff: raises $0.38 to $0.63
d2986703: folds
22be9faa: folds
811232a3: raises $1.37 to $2
8c4d6eff: raises $4.1 to $6.1
811232a3: folds
Uncalled bet ($4.1) returned to 8c4d6eff
*** SHOWDOWN ***
8c4d6eff collected $4.1 from pot
*** SUMMARY ***
Total pot $4.1
Seat 1: d2986703 (button) folded before Flop (didn't bet)
Seat 2: 22be9faa (small blind) folded before Flop
Seat 3: 811232a3 (big blind) folded before Flop
Seat 4: ce59b684 folded before Flop (didn't bet)
Seat 5: Hero folded before Flop (didn't bet)
Seat 6: 8c4d6eff collected ($4.1)


Poker Hand #RC95099146: Hold'em No Limit ($0.1/$0.25) - 2020/04/07 15:47:08
Table 'RushAndCash365884' 6-max Seat #1 is the button
Seat 1: 22be9faa ($17.38 in chips)
Seat 2: adb51d54 ($25.93 in chips)
Seat 3: Hero ($30.77 in chips)
Seat 4: 4dd920ba ($82.42 in chips)
Seat 5: 9f138297 ($28.08 in chips)
Seat 6: 7bf7c8c9 ($28.69 in chips)
adb51d54: posts small blind $0.1
Hero: posts big blind $0.25
*** HOLE CARDS ***
Dealt to 22be9faa 
Dealt to adb51d54 
Dealt to Hero [Kd 5c]
Dealt to 4dd920ba 
Dealt to 9f138297 
Dealt to 7bf7c8c9 
4dd920ba: folds
9f138297: folds
7bf7c8c9: folds
22be9faa: folds
adb51d54: folds
Uncalled bet ($0.15) returned to Hero
*** SHOWDOWN ***
Hero collected $0.2 from pot
*** SUMMARY ***
Total pot $0.2
Seat 1: 22be9faa (button) folded before Flop (didn't bet)
Seat 2: adb51d54 (small blind) folded before Flop
Seat 3: Hero (big blind) collected ($0.2)
Seat 4: 4dd920ba folded before Flop (didn't bet)
Seat 5: 9f138297 folded before Flop (didn't bet)
Seat 6: 7bf7c8c9 folded before Flop (didn't bet)


Poker Hand #RC95099181: Hold'em No Limit ($0.1/$0.25) - 2020/04/07 15:47:12
Table 'RushAndCash365889' 6-max Seat #1 is the button
Seat 1: b5d592d2 ($12.97 in chips)
Seat 2: Hero ($30.52 in chips)
Seat 3: 51c60a1c ($6.57 in chips)
Seat 4: 8c86f461 ($33.72 in chips)
Seat 5: 62eebc49 ($120.04 in chips)
Seat 6: 4ab4e4a3 ($25 in chips)
Hero: posts small blind $0.1
51c60a1c: posts big blind $0.25
*** HOLE CARDS ***
Dealt to b5d592d2 
Dealt to Hero [8d 4c]
Dealt to 51c60a1c 
Dealt to 8c86f461 
Dealt to 62eebc49 
Dealt to 4ab4e4a3 
8c86f461: folds
62eebc49: folds
4ab4e4a3: folds
b5d592d2: folds
Hero: folds
Uncalled bet ($0.15) returned to 51c60a1c
*** SHOWDOWN ***
51c60a1c collected $0.2 from pot
*** SUMMARY ***
Total pot $0.2
Seat 1: b5d592d2 (button) folded before Flop (didn't bet)
Seat 2: Hero (small blind) folded before Flop
Seat 3: 51c60a1c (big blind) collected ($0.2)
Seat 4: 8c86f461 folded before Flop (didn't bet)
Seat 5: 62eebc49 folded before Flop (didn't bet)
Seat 6: 4ab4e4a3 folded before Flop (didn't bet)


Poker Hand #RC95099211: Hold'em No Limit ($0.1/$0.25) - 2020/04/07 15:47:16
Table 'RushAndCash365893' 6-max Seat #1 is the button
Seat 1: Hero ($30.42 in chips)
Seat 2: 9f138297 ($28.08 in chips)
Seat 3: dbf6981f ($62.94 in chips)
Seat 4: 98ddea23 ($35.64 in chips)
Seat 5: 5794e88f ($35.8 in chips)
Seat 6: d3a18552 ($12.5 in chips)
9f138297: posts small blind $0.1
dbf6981f: posts big blind $0.25
*** HOLE CARDS ***
Dealt to Hero [6c 2s]
Dealt to 9f138297 
Dealt to dbf6981f 
Dealt to 98ddea23 
Dealt to 5794e88f 
Dealt to d3a18552 
98ddea23: folds
5794e88f: folds
d3a18552: folds
Hero: folds
9f138297: folds
Uncalled bet ($0.15) returned to dbf6981f
*** SHOWDOWN ***
dbf6981f collected $0.2 from pot
*** SUMMARY ***
Total pot $0.2
Seat 1: Hero (button) folded before Flop (didn't bet)
Seat 2: 9f138297 (small blind) folded before Flop
Seat 3: dbf6981f (big blind) collected ($0.2)
Seat 4: 98ddea23 folded before Flop (didn't bet)
Seat 5: 5794e88f folded before Flop (didn't bet)
Seat 6: d3a18552 folded before Flop (didn't bet)


Poker Hand #RC95099250: Hold'em No Limit ($0.1/$0.25) - 2020/04/07 15:47:20
Table 'RushAndCash365899' 6-max Seat #1 is the button
Seat 1: 98ddea23 ($35.64 in chips)
Seat 2: 966446c2 ($30.91 in chips)
Seat 3: d936f9ac ($15 in chips)
Seat 4: 5d2a310d ($3.37 in chips)
Seat 5: Hero ($30.42 in chips)
Seat 6: e2516f28 ($25 in chips)
966446c2: posts small blind $0.1
d936f9ac: posts big blind $0.25
*** HOLE CARDS ***
Dealt to 98ddea23 
Dealt to 966446c2 
Dealt to d936f9ac 
Dealt to 5d2a310d 
Dealt to Hero [9c 6h]
Dealt to e2516f28 
5d2a310d: folds
Hero: folds
e2516f28: folds
98ddea23: folds
966446c2: raises $0.5 to $0.75
d936f9ac: folds
Uncalled bet ($0.5) returned to 966446c2
*** SHOWDOWN ***
966446c2 collected $0.5 from pot
*** SUMMARY ***
Total pot $0.5
Seat 1: 98ddea23 (button) folded before Flop (didn't bet)
Seat 2: 966446c2 (small blind) collected ($0.5)
Seat 3: d936f9ac (big blind) folded before Flop
Seat 4: 5d2a310d folded before Flop (didn't bet)
Seat 5: Hero folded before Flop (didn't bet)
Seat 6: e2516f28 folded before Flop (didn't bet)


Poker Hand #RC95099289: Hold'em No Limit ($0.1/$0.25) - 2020/04/07 15:47:25
Table 'RushAndCash365905' 6-max Seat #1 is the button
Seat 1: b56c4622 ($19.72 in chips)
Seat 2: 32953d2a ($12.5 in chips)
Seat 3: Hero ($30.77 in chips)
Seat 4: ac90cf4e ($12.34 in chips)
Seat 5: 74937d40 ($36.9 in chips)
Seat 6: e2516f28 ($25 in chips)
32953d2a: posts small blind $0.1
Hero: posts big blind $0.25
*** HOLE CARDS ***
Dealt to b56c4622 
Dealt to 32953d2a 
Dealt to Hero [Ks 6s]
Dealt to ac90cf4e 
Dealt to 74937d40 
Dealt to e2516f28 
ac90cf4e: folds
74937d40: raises $0.38 to $0.63
e2516f28: folds
b56c4622: folds
32953d2a: folds
Hero: folds
Uncalled bet ($0.38) returned to 74937d40
*** SHOWDOWN ***
74937d40 collected $0.6 from pot
*** SUMMARY ***
Total pot $0.6
Seat 1: b56c4622 (button) folded before Flop (didn't bet)
Seat 2: 32953d2a (small blind) folded before Flop
Seat 3: Hero (big blind) folded before Flop
Seat 4: ac90cf4e folded before Flop (didn't bet)
Seat 5: 74937d40 collected ($0.6)
Seat 6: e2516f28 folded before Flop (didn't bet)


Poker Hand #RC95099403: Hold'em No Limit ($0.1/$0.25) - 2020/04/07 15:47:39
Table 'RushAndCash365919' 6-max Seat #1 is the button
Seat 1: 6736194e ($23.28 in chips)
Seat 2: 98ddea23 ($35.39 in chips)
Seat 3: 4c077ac6 ($12 in chips)
Seat 4: 6f1c538f ($24.37 in chips)
Seat 5: b5d592d2 ($12.97 in chips)
Seat 6: Hero ($30.52 in chips)
98ddea23: posts small blind $0.1
4c077ac6: posts big blind $0.25
*** HOLE CARDS ***
Dealt to 6736194e 
Dealt to 98ddea23 
Dealt to 4c077ac6 
Dealt to 6f1c538f 
Dealt to b5d592d2 
Dealt to Hero [Js Jd]
6f1c538f: folds
b5d592d2: folds
Hero: raises $0.38 to $0.63
6736194e: calls $0.63
98ddea23: folds
4c077ac6: calls $0.38
*** FLOP *** [7d Ac Ad]
4c077ac6: checks
Hero: bets $0.7
6736194e: calls $0.7
4c077ac6: folds
*** TURN *** [7d Ac Ad] [Kh]
Hero: bets $2.6
6736194e: calls $2.6
*** RIVER *** [7d Ac Ad Kh] [5d]
Hero: checks
6736194e: bets $4.3
Hero: folds
Uncalled bet ($4.3) returned to 6736194e
*** SHOWDOWN ***
6736194e collected $8.59 from pot
*** SUMMARY ***
Total pot $8.59
Board [7d Ac Ad Kh 5d]
Seat 1: 6736194e (button) won ($8.59)
Seat 2: 98ddea23 (small blind) folded before Flop
Seat 3: 4c077ac6 (big blind) folded on the Flop
Seat 4: 6f1c538f folded before Flop (didn't bet)
Seat 5: b5d592d2 folded before Flop (didn't bet)
Seat 6: Hero folded on the River


Poker Hand #RC95099880: Hold'em No Limit ($0.1/$0.25) - 2020/04/07 15:48:37
Table 'RushAndCash365977' 6-max Seat #1 is the button
Seat 1: 7c935d24 ($25.7 in chips)
Seat 2: 6185872b ($10.25 in chips)
Seat 3: 6736194e ($27.26 in chips)
Seat 4: 9f138297 ($29.28 in chips)
Seat 5: cf91ce53 ($25.29 in chips)
Seat 6: Hero ($26.59 in chips)
6185872b: posts small blind $0.1
6736194e: posts big blind $0.25
*** HOLE CARDS ***
Dealt to 7c935d24 
Dealt to 6185872b 
Dealt to 6736194e 
Dealt to 9f138297 
Dealt to cf91ce53 
Dealt to Hero [Ac 3c]
9f138297: folds
cf91ce53: folds
Hero: raises $0.38 to $0.63
7c935d24: folds
6185872b: calls $0.53
6736194e: folds
*** FLOP *** [5s 4c Ts]
6185872b: checks
Hero: bets $0.57
6185872b: calls $0.57
*** TURN *** [5s 4c Ts] [Kc]
6185872b: bets $1.4
Hero: calls $1.4
*** RIVER *** [5s 4c Ts Kc] [4d]
6185872b: checks
Hero: checks
6185872b: shows [As 2h] (Pair of Fours)
Hero: shows [3c Ac] (Pair of Fours)
*** SHOWDOWN ***
Hero collected $2.72 from pot
6185872b collected $2.72 from pot
*** SUMMARY ***
Total pot $5.45
Board [5s 4c Ts Kc 4d]
Seat 1: 7c935d24 (button) folded before Flop (didn't bet)
Seat 2: 6185872b (small blind) showed [As 2h] and won ($2.72) with Pair of Fours
Seat 3: 6736194e (big blind) folded before Flop
Seat 4: 9f138297 folded before Flop (didn't bet)
Seat 5: cf91ce53 folded before Flop (didn't bet)
Seat 6: Hero showed [Ac 3c] and won ($2.72) with Pair of Fours


Poker Hand #RC95100393: Hold'em No Limit ($0.1/$0.25) - 2020/04/07 15:49:41
Table 'RushAndCash366046' 6-max Seat #1 is the button
Seat 1: 6185872b ($10.24 in chips)
Seat 2: Hero ($26.58 in chips)
Seat 3: bf64de7f ($7.77 in chips)
Seat 4: 7c935d24 ($25.7 in chips)
Seat 5: ed488d2d ($12.5 in chips)
Seat 6: 403fa816 ($9.63 in chips)
Hero: posts small blind $0.1
bf64de7f: posts big blind $0.25
*** HOLE CARDS ***
Dealt to 6185872b 
Dealt to Hero [8h 2d]
Dealt to bf64de7f 
Dealt to 7c935d24 
Dealt to ed488d2d 
Dealt to 403fa816 
7c935d24: folds
ed488d2d: folds
403fa816: folds
6185872b: raises $0.25 to $0.5
Hero: folds
bf64de7f: folds
Uncalled bet ($0.25) returned to 6185872b
*** SHOWDOWN ***
6185872b collected $0.6 from pot
*** SUMMARY ***
Total pot $0.6
Seat 1: 6185872b (button) collected ($0.6)
Seat 2: Hero (small blind) folded before Flop
Seat 3: bf64de7f (big blind) folded before Flop
Seat 4: 7c935d24 folded before Flop (didn't bet)
Seat 5: ed488d2d folded before Flop (didn't bet)
Seat 6: 403fa816 folded before Flop (didn't bet)


Poker Hand #RC95100426: Hold'em No Limit ($0.1/$0.25) - 2020/04/07 15:49:45
Table 'RushAndCash366051' 6-max Seat #1 is the button
Seat 1: d6f2a39c ($3.07 in chips)
Seat 2: 37ae2dd7 ($28.37 in chips)
Seat 3: cdd7700a ($14.35 in chips)
Seat 4: 7ed3ab6b ($29.88 in chips)
Seat 5: 98ddea23 ($7.2 in chips)
Seat 6: Hero ($26.48 in chips)
37ae2dd7: posts small blind $0.1
cdd7700a: posts big blind $0.25
*** HOLE CARDS ***
Dealt to d6f2a39c 
Dealt to 37ae2dd7 
Dealt to cdd7700a 
Dealt to 7ed3ab6b 
Dealt to 98ddea23 
Dealt to Hero [Jh 2h]
7ed3ab6b: folds
98ddea23: raises $0.5 to $0.75
Hero: folds
d6f2a39c: folds
37ae2dd7: folds
cdd7700a: folds
Uncalled bet ($0.5) returned to 98ddea23
*** SHOWDOWN ***
98ddea23 collected $0.6 from pot
*** SUMMARY ***
Total pot $0.6
Seat 1: d6f2a39c (button) folded before Flop (didn't bet)
Seat 2: 37ae2dd7 (small blind) folded before Flop
Seat 3: cdd7700a (big blind) folded before Flop
Seat 4: 7ed3ab6b folded before Flop (didn't bet)
Seat 5: 98ddea23 collected ($0.6)
Seat 6: Hero folded before Flop (didn't bet)


Poker Hand #RC95100452: Hold'em No Limit ($0.1/$0.25) - 2020/04/07 15:49:48
Table 'RushAndCash366057' 6-max Seat #1 is the button
Seat 1: 51c60a1c ($10.11 in chips)
Seat 2: 2c82afb5 ($13.56 in chips)
Seat 3: 4c077ac6 ($12.19 in chips)
Seat 4: ed488d2d ($12.5 in chips)
Seat 5: Hero ($26.48 in chips)
Seat 6: 7ed3ab6b ($29.88 in chips)
2c82afb5: posts small blind $0.1
4c077ac6: posts big blind $0.25
*** HOLE CARDS ***
Dealt to 51c60a1c 
Dealt to 2c82afb5 
Dealt to 4c077ac6 
Dealt to ed488d2d 
Dealt to Hero [Kc 8s]
Dealt to 7ed3ab6b 
ed488d2d: folds
Hero: folds
7ed3ab6b: folds
51c60a1c: folds
2c82afb5: raises $0.38 to $0.63
4c077ac6: folds
Uncalled bet ($0.38) returned to 2c82afb5
*** SHOWDOWN ***
2c82afb5 collected $0.5 from pot
*** SUMMARY ***
Total pot $0.5
Seat 1: 51c60a1c (button) folded before Flop (didn't bet)
Seat 2: 2c82afb5 (small blind) collected ($0.5)
Seat 3: 4c077ac6 (big blind) folded before Flop
Seat 4: ed488d2d folded before Flop (didn't bet)
Seat 5: Hero folded before Flop (didn't bet)
Seat 6: 7ed3ab6b folded before Flop (didn't bet)


Poker Hand #RC95100486: Hold'em No Limit ($0.1/$0.25) - 2020/04/07 15:49:52
Table 'RushAndCash366062' 6-max Seat #1 is the button
Seat 1: Hero ($26.48 in chips)
Seat 2: bc3db224 ($27.5 in chips)
Seat 3: 6bf543f8 ($25.32 in chips)
Seat 4: 7ed3ab6b ($29.88 in chips)
Seat 5: 51c60a1c ($10.11 in chips)
Seat 6: a0d04110 ($73.26 in chips)
bc3db224: posts small blind $0.1
6bf543f8: posts big blind $0.25
*** HOLE CARDS ***
Dealt to Hero [8d 5h]
Dealt to bc3db224 
Dealt to 6bf543f8 
Dealt to 7ed3ab6b 
Dealt to 51c60a1c 
Dealt to a0d04110 
7ed3ab6b: folds
51c60a1c: folds
a0d04110: folds
Hero: folds
bc3db224: folds
Uncalled bet ($0.15) returned to 6bf543f8
*** SHOWDOWN ***
6bf543f8 collected $0.2 from pot
*** SUMMARY ***
Total pot $0.2
Seat 1: Hero (button) folded before Flop (didn't bet)
Seat 2: bc3db224 (small blind) folded before Flop
Seat 3: 6bf543f8 (big blind) collected ($0.2)
Seat 4: 7ed3ab6b folded before Flop (didn't bet)
Seat 5: 51c60a1c folded before Flop (didn't bet)
Seat 6: a0d04110 folded before Flop (didn't bet)


Poker Hand #RC95100517: Hold'em No Limit ($0.1/$0.25) - 2020/04/07 15:49:56
Table 'RushAndCash366067' 6-max Seat #1 is the button
Seat 1: 275e7f74 ($26.41 in chips)
Seat 2: 6bf543f8 ($25.07 in chips)
Seat 3: da17c979 ($12.94 in chips)
Seat 4: Hero ($26.48 in chips)
Seat 5: 403fa816 ($9.63 in chips)
Seat 6: 36017ad1 ($34.63 in chips)
6bf543f8: posts small blind $0.1
da17c979: posts big blind $0.25
*** HOLE CARDS ***
Dealt to 275e7f74 
Dealt to 6bf543f8 
Dealt to da17c979 
Dealt to Hero [Qh 9d]
Dealt to 403fa816 
Dealt to 36017ad1 
Hero: folds
403fa816: folds
36017ad1: raises $0.38 to $0.63
275e7f74: folds
6bf543f8: folds
da17c979: folds
Uncalled bet ($0.38) returned to 36017ad1
*** SHOWDOWN ***
36017ad1 collected $0.6 from pot
*** SUMMARY ***
Total pot $0.6
Seat 1: 275e7f74 (button) folded before Flop (didn't bet)
Seat 2: 6bf543f8 (small blind) folded before Flop
Seat 3: da17c979 (big blind) folded before Flop
Seat 4: Hero folded before Flop (didn't bet)
Seat 5: 403fa816 folded before Flop (didn't bet)
Seat 6: 36017ad1 collected ($0.6)


Poker Hand #RC95100548: Hold'em No Limit ($0.1/$0.25) - 2020/04/07 15:50:00
Table 'RushAndCash366072' 6-max Seat #1 is the button
Seat 1: Hero ($26.48 in chips)
Seat 2: bad0409c ($15.12 in chips)
Seat 3: 44d6b861 ($26.69 in chips)
Seat 4: fc8a29ea ($56.7 in chips)
Seat 5: fb4a5e69 ($25.55 in chips)
Seat 6: bf64de7f ($7.52 in chips)
bad0409c: posts small blind $0.1
44d6b861: posts big blind $0.25
*** HOLE CARDS ***
Dealt to Hero [Jc 7c]
Dealt to bad0409c 
Dealt to 44d6b861 
Dealt to fc8a29ea 
Dealt to fb4a5e69 
Dealt to bf64de7f 
fc8a29ea: folds
fb4a5e69: folds
bf64de7f: folds
Hero: folds
bad0409c: folds
Uncalled bet ($0.15) returned to 44d6b861
*** SHOWDOWN ***
44d6b861 collected $0.2 from pot
*** SUMMARY ***
Total pot $0.2
Seat 1: Hero (button) folded before Flop (didn't bet)
Seat 2: bad0409c (small blind) folded before Flop
Seat 3: 44d6b861 (big blind) collected ($0.2)
Seat 4: fc8a29ea folded before Flop (didn't bet)
Seat 5: fb4a5e69 folded before Flop (didn't bet)
Seat 6: bf64de7f folded before Flop (didn't bet)


Poker Hand #RC95100575: Hold'em No Limit ($0.1/$0.25) - 2020/04/07 15:50:03
Table 'RushAndCash366076' 6-max Seat #1 is the button
Seat 1: 2c82afb5 ($13.81 in chips)
Seat 2: 275e7f74 ($26.41 in chips)
Seat 3: Hero ($26.48 in chips)
Seat 4: ec1c524d ($25 in chips)
Seat 5: 89387862 ($31.3 in chips)
Seat 6: cdd7700a ($14 in chips)
275e7f74: posts small blind $0.1
Hero: posts big blind $0.25
*** HOLE CARDS ***
Dealt to 2c82afb5 
Dealt to 275e7f74 
Dealt to Hero [9h 5c]
Dealt to ec1c524d 
Dealt to 89387862 
Dealt to cdd7700a 
ec1c524d: raises $0.25 to $0.5
89387862: folds
cdd7700a: folds
2c82afb5: folds
275e7f74: folds
Hero: folds
Uncalled bet ($0.25) returned to ec1c524d
*** SHOWDOWN ***
ec1c524d collected $0.6 from pot
*** SUMMARY ***
Total pot $0.6
Seat 1: 2c82afb5 (button) folded before Flop (didn't bet)
Seat 2: 275e7f74 (small blind) folded before Flop
Seat 3: Hero (big blind) folded before Flop
Seat 4: ec1c524d collected ($0.6)
Seat 5: 89387862 folded before Flop (didn't bet)
Seat 6: cdd7700a folded before Flop (didn't bet)


Poker Hand #RC95100594: Hold'em No Limit ($0.1/$0.25) - 2020/04/07 15:50:06
Table 'RushAndCash366079' 6-max Seat #1 is the button
Seat 1: acf1a889 ($22.1 in chips)
Seat 2: Hero ($26.23 in chips)
Seat 3: ea254934 ($12.85 in chips)
Seat 4: bbb85b3f ($25.82 in chips)
Seat 5: d263ef65 ($11.15 in chips)
Seat 6: be711e9d ($36.68 in chips)
Hero: posts small blind $0.1
ea254934: posts big blind $0.25
*** HOLE CARDS ***
Dealt to acf1a889 
Dealt to Hero [Jh 9d]
Dealt to ea254934 
Dealt to bbb85b3f 
Dealt to d263ef65 
Dealt to be711e9d 
bbb85b3f: folds
d263ef65: folds
be711e9d: raises $0.38 to $0.63
acf1a889: folds
Hero: folds
ea254934: folds
Uncalled bet ($0.38) returned to be711e9d
*** SHOWDOWN ***
be711e9d collected $0.6 from pot
*** SUMMARY ***
Total pot $0.6
Seat 1: acf1a889 (button) folded before Flop (didn't bet)
Seat 2: Hero (small blind) folded before Flop
Seat 3: ea254934 (big blind) folded before Flop
Seat 4: bbb85b3f folded before Flop (didn't bet)
Seat 5: d263ef65 folded before Flop (didn't bet)
Seat 6: be711e9d collected ($0.6)


Poker Hand #RC95100630: Hold'em No Limit ($0.1/$0.25) - 2020/04/07 15:50:11
Table 'RushAndCash366083' 6-max Seat #1 is the button
Seat 1: 61ad32d ($15.12 in chips)
Seat 2: Hero ($26.13 in chips)
Seat 3: 4dd920ba ($82.67 in chips)
Seat 4: cdd7700a ($14 in chips)
Seat 5: bbb85b3f ($25.82 in chips)
Seat 6: 30cab83a ($44.23 in chips)
Hero: posts small blind $0.1
4dd920ba: posts big blind $0.25
*** HOLE CARDS ***
Dealt to 61ad32d 
Dealt to Hero [As 8h]
Dealt to 4dd920ba 
Dealt to cdd7700a 
Dealt to bbb85b3f 
Dealt to 30cab83a 
cdd7700a: folds
bbb85b3f: raises $0.38 to $0.63
30cab83a: folds
61ad32d: folds
Hero: folds
4dd920ba: folds
Uncalled bet ($0.38) returned to bbb85b3f
*** SHOWDOWN ***
bbb85b3f collected $0.6 from pot
*** SUMMARY ***
Total pot $0.6
Seat 1: 61ad32d (button) folded before Flop (didn't bet)
Seat 2: Hero (small blind) folded before Flop
Seat 3: 4dd920ba (big blind) folded before Flop
Seat 4: cdd7700a folded before Flop (didn't bet)
Seat 5: bbb85b3f collected ($0.6)
Seat 6: 30cab83a folded before Flop (didn't bet)


Poker Hand #RC95100653: Hold'em No Limit ($0.1/$0.25) - 2020/04/07 15:50:15
Table 'RushAndCash366087' 6-max Seat #1 is the button
Seat 1: 346ec01 ($12.85 in chips)
Seat 2: d9a04cfb ($25.35 in chips)
Seat 3: 403fa816 ($9.63 in chips)
Seat 4: 51c60a1c ($10.11 in chips)
Seat 5: Hero ($26.03 in chips)
Seat 6: 61ad32d ($15.12 in chips)
d9a04cfb: posts small blind $0.1
403fa816: posts big blind $0.25
*** HOLE CARDS ***
Dealt to 346ec01 
Dealt to d9a04cfb 
Dealt to 403fa816 
Dealt to 51c60a1c 
Dealt to Hero [Ah 3s]
Dealt to 61ad32d 
51c60a1c: folds
Hero: folds
61ad32d: folds
346ec01: raises $0.38 to $0.63
d9a04cfb: folds
403fa816: folds
Uncalled bet ($0.38) returned to 346ec01
*** SHOWDOWN ***
346ec01 collected $0.6 from pot
*** SUMMARY ***
Total pot $0.6
Seat 1: 346ec01 (button) collected ($0.6)
Seat 2: d9a04cfb (small blind) folded before Flop
Seat 3: 403fa816 (big blind) folded before Flop
Seat 4: 51c60a1c folded before Flop (didn't bet)
Seat 5: Hero folded before Flop (didn't bet)
Seat 6: 61ad32d folded before Flop (didn't bet)


Poker Hand #RC95100682: Hold'em No Limit ($0.1/$0.25) - 2020/04/07 15:50:19
Table 'RushAndCash366091' 6-max Seat #1 is the button
Seat 1: 3dafe47e ($14.98 in chips)
Seat 2: 8004b155 ($12.96 in chips)
Seat 3: Hero ($26.03 in chips)
Seat 4: 61ad32d ($15.12 in chips)
Seat 5: acf1a889 ($22.1 in chips)
Seat 6: bf64de7f ($7.42 in chips)
8004b155: posts small blind $0.1
Hero: posts big blind $0.25
*** HOLE CARDS ***
Dealt to 3dafe47e 
Dealt to 8004b155 
Dealt to Hero [Qh Tc]
Dealt to 61ad32d 
Dealt to acf1a889 
Dealt to bf64de7f 
61ad32d: folds
acf1a889: folds
bf64de7f: folds
3dafe47e: folds
8004b155: folds
Uncalled bet ($0.15) returned to Hero
*** SHOWDOWN ***
Hero collected $0.2 from pot
*** SUMMARY ***
Total pot $0.2
Seat 1: 3dafe47e (button) folded before Flop (didn't bet)
Seat 2: 8004b155 (small blind) folded before Flop
Seat 3: Hero (big blind) collected ($0.2)
Seat 4: 61ad32d folded before Flop (didn't bet)
Seat 5: acf1a889 folded before Flop (didn't bet)
Seat 6: bf64de7f folded before Flop (didn't bet)


Poker Hand #RC95100715: Hold'em No Limit ($0.1/$0.25) - 2020/04/07 15:50:23
Table 'RushAndCash366097' 6-max Seat #1 is the button
Seat 1: Hero ($25.78 in chips)
Seat 2: 2dd038c3 ($7.33 in chips)
Seat 3: 51c60a1c ($10.01 in chips)
Seat 4: bad0409c ($15.37 in chips)
Seat 5: fb4a5e69 ($25.9 in chips)
Seat 6: 181b6319 ($24.37 in chips)
2dd038c3: posts small blind $0.1
51c60a1c: posts big blind $0.25
*** HOLE CARDS ***
Dealt to Hero [Kc Qh]
Dealt to 2dd038c3 
Dealt to 51c60a1c 
Dealt to bad0409c 
Dealt to fb4a5e69 
Dealt to 181b6319 
bad0409c: folds
fb4a5e69: folds
181b6319: folds
Hero: raises $0.38 to $0.63
2dd038c3: folds
51c60a1c: folds
Uncalled bet ($0.38) returned to Hero
*** SHOWDOWN ***
Hero collected $0.6 from pot
*** SUMMARY ***
Total pot $0.6
Seat 1: Hero (button) collected ($0.6)
Seat 2: 2dd038c3 (small blind) folded before Flop
Seat 3: 51c60a1c (big blind) folded before Flop
Seat 4: bad0409c folded before Flop (didn't bet)
Seat 5: fb4a5e69 folded before Flop (didn't bet)
Seat 6: 181b6319 folded before Flop (didn't bet)


Poker Hand #RC95100842: Hold'em No Limit ($0.1/$0.25) - 2020/04/07 15:50:39
Table 'RushAndCash366117' 6-max Seat #1 is the button
Seat 1: 7c935d24 ($26.05 in chips)
Seat 2: 36017ad1 ($34.73 in chips)
Seat 3: 8b8d197c ($29.97 in chips)
Seat 4: 492c0086 ($14.64 in chips)
Seat 5: 22be9faa ($10.2 in chips)
Seat 6: Hero ($26.48 in chips)
36017ad1: posts small blind $0.1
8b8d197c: posts big blind $0.25
*** HOLE CARDS ***
Dealt to 7c935d24 
Dealt to 36017ad1 
Dealt to 8b8d197c 
Dealt to 492c0086 
Dealt to 22be9faa 
Dealt to Hero [Qc 5d]
492c0086: folds
22be9faa: folds
Hero: folds
7c935d24: raises $0.38 to $0.63
36017ad1: folds
8b8d197c: calls $0.38
*** FLOP *** [8d Ac 6s]
8b8d197c: checks
7c935d24: checks
*** TURN *** [8d Ac 6s] [Jh]
8b8d197c: bets $1
7c935d24: calls $1
*** RIVER *** [8d Ac 6s Jh] [9c]
8b8d197c: bets $2.8
7c935d24: folds
Uncalled bet ($2.8) returned to 8b8d197c
*** SHOWDOWN ***
8b8d197c collected $3.36 from pot
*** SUMMARY ***
Total pot $3.36
Board [8d Ac 6s Jh 9c]
Seat 1: 7c935d24 (button) folded on the River
Seat 2: 36017ad1 (small blind) folded before Flop
Seat 3: 8b8d197c (big blind) won ($3.36)
Seat 4: 492c0086 folded before Flop (didn't bet)
Seat 5: 22be9faa folded before Flop (didn't bet)
Seat 6: Hero folded before Flop (didn't bet)


Poker Hand #RC95100872: Hold'em No Limit ($0.1/$0.25) - 2020/04/07 15:50:43
Table 'RushAndCash366121' 6-max Seat #1 is the button
Seat 1: dbf6981f ($49.16 in chips)
Seat 2: 22be9faa ($10.2 in chips)
Seat 3: 4aa8d4e8 ($13.16 in chips)
Seat 4: 8c4d6eff ($37.25 in chips)
Seat 5: Hero ($26.48 in chips)
Seat 6: b5d592d2 ($12.87 in chips)
22be9faa: posts small blind $0.1
4aa8d4e8: posts big blind $0.25
*** HOLE CARDS ***
Dealt to dbf6981f 
Dealt to 22be9faa 
Dealt to 4aa8d4e8 
Dealt to 8c4d6eff 
Dealt to Hero [Kc Ts]
Dealt to b5d592d2 
8c4d6eff: folds
Hero: folds
b5d592d2: folds
dbf6981f: folds
22be9faa: folds
Uncalled bet ($0.15) returned to 4aa8d4e8
*** SHOWDOWN ***
4aa8d4e8 collected $0.2 from pot
*** SUMMARY ***
Total pot $0.2
Seat 1: dbf6981f (button) folded before Flop (didn't bet)
Seat 2: 22be9faa (small blind) folded before Flop
Seat 3: 4aa8d4e8 (big blind) collected ($0.2)
Seat 4: 8c4d6eff folded before Flop (didn't bet)
Seat 5: Hero folded before Flop (didn't bet)
Seat 6: b5d592d2 folded before Flop (didn't bet)


Poker Hand #RC95100929: Hold'em No Limit ($0.1/$0.25) - 2020/04/07 15:50:50
Table 'RushAndCash366129' 6-max Seat #1 is the button
Seat 1: d3a18552 ($12.5 in chips)
Seat 2: Hero ($26.48 in chips)
Seat 3: 181b6319 ($24.72 in chips)
Seat 4: 30cab83a ($43.88 in chips)
Seat 5: 62eebc49 ($122.43 in chips)
Seat 6: 74937d40 ($37.19 in chips)
Hero: posts small blind $0.1
181b6319: posts big blind $0.25
*** HOLE CARDS ***
Dealt to d3a18552 
Dealt to Hero [Ks 4c]
Dealt to 181b6319 
Dealt to 30cab83a 
Dealt to 62eebc49 
Dealt to 74937d40 
30cab83a: folds
62eebc49: folds
74937d40: raises $0.38 to $0.63
d3a18552: folds
Hero: folds
181b6319: folds
Uncalled bet ($0.38) returned to 74937d40
*** SHOWDOWN ***
74937d40 collected $0.6 from pot
*** SUMMARY ***
Total pot $0.6
Seat 1: d3a18552 (button) folded before Flop (didn't bet)
Seat 2: Hero (small blind) folded before Flop
Seat 3: 181b6319 (big blind) folded before Flop
Seat 4: 30cab83a folded before Flop (didn't bet)
Seat 5: 62eebc49 folded before Flop (didn't bet)
Seat 6: 74937d40 collected ($0.6)


Poker Hand #RC95100954: Hold'em No Limit ($0.1/$0.25) - 2020/04/07 15:50:53
Table 'RushAndCash366132' 6-max Seat #1 is the button
Seat 1: 403fa816 ($9.28 in chips)
Seat 2: 61ad32d ($16.13 in chips)
Seat 3: Hero ($26.38 in chips)
Seat 4: 3d05956 ($41.15 in chips)
Seat 5: dbf6981f ($49.16 in chips)
Seat 6: 44d6b861 ($26.69 in chips)
61ad32d: posts small blind $0.1
Hero: posts big blind $0.25
*** HOLE CARDS ***
Dealt to 403fa816 
Dealt to 61ad32d 
Dealt to Hero [Th 3h]
Dealt to 3d05956 
Dealt to dbf6981f 
Dealt to 44d6b861 
3d05956: folds
dbf6981f: folds
44d6b861: folds
403fa816: raises $0.25 to $0.5
61ad32d: folds
Hero: folds
Uncalled bet ($0.25) returned to 403fa816
*** SHOWDOWN ***
403fa816 collected $0.6 from pot
*** SUMMARY ***
Total pot $0.6
Seat 1: 403fa816 (button) collected ($0.6)
Seat 2: 61ad32d (small blind) folded before Flop
Seat 3: Hero (big blind) folded before Flop
Seat 4: 3d05956 folded before Flop (didn't bet)
Seat 5: dbf6981f folded before Flop (didn't bet)
Seat 6: 44d6b861 folded before Flop (didn't bet)


Poker Hand #RC95100978: Hold'em No Limit ($0.1/$0.25) - 2020/04/07 15:50:56
Table 'RushAndCash366134' 6-max Seat #1 is the button
Seat 1: d6f2a39c ($2.72 in chips)
Seat 2: be711e9d ($37.13 in chips)
Seat 3: 36017ad1 ($34.63 in chips)
Seat 4: Hero ($26.13 in chips)
Seat 5: 4ab4e4a3 ($25 in chips)
Seat 6: f178c62c ($28.28 in chips)
be711e9d: posts small blind $0.1
36017ad1: posts big blind $0.25
*** HOLE CARDS ***
Dealt to d6f2a39c 
Dealt to be711e9d 
Dealt to 36017ad1 
Dealt to Hero [7d 2h]
Dealt to 4ab4e4a3 
Dealt to f178c62c 
Hero: folds
4ab4e4a3: folds
f178c62c: folds
d6f2a39c: folds
be711e9d: folds
Uncalled bet ($0.15) returned to 36017ad1
*** SHOWDOWN ***
36017ad1 collected $0.2 from pot
*** SUMMARY ***
Total pot $0.2
Seat 1: d6f2a39c (button) folded before Flop (didn't bet)
Seat 2: be711e9d (small blind) folded before Flop
Seat 3: 36017ad1 (big blind) collected ($0.2)
Seat 4: Hero folded before Flop (didn't bet)
Seat 5: 4ab4e4a3 folded before Flop (didn't bet)
Seat 6: f178c62c folded before Flop (didn't bet)


Poker Hand #RC95101005: Hold'em No Limit ($0.1/$0.25) - 2020/04/07 15:51:00
Table 'RushAndCash366137' 6-max Seat #1 is the button
Seat 1: Hero ($26.13 in chips)
Seat 2: 44d6b861 ($26.69 in chips)
Seat 3: 8c4d6eff ($37.15 in chips)
Seat 4: bda1b4ce ($32.04 in chips)
Seat 5: bad0409c ($16.38 in chips)
Seat 6: bf64de7f ($7.07 in chips)
44d6b861: posts small blind $0.1
8c4d6eff: posts big blind $0.25
*** HOLE CARDS ***
Dealt to Hero [Ac 8s]
Dealt to 44d6b861 
Dealt to 8c4d6eff 
Dealt to bda1b4ce 
Dealt to bad0409c 
Dealt to bf64de7f 
bda1b4ce: folds
bad0409c: folds
bf64de7f: folds
Hero: folds
44d6b861: calls $0.15
8c4d6eff: checks
*** FLOP *** [Jc Qc Kh]
44d6b861: bets $0.25
8c4d6eff: folds
Uncalled bet ($0.25) returned to 44d6b861
*** SHOWDOWN ***
44d6b861 collected $0.5 from pot
*** SUMMARY ***
Total pot $0.5
Board [Jc Qc Kh]
Seat 1: Hero (button) folded before Flop (didn't bet)
Seat 2: 44d6b861 (small blind) won ($0.5)
Seat 3: 8c4d6eff (big blind) folded on the Flop
Seat 4: bda1b4ce folded before Flop (didn't bet)
Seat 5: bad0409c folded before Flop (didn't bet)
Seat 6: bf64de7f folded before Flop (didn't bet)


Poker Hand #RC95101035: Hold'em No Limit ($0.1/$0.25) - 2020/04/07 15:51:03
Table 'RushAndCash366141' 6-max Seat #1 is the button
Seat 1: 3cfd7308 ($51.4 in chips)
Seat 2: d263ef65 ($11.25 in chips)
Seat 3: 6736194e ($25.91 in chips)
Seat 4: Hero ($26.13 in chips)
Seat 5: dbf6981f ($49.16 in chips)
Seat 6: fb4a5e69 ($25.55 in chips)
d263ef65: posts small blind $0.1
6736194e: posts big blind $0.25
*** HOLE CARDS ***
Dealt to 3cfd7308 
Dealt to d263ef65 
Dealt to 6736194e 
Dealt to Hero [Qs 4c]
Dealt to dbf6981f 
Dealt to fb4a5e69 
Hero: folds
dbf6981f: folds
fb4a5e69: raises $0.38 to $0.63
3cfd7308: folds
d263ef65: folds
6736194e: folds
Uncalled bet ($0.38) returned to fb4a5e69
*** SHOWDOWN ***
fb4a5e69 collected $0.6 from pot
*** SUMMARY ***
Total pot $0.6
Seat 1: 3cfd7308 (button) folded before Flop (didn't bet)
Seat 2: d263ef65 (small blind) folded before Flop
Seat 3: 6736194e (big blind) folded before Flop
Seat 4: Hero folded before Flop (didn't bet)
Seat 5: dbf6981f folded before Flop (didn't bet)
Seat 6: fb4a5e69 collected ($0.6)


Poker Hand #RC95101067: Hold'em No Limit ($0.1/$0.25) - 2020/04/07 15:51:07
Table 'RushAndCash366145' 6-max Seat #1 is the button
Seat 1: 3423a84d ($51.05 in chips)
Seat 2: 98ddea23 ($9.73 in chips)
Seat 3: 37ae2dd7 ($28.27 in chips)
Seat 4: da17c979 ($12.5 in chips)
Seat 5: Hero ($26.13 in chips)
Seat 6: 8c4d6eff ($36.9 in chips)
98ddea23: posts small blind $0.1
37ae2dd7: posts big blind $0.25
*** HOLE CARDS ***
Dealt to 3423a84d 
Dealt to 98ddea23 
Dealt to 37ae2dd7 
Dealt to da17c979 
Dealt to Hero [8d 6c]
Dealt to 8c4d6eff 
da17c979: folds
Hero: folds
8c4d6eff: folds
3423a84d: raises $0.25 to $0.5
98ddea23: folds
37ae2dd7: calls $0.25
*** FLOP *** [Ks 4h 8h]
37ae2dd7: checks
3423a84d: bets $0.4
37ae2dd7: raises $1.5 to $1.9
3423a84d: folds
Uncalled bet ($1.5) returned to 37ae2dd7
*** SHOWDOWN ***
37ae2dd7 collected $1.9 from pot
*** SUMMARY ***
Total pot $1.9
Board [Ks 4h 8h]
Seat 1: 3423a84d (button) folded on the Flop
Seat 2: 98ddea23 (small blind) folded before Flop
Seat 3: 37ae2dd7 (big blind) won ($1.9)
Seat 4: da17c979 folded before Flop (didn't bet)
Seat 5: Hero folded before Flop (didn't bet)
Seat 6: 8c4d6eff folded before Flop (didn't bet)


Poker Hand #RC95101137: Hold'em No Limit ($0.1/$0.25) - 2020/04/07 15:51:16
Table 'RushAndCash366155' 6-max Seat #1 is the button
Seat 1: 51c60a1c ($10.53 in chips)
Seat 2: Hero ($26.13 in chips)
Seat 3: 44d6b861 ($26.92 in chips)
Seat 4: 30cab83a ($43.78 in chips)
Seat 5: cdd7700a ($12.5 in chips)
Seat 6: 403fa816 ($9.63 in chips)
Hero: posts small blind $0.1
44d6b861: posts big blind $0.25
*** HOLE CARDS ***
Dealt to 51c60a1c 
Dealt to Hero [5d 2h]
Dealt to 44d6b861 
Dealt to 30cab83a 
Dealt to cdd7700a 
Dealt to 403fa816 
30cab83a: folds
cdd7700a: folds
403fa816: folds
51c60a1c: raises $0.5 to $0.75
Hero: folds
44d6b861: calls $0.5
*** FLOP *** [Ks 3s Qs]
44d6b861: checks
51c60a1c: bets $0.8
44d6b861: folds
Uncalled bet ($0.8) returned to 51c60a1c
*** SHOWDOWN ***
51c60a1c collected $1.6 from pot
*** SUMMARY ***
Total pot $1.6
Board [Ks 3s Qs]
Seat 1: 51c60a1c (button) won ($1.6)
Seat 2: Hero (small blind) folded before Flop
Seat 3: 44d6b861 (big blind) folded on the Flop
Seat 4: 30cab83a folded before Flop (didn't bet)
Seat 5: cdd7700a folded before Flop (didn't bet)
Seat 6: 403fa816 folded before Flop (didn't bet)


Poker Hand #RC95101168: Hold'em No Limit ($0.1/$0.25) - 2020/04/07 15:51:20
Table 'RushAndCash366160' 6-max Seat #1 is the button
Seat 1: Hero ($26.03 in chips)
Seat 2: 8c4d6eff ($36.9 in chips)
Seat 3: 30cab83a ($43.78 in chips)
Seat 4: dbf6981f ($49.16 in chips)
Seat 5: d263ef65 ($11.15 in chips)
Seat 6: d3a18552 ($12.5 in chips)
8c4d6eff: posts small blind $0.1
30cab83a: posts big blind $0.25
*** HOLE CARDS ***
Dealt to Hero [Kd 3s]
Dealt to 8c4d6eff 
Dealt to 30cab83a 
Dealt to dbf6981f 
Dealt to d263ef65 
Dealt to d3a18552 
dbf6981f: folds
d263ef65: folds
d3a18552: folds
Hero: folds
8c4d6eff: folds
Uncalled bet ($0.15) returned to 30cab83a
*** SHOWDOWN ***
30cab83a collected $0.2 from pot
*** SUMMARY ***
Total pot $0.2
Seat 1: Hero (button) folded before Flop (didn't bet)
Seat 2: 8c4d6eff (small blind) folded before Flop
Seat 3: 30cab83a (big blind) collected ($0.2)
Seat 4: dbf6981f folded before Flop (didn't bet)
Seat 5: d263ef65 folded before Flop (didn't bet)
Seat 6: d3a18552 folded before Flop (didn't bet)


Poker Hand #RC95101196: Hold'em No Limit ($0.1/$0.25) - 2020/04/07 15:51:24
Table 'RushAndCash366164' 6-max Seat #1 is the button
Seat 1: 8004b155 ($13.86 in chips)
Seat 2: 94943589 ($25.02 in chips)
Seat 3: Hero ($26.03 in chips)
Seat 4: ac90cf4e ($11.41 in chips)
Seat 5: b56c4622 ($16.47 in chips)
Seat 6: dbf6981f ($49.16 in chips)
94943589: posts small blind $0.1
Hero: posts big blind $0.25
*** HOLE CARDS ***
Dealt to 8004b155 
Dealt to 94943589 
Dealt to Hero [Ts Td]
Dealt to ac90cf4e 
Dealt to b56c4622 
Dealt to dbf6981f 
ac90cf4e: folds
b56c4622: folds
dbf6981f: raises $0.38 to $0.63
8004b155: raises $1.13 to $1.76
94943589: folds
Hero: raises $3.74 to $5.5
dbf6981f: folds
8004b155: folds
Uncalled bet ($3.74) returned to Hero
*** SHOWDOWN ***
Hero collected $4.25 from pot
*** SUMMARY ***
Total pot $4.25
Seat 1: 8004b155 (button) folded before Flop
Seat 2: 94943589 (small blind) folded before Flop
Seat 3: Hero (big blind) collected ($4.25)
Seat 4: ac90cf4e folded before Flop (didn't bet)
Seat 5: b56c4622 folded before Flop (didn't bet)
Seat 6: dbf6981f folded before Flop


Poker Hand #RC95101422: Hold'em No Limit ($0.1/$0.25) - 2020/04/07 15:51:55
Table 'RushAndCash366193' 6-max Seat #1 is the button
Seat 1: 811232a3 ($35.68 in chips)
Seat 2: 8004b155 ($12.1 in chips)
Seat 3: be711e9d ($36.4 in chips)
Seat 4: ec1c524d ($25 in chips)
Seat 5: Hero ($28.31 in chips)
Seat 6: ea254934 ($14.3 in chips)
8004b155: posts small blind $0.1
be711e9d: posts big blind $0.25
*** HOLE CARDS ***
Dealt to 811232a3 
Dealt to 8004b155 
Dealt to be711e9d 
Dealt to ec1c524d 
Dealt to Hero [Jd 3h]
Dealt to ea254934 
ec1c524d: folds
Hero: folds
ea254934: folds
811232a3: folds
8004b155: folds
Uncalled bet ($0.15) returned to be711e9d
*** SHOWDOWN ***
be711e9d collected $0.2 from pot
*** SUMMARY ***
Total pot $0.2
Seat 1: 811232a3 (button) folded before Flop (didn't bet)
Seat 2: 8004b155 (small blind) folded before Flop
Seat 3: be711e9d (big blind) collected ($0.2)
Seat 4: ec1c524d folded before Flop (didn't bet)
Seat 5: Hero folded before Flop (didn't bet)
Seat 6: ea254934 folded before Flop (didn't bet)


Poker Hand #RC95101579: Hold'em No Limit ($0.1/$0.25) - 2020/04/07 15:52:18
Table 'RushAndCash366207' 6-max Seat #1 is the button
Seat 1: 6bf543f8 ($27.43 in chips)
Seat 2: Hero ($28.31 in chips)
Seat 3: 57ff778 ($29.09 in chips)
Seat 4: 5d2a310d ($6.77 in chips)
Seat 5: bad0409c ($16.03 in chips)
Seat 6: 36017ad1 ($35.08 in chips)
Hero: posts small blind $0.1
57ff778: posts big blind $0.25
*** HOLE CARDS ***
Dealt to 6bf543f8 
Dealt to Hero [Tc 3d]
Dealt to 57ff778 
Dealt to 5d2a310d 
Dealt to bad0409c 
Dealt to 36017ad1 
5d2a310d: folds
bad0409c: raises $0.38 to $0.63
36017ad1: folds
6bf543f8: folds
Hero: folds
57ff778: raises $1.87 to $2.5
bad0409c: folds
Uncalled bet ($1.87) returned to 57ff778
*** SHOWDOWN ***
57ff778 collected $1.36 from pot
*** SUMMARY ***
Total pot $1.36
Seat 1: 6bf543f8 (button) folded before Flop (didn't bet)
Seat 2: Hero (small blind) folded before Flop
Seat 3: 57ff778 (big blind) collected ($1.36)
Seat 4: 5d2a310d folded before Flop (didn't bet)
Seat 5: bad0409c folded before Flop
Seat 6: 36017ad1 folded before Flop (didn't bet)


Poker Hand #RC95101602: Hold'em No Limit ($0.1/$0.25) - 2020/04/07 15:52:21
Table 'RushAndCash366210' 6-max Seat #1 is the button
Seat 1: acf1a889 ($21.55 in chips)
Seat 2: 811232a3 ($35.68 in chips)
Seat 3: ea254934 ($14.3 in chips)
Seat 4: ac90cf4e ($11.06 in chips)
Seat 5: fe2378bf ($12.95 in chips)
Seat 6: Hero ($28.21 in chips)
811232a3: posts small blind $0.1
ea254934: posts big blind $0.25
*** HOLE CARDS ***
Dealt to acf1a889 
Dealt to 811232a3 
Dealt to ea254934 
Dealt to ac90cf4e 
Dealt to fe2378bf 
Dealt to Hero [Kd Jh]
ac90cf4e: folds
fe2378bf: folds
Hero: raises $0.38 to $0.63
acf1a889: raises $1.27 to $1.9
811232a3: folds
ea254934: folds
Hero: folds
Uncalled bet ($1.27) returned to acf1a889
*** SHOWDOWN ***
acf1a889 collected $1.61 from pot
*** SUMMARY ***
Total pot $1.61
Seat 1: acf1a889 (button) collected ($1.61)
Seat 2: 811232a3 (small blind) folded before Flop
Seat 3: ea254934 (big blind) folded before Flop
Seat 4: ac90cf4e folded before Flop (didn't bet)
Seat 5: fe2378bf folded before Flop (didn't bet)
Seat 6: Hero folded before Flop


