Poker Hand #RC92801028: Hold'em No Limit ($0.1/$0.25) - 2020/04/02 23:24:31
Table 'RushAndCash46190' 6-max Seat #1 is the button
Seat 1: e3fa4802 ($30.37 in chips)
Seat 2: 1b17c736 ($28.7 in chips)
Seat 3: Hero ($25 in chips)
Seat 4: eb18162e ($39.95 in chips)
Seat 5: 803a0c06 ($25 in chips)
Seat 6: c6233f33 ($25 in chips)
1b17c736: posts small blind $0.1
Hero: posts big blind $0.25
*** HOLE CARDS ***
Dealt to e3fa4802 
Dealt to 1b17c736 
Dealt to Hero [Tc 5d]
Dealt to eb18162e 
Dealt to 803a0c06 
Dealt to c6233f33 
eb18162e: folds
803a0c06: folds
c6233f33: raises $0.38 to $0.63
e3fa4802: folds
1b17c736: calls $0.53
Hero: folds
*** FLOP *** [3s Js 9c]
1b17c736: checks
c6233f33: checks
*** TURN *** [3s Js 9c] [8c]
1b17c736: checks
c6233f33: bets $0.55
1b17c736: folds
Uncalled bet ($0.55) returned to c6233f33
*** SHOWDOWN ***
c6233f33 collected $1.51 from pot
*** SUMMARY ***
Total pot $1.51
Board [3s Js 9c 8c]
Seat 1: e3fa4802 (button) folded before Flop (didn't bet)
Seat 2: 1b17c736 (small blind) folded on the Turn
Seat 3: Hero (big blind) folded before Flop
Seat 4: eb18162e folded before Flop (didn't bet)
Seat 5: 803a0c06 folded before Flop (didn't bet)
Seat 6: c6233f33 won ($1.51)


Poker Hand #RC92801060: Hold'em No Limit ($0.1/$0.25) - 2020/04/02 23:24:37
Table 'RushAndCash46193' 6-max Seat #1 is the button
Seat 1: e3fa4802 ($30.37 in chips)
Seat 2: Hero ($25 in chips)
Seat 3: eb18162e ($39.95 in chips)
Seat 4: ab641f7 ($61.25 in chips)
Seat 5: bb54cb76 ($52.77 in chips)
Seat 6: 803a0c06 ($25 in chips)
Hero: posts small blind $0.1
eb18162e: posts big blind $0.25
*** HOLE CARDS ***
Dealt to e3fa4802 
Dealt to Hero [5c 4h]
Dealt to eb18162e 
Dealt to ab641f7 
Dealt to bb54cb76 
Dealt to 803a0c06 
ab641f7: folds
bb54cb76: folds
803a0c06: raises $0.38 to $0.63
e3fa4802: folds
Hero: folds
eb18162e: folds
Uncalled bet ($0.38) returned to 803a0c06
*** SHOWDOWN ***
803a0c06 collected $0.6 from pot
*** SUMMARY ***
Total pot $0.6
Seat 1: e3fa4802 (button) folded before Flop (didn't bet)
Seat 2: Hero (small blind) folded before Flop
Seat 3: eb18162e (big blind) folded before Flop
Seat 4: ab641f7 folded before Flop (didn't bet)
Seat 5: bb54cb76 folded before Flop (didn't bet)
Seat 6: 803a0c06 collected ($0.6)


Poker Hand #RC92801093: Hold'em No Limit ($0.1/$0.25) - 2020/04/02 23:24:42
Table 'RushAndCash46197' 6-max Seat #1 is the button
Seat 1: Hero ($25 in chips)
Seat 2: 44db54de ($25 in chips)
Seat 3: 7db17161 ($55.22 in chips)
Seat 4: 9c1f26b8 ($25.7 in chips)
Seat 5: 2bebd6e7 ($35.61 in chips)
Seat 6: c28873d2 ($47.54 in chips)
44db54de: posts small blind $0.1
7db17161: posts big blind $0.25
*** HOLE CARDS ***
Dealt to Hero [7c 5s]
Dealt to 44db54de 
Dealt to 7db17161 
Dealt to 9c1f26b8 
Dealt to 2bebd6e7 
Dealt to c28873d2 
9c1f26b8: folds
2bebd6e7: raises $0.38 to $0.63
c28873d2: folds
Hero: folds
44db54de: folds
7db17161: folds
Uncalled bet ($0.38) returned to 2bebd6e7
*** SHOWDOWN ***
2bebd6e7 collected $0.6 from pot
*** SUMMARY ***
Total pot $0.6
Seat 1: Hero (button) folded before Flop (didn't bet)
Seat 2: 44db54de (small blind) folded before Flop
Seat 3: 7db17161 (big blind) folded before Flop
Seat 4: 9c1f26b8 folded before Flop (didn't bet)
Seat 5: 2bebd6e7 collected ($0.6)
Seat 6: c28873d2 folded before Flop (didn't bet)


Poker Hand #RC92801124: Hold'em No Limit ($0.1/$0.25) - 2020/04/02 23:24:48
Table 'RushAndCash46204' 6-max Seat #1 is the button
Seat 1: abf9b61c ($29.67 in chips)
Seat 2: 57b0a14c ($26.93 in chips)
Seat 3: ab641f7 ($61.25 in chips)
Seat 4: f19292be ($31.15 in chips)
Seat 5: 833dc1e7 ($73.63 in chips)
Seat 6: Hero ($25 in chips)
57b0a14c: posts small blind $0.1
ab641f7: posts big blind $0.25
*** HOLE CARDS ***
Dealt to abf9b61c 
Dealt to 57b0a14c 
Dealt to ab641f7 
Dealt to f19292be 
Dealt to 833dc1e7 
Dealt to Hero [8s 3s]
f19292be: raises $0.38 to $0.63
833dc1e7: folds
Hero: folds
abf9b61c: folds
57b0a14c: folds
ab641f7: folds
Uncalled bet ($0.38) returned to f19292be
*** SHOWDOWN ***
f19292be collected $0.6 from pot
*** SUMMARY ***
Total pot $0.6
Seat 1: abf9b61c (button) folded before Flop (didn't bet)
Seat 2: 57b0a14c (small blind) folded before Flop
Seat 3: ab641f7 (big blind) folded before Flop
Seat 4: f19292be collected ($0.6)
Seat 5: 833dc1e7 folded before Flop (didn't bet)
Seat 6: Hero folded before Flop (didn't bet)


Poker Hand #RC92801164: Hold'em No Limit ($0.1/$0.25) - 2020/04/02 23:24:54
Table 'RushAndCash46210' 6-max Seat #1 is the button
Seat 1: 7db17161 ($54.97 in chips)
Seat 2: 569c22a2 ($26.26 in chips)
Seat 3: c427ddfc ($29.58 in chips)
Seat 4: Hero ($25 in chips)
Seat 5: abf9b61c ($29.67 in chips)
Seat 6: 2eabd980 ($19.42 in chips)
569c22a2: posts small blind $0.1
c427ddfc: posts big blind $0.25
*** HOLE CARDS ***
Dealt to 7db17161 
Dealt to 569c22a2 
Dealt to c427ddfc 
Dealt to Hero [Kh 9s]
Dealt to abf9b61c 
Dealt to 2eabd980 
Hero: folds
abf9b61c: folds
2eabd980: folds
7db17161: folds
569c22a2: folds
Uncalled bet ($0.15) returned to c427ddfc
*** SHOWDOWN ***
c427ddfc collected $0.2 from pot
*** SUMMARY ***
Total pot $0.2
Seat 1: 7db17161 (button) folded before Flop (didn't bet)
Seat 2: 569c22a2 (small blind) folded before Flop
Seat 3: c427ddfc (big blind) collected ($0.2)
Seat 4: Hero folded before Flop (didn't bet)
Seat 5: abf9b61c folded before Flop (didn't bet)
Seat 6: 2eabd980 folded before Flop (didn't bet)


Poker Hand #RC92801184: Hold'em No Limit ($0.1/$0.25) - 2020/04/02 23:24:58
Table 'RushAndCash46213' 6-max Seat #1 is the button
Seat 1: bb54cb76 ($52.42 in chips)
Seat 2: 2611a367 ($26.25 in chips)
Seat 3: 533b95e8 ($26.81 in chips)
Seat 4: Hero ($25 in chips)
Seat 5: 57b0a14c ($26.83 in chips)
Seat 6: 9c1f26b8 ($25.7 in chips)
2611a367: posts small blind $0.1
533b95e8: posts big blind $0.25
*** HOLE CARDS ***
Dealt to bb54cb76 
Dealt to 2611a367 
Dealt to 533b95e8 
Dealt to Hero [Jc Tc]
Dealt to 57b0a14c 
Dealt to 9c1f26b8 
Hero: raises $0.38 to $0.63
57b0a14c: folds
9c1f26b8: folds
bb54cb76: folds
2611a367: folds
533b95e8: folds
Uncalled bet ($0.38) returned to Hero
*** SHOWDOWN ***
Hero collected $0.6 from pot
*** SUMMARY ***
Total pot $0.6
Seat 1: bb54cb76 (button) folded before Flop (didn't bet)
Seat 2: 2611a367 (small blind) folded before Flop
Seat 3: 533b95e8 (big blind) folded before Flop
Seat 4: Hero collected ($0.6)
Seat 5: 57b0a14c folded before Flop (didn't bet)
Seat 6: 9c1f26b8 folded before Flop (didn't bet)


Poker Hand #RC92801259: Hold'em No Limit ($0.1/$0.25) - 2020/04/02 23:25:11
Table 'RushAndCash46224' 6-max Seat #1 is the button
Seat 1: ec75d237 ($25.1 in chips)
Seat 2: c27aaa40 ($80.43 in chips)
Seat 3: 2bebd6e7 ($36.31 in chips)
Seat 4: d548caa1 ($38.62 in chips)
Seat 5: d1e38640 ($30.9 in chips)
Seat 6: Hero ($25.35 in chips)
c27aaa40: posts small blind $0.1
2bebd6e7: posts big blind $0.25
*** HOLE CARDS ***
Dealt to ec75d237 
Dealt to c27aaa40 
Dealt to 2bebd6e7 
Dealt to d548caa1 
Dealt to d1e38640 
Dealt to Hero [9d 7s]
d548caa1: folds
d1e38640: folds
Hero: folds
ec75d237: folds
c27aaa40: raises $0.38 to $0.63
2bebd6e7: folds
Uncalled bet ($0.38) returned to c27aaa40
*** SHOWDOWN ***
c27aaa40 collected $0.5 from pot
*** SUMMARY ***
Total pot $0.5
Seat 1: ec75d237 (button) folded before Flop (didn't bet)
Seat 2: c27aaa40 (small blind) collected ($0.5)
Seat 3: 2bebd6e7 (big blind) folded before Flop
Seat 4: d548caa1 folded before Flop (didn't bet)
Seat 5: d1e38640 folded before Flop (didn't bet)
Seat 6: Hero folded before Flop (didn't bet)


Poker Hand #RC92801287: Hold'em No Limit ($0.1/$0.25) - 2020/04/02 23:25:16
Table 'RushAndCash46229' 6-max Seat #1 is the button
Seat 1: 57b0a14c ($26.58 in chips)
Seat 2: 7adcb578 ($39.12 in chips)
Seat 3: Hero ($25.35 in chips)
Seat 4: 6d33a0cb ($32.38 in chips)
Seat 5: e5667aa7 ($94.91 in chips)
Seat 6: b912752f ($32.6 in chips)
7adcb578: posts small blind $0.1
Hero: posts big blind $0.25
*** HOLE CARDS ***
Dealt to 57b0a14c 
Dealt to 7adcb578 
Dealt to Hero [5h 2d]
Dealt to 6d33a0cb 
Dealt to e5667aa7 
Dealt to b912752f 
6d33a0cb: raises $0.38 to $0.63
e5667aa7: folds
b912752f: folds
57b0a14c: folds
7adcb578: folds
Hero: folds
Uncalled bet ($0.38) returned to 6d33a0cb
*** SHOWDOWN ***
6d33a0cb collected $0.6 from pot
*** SUMMARY ***
Total pot $0.6
Seat 1: 57b0a14c (button) folded before Flop (didn't bet)
Seat 2: 7adcb578 (small blind) folded before Flop
Seat 3: Hero (big blind) folded before Flop
Seat 4: 6d33a0cb collected ($0.6)
Seat 5: e5667aa7 folded before Flop (didn't bet)
Seat 6: b912752f folded before Flop (didn't bet)


Poker Hand #RC92801319: Hold'em No Limit ($0.1/$0.25) - 2020/04/02 23:25:22
Table 'RushAndCash46233' 6-max Seat #1 is the button
Seat 1: d1e38640 ($30.65 in chips)
Seat 2: Hero ($25.1 in chips)
Seat 3: e5667aa7 ($94.91 in chips)
Seat 4: 2bebd6e7 ($36.06 in chips)
Seat 5: e4b820db ($55.16 in chips)
Seat 6: 44db54de ($25.45 in chips)
Hero: posts small blind $0.1
e5667aa7: posts big blind $0.25
*** HOLE CARDS ***
Dealt to d1e38640 
Dealt to Hero [8s 6d]
Dealt to e5667aa7 
Dealt to 2bebd6e7 
Dealt to e4b820db 
Dealt to 44db54de 
2bebd6e7: folds
e4b820db: folds
44db54de: folds
d1e38640: folds
Hero: folds
Uncalled bet ($0.15) returned to e5667aa7
*** SHOWDOWN ***
e5667aa7 collected $0.2 from pot
*** SUMMARY ***
Total pot $0.2
Seat 1: d1e38640 (button) folded before Flop (didn't bet)
Seat 2: Hero (small blind) folded before Flop
Seat 3: e5667aa7 (big blind) collected ($0.2)
Seat 4: 2bebd6e7 folded before Flop (didn't bet)
Seat 5: e4b820db folded before Flop (didn't bet)
Seat 6: 44db54de folded before Flop (didn't bet)


Poker Hand #RC92801359: Hold'em No Limit ($0.1/$0.25) - 2020/04/02 23:25:27
Table 'RushAndCash46238' 6-max Seat #1 is the button
Seat 1: Hero ($25 in chips)
Seat 2: d1e38640 ($30.65 in chips)
Seat 3: 2611a367 ($26.4 in chips)
Seat 4: 2d8ae955 ($25 in chips)
Seat 5: 2eabd980 ($19.07 in chips)
Seat 6: abf9b61c ($30.02 in chips)
d1e38640: posts small blind $0.1
2611a367: posts big blind $0.25
*** HOLE CARDS ***
Dealt to Hero [5c 2h]
Dealt to d1e38640 
Dealt to 2611a367 
Dealt to 2d8ae955 
Dealt to 2eabd980 
Dealt to abf9b61c 
2d8ae955: folds
2eabd980: folds
abf9b61c: folds
Hero: folds
d1e38640: raises $0.38 to $0.63
2611a367: folds
Uncalled bet ($0.38) returned to d1e38640
*** SHOWDOWN ***
d1e38640 collected $0.5 from pot
*** SUMMARY ***
Total pot $0.5
Seat 1: Hero (button) folded before Flop (didn't bet)
Seat 2: d1e38640 (small blind) collected ($0.5)
Seat 3: 2611a367 (big blind) folded before Flop
Seat 4: 2d8ae955 folded before Flop (didn't bet)
Seat 5: 2eabd980 folded before Flop (didn't bet)
Seat 6: abf9b61c folded before Flop (didn't bet)


Poker Hand #RC92801385: Hold'em No Limit ($0.1/$0.25) - 2020/04/02 23:25:31
Table 'RushAndCash46242' 6-max Seat #1 is the button
Seat 1: 2d8ae955 ($25 in chips)
Seat 2: 33dc6448 ($32.36 in chips)
Seat 3: 359d23bf ($28.03 in chips)
Seat 4: Hero ($25 in chips)
Seat 5: e4b820db ($55.16 in chips)
Seat 6: 2eabd980 ($19.07 in chips)
33dc6448: posts small blind $0.1
359d23bf: posts big blind $0.25
*** HOLE CARDS ***
Dealt to 2d8ae955 
Dealt to 33dc6448 
Dealt to 359d23bf 
Dealt to Hero [As 8h]
Dealt to e4b820db 
Dealt to 2eabd980 
Hero: folds
e4b820db: folds
2eabd980: folds
2d8ae955: raises $0.5 to $0.75
33dc6448: folds
359d23bf: raises $1.75 to $2.5
2d8ae955: folds
Uncalled bet ($1.75) returned to 359d23bf
*** SHOWDOWN ***
359d23bf collected $1.6 from pot
*** SUMMARY ***
Total pot $1.6
Seat 1: 2d8ae955 (button) folded before Flop
Seat 2: 33dc6448 (small blind) folded before Flop
Seat 3: 359d23bf (big blind) collected ($1.6)
Seat 4: Hero folded before Flop (didn't bet)
Seat 5: e4b820db folded before Flop (didn't bet)
Seat 6: 2eabd980 folded before Flop (didn't bet)


Poker Hand #RC92801406: Hold'em No Limit ($0.1/$0.25) - 2020/04/02 23:25:35
Table 'RushAndCash46244' 6-max Seat #1 is the button
Seat 1: 2611a367 ($26.15 in chips)
Seat 2: e5667aa7 ($95.01 in chips)
Seat 3: 7db17161 ($54.87 in chips)
Seat 4: 569c22a2 ($25.91 in chips)
Seat 5: Hero ($25 in chips)
Seat 6: f92e6d28 ($31.65 in chips)
e5667aa7: posts small blind $0.1
7db17161: posts big blind $0.25
*** HOLE CARDS ***
Dealt to 2611a367 
Dealt to e5667aa7 
Dealt to 7db17161 
Dealt to 569c22a2 
Dealt to Hero [5s 2d]
Dealt to f92e6d28 
569c22a2: folds
Hero: folds
f92e6d28: folds
2611a367: folds
e5667aa7: raises $0.38 to $0.63
7db17161: folds
Uncalled bet ($0.38) returned to e5667aa7
*** SHOWDOWN ***
e5667aa7 collected $0.5 from pot
*** SUMMARY ***
Total pot $0.5
Seat 1: 2611a367 (button) folded before Flop (didn't bet)
Seat 2: e5667aa7 (small blind) collected ($0.5)
Seat 3: 7db17161 (big blind) folded before Flop
Seat 4: 569c22a2 folded before Flop (didn't bet)
Seat 5: Hero folded before Flop (didn't bet)
Seat 6: f92e6d28 folded before Flop (didn't bet)


Poker Hand #RC92801429: Hold'em No Limit ($0.1/$0.25) - 2020/04/02 23:25:39
Table 'RushAndCash46247' 6-max Seat #1 is the button
Seat 1: f43af171 ($24.26 in chips)
Seat 2: 2bebd6e7 ($36.06 in chips)
Seat 3: cbf0ae65 ($12.5 in chips)
Seat 4: 2611a367 ($26.15 in chips)
Seat 5: Hero ($25 in chips)
Seat 6: 5a8dd9c3 ($25 in chips)
2bebd6e7: posts small blind $0.1
cbf0ae65: posts big blind $0.25
*** HOLE CARDS ***
Dealt to f43af171 
Dealt to 2bebd6e7 
Dealt to cbf0ae65 
Dealt to 2611a367 
Dealt to Hero [Th 8c]
Dealt to 5a8dd9c3 
2611a367: folds
Hero: folds
5a8dd9c3: folds
f43af171: folds
2bebd6e7: folds
Uncalled bet ($0.15) returned to cbf0ae65
*** SHOWDOWN ***
cbf0ae65 collected $0.2 from pot
*** SUMMARY ***
Total pot $0.2
Seat 1: f43af171 (button) folded before Flop (didn't bet)
Seat 2: 2bebd6e7 (small blind) folded before Flop
Seat 3: cbf0ae65 (big blind) collected ($0.2)
Seat 4: 2611a367 folded before Flop (didn't bet)
Seat 5: Hero folded before Flop (didn't bet)
Seat 6: 5a8dd9c3 folded before Flop (didn't bet)


Poker Hand #RC92801450: Hold'em No Limit ($0.1/$0.25) - 2020/04/02 23:25:42
Table 'RushAndCash46249' 6-max Seat #1 is the button
Seat 1: f0b740a4 ($10.93 in chips)
Seat 2: Hero ($25 in chips)
Seat 3: bcf79ef3 ($12.5 in chips)
Seat 4: e4b820db ($55.16 in chips)
Seat 5: 569c22a2 ($25.91 in chips)
Seat 6: abf9b61c ($30.02 in chips)
Hero: posts small blind $0.1
bcf79ef3: posts big blind $0.25
*** HOLE CARDS ***
Dealt to f0b740a4 
Dealt to Hero [Js 9s]
Dealt to bcf79ef3 
Dealt to e4b820db 
Dealt to 569c22a2 
Dealt to abf9b61c 
e4b820db: folds
569c22a2: folds
abf9b61c: raises $0.38 to $0.63
f0b740a4: calls $0.63
Hero: folds
bcf79ef3: folds
*** FLOP *** [Tc 2s 3c]
abf9b61c: checks
f0b740a4: checks
*** TURN *** [Tc 2s 3c] [6c]
abf9b61c: checks
f0b740a4: checks
*** RIVER *** [Tc 2s 3c 6c] [8s]
abf9b61c: checks
f0b740a4: checks
abf9b61c: shows [Kc Qd] (King-High)
f0b740a4: shows [Qs Ac] (Ace-High)
*** SHOWDOWN ***
f0b740a4 collected $1.61 from pot
*** SUMMARY ***
Total pot $1.61
Board [Tc 2s 3c 6c 8s]
Seat 1: f0b740a4 (button) showed [Ac Qs] and won ($1.61) with Ace-High
Seat 2: Hero (small blind) folded before Flop
Seat 3: bcf79ef3 (big blind) folded before Flop
Seat 4: e4b820db folded before Flop (didn't bet)
Seat 5: 569c22a2 folded before Flop (didn't bet)
Seat 6: abf9b61c showed [Kc Qd] and lost with King-High


Poker Hand #RC92801597: Hold'em No Limit ($0.1/$0.25) - 2020/04/02 23:26:08
Table 'RushAndCash46270' 6-max Seat #1 is the button
Seat 1: dc9aea4f ($6.67 in chips)
Seat 2: 163fde06 ($32.41 in chips)
Seat 3: Hero ($25 in chips)
Seat 4: ab641f7 ($61.25 in chips)
Seat 5: ca320935 ($72.69 in chips)
Seat 6: 33dc6448 ($32.61 in chips)
163fde06: posts small blind $0.1
Hero: posts big blind $0.25
*** HOLE CARDS ***
Dealt to dc9aea4f 
Dealt to 163fde06 
Dealt to Hero [6c 4h]
Dealt to ab641f7 
Dealt to ca320935 
Dealt to 33dc6448 
ab641f7: folds
ca320935: raises $0.5 to $0.75
33dc6448: folds
dc9aea4f: calls $0.75
163fde06: folds
Hero: folds
*** FLOP *** [4c Jh 3h]
ca320935: checks
dc9aea4f: bets $1
ca320935: raises $8 to $9
dc9aea4f: calls $4.92 and is all-in
Uncalled bet ($3.08) returned to ca320935
ca320935: shows [4d 4s] (Three Fours)
dc9aea4f: shows [Th Kh] (King-High)
*** FIRST TURN *** [4c Jh 3h] [6h]
*** FIRST RIVER *** [4c Jh 3h 6h] [6d]
*** SECOND TURN *** [4c Jh 3h] [Ah]
*** SECOND RIVER *** [4c Jh 3h Ah] [2d]
*** FIRST SHOWDOWN ***
ca320935 collected $6.84 from pot
*** SECOND SHOWDOWN ***
dc9aea4f collected $6.84 from pot
*** SUMMARY ***
Total pot $13.69
Hand was run two times
FIRST Board [4c Jh 3h 6h 6d]
SECOND Board [4c Jh 3h Ah 2d]
Seat 1: dc9aea4f (button) showed [Kh Th] and lost with King High Flush, and won ($6.84) with Ace High Flush
Seat 2: 163fde06 (small blind) folded before Flop
Seat 3: Hero (big blind) folded before Flop
Seat 4: ab641f7 folded before Flop (didn't bet)
Seat 5: ca320935 showed [4s 4d] and won ($6.84) with Fours Full over Sixes, and lost with Three Fours
Seat 6: 33dc6448 folded before Flop (didn't bet)


Poker Hand #RC92801622: Hold'em No Limit ($0.1/$0.25) - 2020/04/02 23:26:12
Table 'RushAndCash46274' 6-max Seat #1 is the button
Seat 1: Hero ($25 in chips)
Seat 2: bcf79ef3 ($12.25 in chips)
Seat 3: ab641f7 ($61.25 in chips)
Seat 4: 57b0a14c ($26.33 in chips)
Seat 5: 243ca57e ($25 in chips)
Seat 6: e145ce2 ($12.5 in chips)
bcf79ef3: posts small blind $0.1
ab641f7: posts big blind $0.25
*** HOLE CARDS ***
Dealt to Hero [8h 8c]
Dealt to bcf79ef3 
Dealt to ab641f7 
Dealt to 57b0a14c 
Dealt to 243ca57e 
Dealt to e145ce2 
57b0a14c: folds
243ca57e: folds
e145ce2: folds
Hero: raises $0.38 to $0.63
bcf79ef3: folds
ab641f7: folds
Uncalled bet ($0.38) returned to Hero
*** SHOWDOWN ***
Hero collected $0.6 from pot
*** SUMMARY ***
Total pot $0.6
Seat 1: Hero (button) collected ($0.6)
Seat 2: bcf79ef3 (small blind) folded before Flop
Seat 3: ab641f7 (big blind) folded before Flop
Seat 4: 57b0a14c folded before Flop (didn't bet)
Seat 5: 243ca57e folded before Flop (didn't bet)
Seat 6: e145ce2 folded before Flop (didn't bet)


Poker Hand #RC92801713: Hold'em No Limit ($0.1/$0.25) - 2020/04/02 23:26:28
Table 'RushAndCash46287' 6-max Seat #1 is the button
Seat 1: 7eb96805 ($11.52 in chips)
Seat 2: eb18162e ($35.3 in chips)
Seat 3: f19292be ($32.07 in chips)
Seat 4: Hero ($25.35 in chips)
Seat 5: bd35f4c4 ($35.04 in chips)
Seat 6: b1240fa5 ($46.77 in chips)
eb18162e: posts small blind $0.1
f19292be: posts big blind $0.25
*** HOLE CARDS ***
Dealt to 7eb96805 
Dealt to eb18162e 
Dealt to f19292be 
Dealt to Hero [5c 4c]
Dealt to bd35f4c4 
Dealt to b1240fa5 
Hero: folds
bd35f4c4: folds
b1240fa5: folds
7eb96805: raises $0.38 to $0.63
eb18162e: folds
f19292be: folds
Uncalled bet ($0.38) returned to 7eb96805
*** SHOWDOWN ***
7eb96805 collected $0.6 from pot
*** SUMMARY ***
Total pot $0.6
Seat 1: 7eb96805 (button) collected ($0.6)
Seat 2: eb18162e (small blind) folded before Flop
Seat 3: f19292be (big blind) folded before Flop
Seat 4: Hero folded before Flop (didn't bet)
Seat 5: bd35f4c4 folded before Flop (didn't bet)
Seat 6: b1240fa5 folded before Flop (didn't bet)


Poker Hand #RC92801738: Hold'em No Limit ($0.1/$0.25) - 2020/04/02 23:26:32
Table 'RushAndCash46290' 6-max Seat #1 is the button
Seat 1: c6233f33 ($25 in chips)
Seat 2: d548caa1 ($37.62 in chips)
Seat 3: 243ca57e ($25 in chips)
Seat 4: Hero ($25.35 in chips)
Seat 5: 1c532a9e ($16.7 in chips)
Seat 6: 7adcb578 ($41.36 in chips)
d548caa1: posts small blind $0.1
243ca57e: posts big blind $0.25
*** HOLE CARDS ***
Dealt to c6233f33 
Dealt to d548caa1 
Dealt to 243ca57e 
Dealt to Hero [5h 2s]
Dealt to 1c532a9e 
Dealt to 7adcb578 
Hero: folds
1c532a9e: folds
7adcb578: folds
c6233f33: raises $0.38 to $0.63
d548caa1: raises $0.38 to $1.01
243ca57e: folds
c6233f33: calls $0.38
*** FLOP *** [8h 6d 3s]
d548caa1: checks
c6233f33: checks
*** TURN *** [8h 6d 3s] [3c]
d548caa1: checks
c6233f33: bets $1.5
d548caa1: calls $1.5
*** RIVER *** [8h 6d 3s 3c] [Th]
d548caa1: checks
c6233f33: bets $13.1
d548caa1: folds
Uncalled bet ($13.1) returned to c6233f33
*** SHOWDOWN ***
c6233f33 collected $5.27 from pot
*** SUMMARY ***
Total pot $5.27
Board [8h 6d 3s 3c Th]
Seat 1: c6233f33 (button) won ($5.27)
Seat 2: d548caa1 (small blind) folded on the River
Seat 3: 243ca57e (big blind) folded before Flop
Seat 4: Hero folded before Flop (didn't bet)
Seat 5: 1c532a9e folded before Flop (didn't bet)
Seat 6: 7adcb578 folded before Flop (didn't bet)


Poker Hand #RC92801761: Hold'em No Limit ($0.1/$0.25) - 2020/04/02 23:26:36
Table 'RushAndCash46293' 6-max Seat #1 is the button
Seat 1: 2eabd980 ($20.62 in chips)
Seat 2: 97dacd30 ($11.9 in chips)
Seat 3: bb54cb76 ($49.79 in chips)
Seat 4: 163fde06 ($32.41 in chips)
Seat 5: Hero ($25.35 in chips)
Seat 6: 89a3eced ($226.3 in chips)
97dacd30: posts small blind $0.1
bb54cb76: posts big blind $0.25
*** HOLE CARDS ***
Dealt to 2eabd980 
Dealt to 97dacd30 
Dealt to bb54cb76 
Dealt to 163fde06 
Dealt to Hero [9c 8h]
Dealt to 89a3eced 
163fde06: folds
Hero: folds
89a3eced: folds
2eabd980: folds
97dacd30: calls $0.15
bb54cb76: raises $0.75 to $1
97dacd30: calls $0.75
*** FLOP *** [3c Ad Ah]
97dacd30: checks
bb54cb76: checks
*** TURN *** [3c Ad Ah] [Qs]
97dacd30: checks
bb54cb76: bets $1.5
97dacd30: calls $1.5
*** RIVER *** [3c Ad Ah Qs] [4h]
97dacd30: checks
bb54cb76: bets $47.29 and is all-in
97dacd30: folds
Uncalled bet ($47.29) returned to bb54cb76
*** SHOWDOWN ***
bb54cb76 collected $5 from pot
*** SUMMARY ***
Total pot $5
Board [3c Ad Ah Qs 4h]
Seat 1: 2eabd980 (button) folded before Flop (didn't bet)
Seat 2: 97dacd30 (small blind) folded on the River
Seat 3: bb54cb76 (big blind) won ($5)
Seat 4: 163fde06 folded before Flop (didn't bet)
Seat 5: Hero folded before Flop (didn't bet)
Seat 6: 89a3eced folded before Flop (didn't bet)


Poker Hand #RC92801789: Hold'em No Limit ($0.1/$0.25) - 2020/04/02 23:26:41
Table 'RushAndCash46296' 6-max Seat #1 is the button
Seat 1: c28873d2 ($50.48 in chips)
Seat 2: 33dc6448 ($31.98 in chips)
Seat 3: Hero ($25.35 in chips)
Seat 4: 833dc1e7 ($73.65 in chips)
Seat 5: eb18162e ($35.2 in chips)
Seat 6: 163fde06 ($32.41 in chips)
33dc6448: posts small blind $0.1
Hero: posts big blind $0.25
*** HOLE CARDS ***
Dealt to c28873d2 
Dealt to 33dc6448 
Dealt to Hero [Qc Tc]
Dealt to 833dc1e7 
Dealt to eb18162e 
Dealt to 163fde06 
833dc1e7: folds
eb18162e: raises $0.5 to $0.75
163fde06: folds
c28873d2: folds
33dc6448: folds
Hero: folds
Uncalled bet ($0.5) returned to eb18162e
*** SHOWDOWN ***
eb18162e collected $0.6 from pot
*** SUMMARY ***
Total pot $0.6
Seat 1: c28873d2 (button) folded before Flop (didn't bet)
Seat 2: 33dc6448 (small blind) folded before Flop
Seat 3: Hero (big blind) folded before Flop
Seat 4: 833dc1e7 folded before Flop (didn't bet)
Seat 5: eb18162e collected ($0.6)
Seat 6: 163fde06 folded before Flop (didn't bet)


Poker Hand #RC92801846: Hold'em No Limit ($0.1/$0.25) - 2020/04/02 23:26:52
Table 'RushAndCash46303' 6-max Seat #1 is the button
Seat 1: 803a0c06 ($25 in chips)
Seat 2: Hero ($25.1 in chips)
Seat 3: c427ddfc ($29.48 in chips)
Seat 4: cbf0ae65 ($12.85 in chips)
Seat 5: 9c1f26b8 ($25 in chips)
Seat 6: 5b73fbfa ($52.04 in chips)
Hero: posts small blind $0.1
c427ddfc: posts big blind $0.25
*** HOLE CARDS ***
Dealt to 803a0c06 
Dealt to Hero [Td 5d]
Dealt to c427ddfc 
Dealt to cbf0ae65 
Dealt to 9c1f26b8 
Dealt to 5b73fbfa 
cbf0ae65: raises $0.38 to $0.63
9c1f26b8: folds
5b73fbfa: folds
803a0c06: raises $2.02 to $2.65
Hero: folds
c427ddfc: folds
cbf0ae65: folds
Uncalled bet ($2.02) returned to 803a0c06
*** SHOWDOWN ***
803a0c06 collected $1.61 from pot
*** SUMMARY ***
Total pot $1.61
Seat 1: 803a0c06 (button) collected ($1.61)
Seat 2: Hero (small blind) folded before Flop
Seat 3: c427ddfc (big blind) folded before Flop
Seat 4: cbf0ae65 folded before Flop
Seat 5: 9c1f26b8 folded before Flop (didn't bet)
Seat 6: 5b73fbfa folded before Flop (didn't bet)


Poker Hand #RC92801876: Hold'em No Limit ($0.1/$0.25) - 2020/04/02 23:26:58
Table 'RushAndCash46308' 6-max Seat #1 is the button
Seat 1: Hero ($25 in chips)
Seat 2: c28873d2 ($50.23 in chips)
Seat 3: b320ed6a ($55.4 in chips)
Seat 4: b561aa9d ($29.43 in chips)
Seat 5: e145ce2 ($12.5 in chips)
Seat 6: 33dc6448 ($31.88 in chips)
c28873d2: posts small blind $0.1
b320ed6a: posts big blind $0.25
*** HOLE CARDS ***
Dealt to Hero [Qh Jd]
Dealt to c28873d2 
Dealt to b320ed6a 
Dealt to b561aa9d 
Dealt to e145ce2 
Dealt to 33dc6448 
b561aa9d: folds
e145ce2: folds
33dc6448: folds
Hero: raises $0.38 to $0.63
c28873d2: folds
b320ed6a: folds
Uncalled bet ($0.38) returned to Hero
*** SHOWDOWN ***
Hero collected $0.6 from pot
*** SUMMARY ***
Total pot $0.6
Seat 1: Hero (button) collected ($0.6)
Seat 2: c28873d2 (small blind) folded before Flop
Seat 3: b320ed6a (big blind) folded before Flop
Seat 4: b561aa9d folded before Flop (didn't bet)
Seat 5: e145ce2 folded before Flop (didn't bet)
Seat 6: 33dc6448 folded before Flop (didn't bet)


Poker Hand #RC92802001: Hold'em No Limit ($0.1/$0.25) - 2020/04/02 23:27:22
Table 'RushAndCash46327' 6-max Seat #1 is the button
Seat 1: 2bebd6e7 ($41.32 in chips)
Seat 2: e145ce2 ($12.85 in chips)
Seat 3: 33dc6448 ($31.78 in chips)
Seat 4: c27aaa40 ($83.5 in chips)
Seat 5: 243ca57e ($25.25 in chips)
Seat 6: Hero ($25.35 in chips)
e145ce2: posts small blind $0.1
33dc6448: posts big blind $0.25
*** HOLE CARDS ***
Dealt to 2bebd6e7 
Dealt to e145ce2 
Dealt to 33dc6448 
Dealt to c27aaa40 
Dealt to 243ca57e 
Dealt to Hero [Td 6d]
c27aaa40: folds
243ca57e: folds
Hero: folds
2bebd6e7: folds
e145ce2: raises $0.5 to $0.75
33dc6448: calls $0.5
*** FLOP *** [Ac Kh Jd]
e145ce2: bets $0.8
33dc6448: calls $0.8
*** TURN *** [Ac Kh Jd] [3h]
e145ce2: bets $1.6
33dc6448: raises $28.63 to $30.23 and is all-in
e145ce2: calls $9.7 and is all-in
Uncalled bet ($18.93) returned to 33dc6448
33dc6448: shows [Ts Qd] (Aces-High Straight)
e145ce2: shows [Ah 5h] (Pair of Aces)
*** FIRST RIVER *** [Ac Kh Jd 3h] [6s]
*** SECOND RIVER *** [Ac Kh Jd 3h] [5s]
*** FIRST SHOWDOWN ***
33dc6448 collected $12.85 from pot
*** SECOND SHOWDOWN ***
33dc6448 collected $12.85 from pot
*** SUMMARY ***
Total pot $25.7
Hand was run two times
FIRST Board [Ac Kh Jd 3h 6s]
SECOND Board [Ac Kh Jd 3h 5s]
Seat 1: 2bebd6e7 (button) folded before Flop (didn't bet)
Seat 2: e145ce2 (small blind) showed [Ah 5h] and lost with Pair of Aces, and lost with Pair of Aces and Pair of Fives
Seat 3: 33dc6448 (big blind) showed [Qd Ts] and won ($12.85) with Aces-High Straight, and won ($12.85) with Aces-High Straight
Seat 4: c27aaa40 folded before Flop (didn't bet)
Seat 5: 243ca57e folded before Flop (didn't bet)
Seat 6: Hero folded before Flop (didn't bet)


Poker Hand #RC92802027: Hold'em No Limit ($0.1/$0.25) - 2020/04/02 23:27:26
Table 'RushAndCash46331' 6-max Seat #1 is the button
Seat 1: 97dacd30 ($9.4 in chips)
Seat 2: bb54cb76 ($52.04 in chips)
Seat 3: a36379d9 ($38.89 in chips)
Seat 4: c427ddfc ($29.23 in chips)
Seat 5: 2eabd980 ($20.17 in chips)
Seat 6: Hero ($25.35 in chips)
bb54cb76: posts small blind $0.1
a36379d9: posts big blind $0.25
*** HOLE CARDS ***
Dealt to 97dacd30 
Dealt to bb54cb76 
Dealt to a36379d9 
Dealt to c427ddfc 
Dealt to 2eabd980 
Dealt to Hero [Qc 3s]
c427ddfc: folds
2eabd980: calls $0.25
Hero: folds
97dacd30: folds
bb54cb76: folds
a36379d9: checks
*** FLOP *** [9c 5d 6s]
a36379d9: checks
2eabd980: checks
*** TURN *** [9c 5d 6s] [2s]
a36379d9: bets $0.4
2eabd980: folds
Uncalled bet ($0.4) returned to a36379d9
*** SHOWDOWN ***
a36379d9 collected $0.6 from pot
*** SUMMARY ***
Total pot $0.6
Board [9c 5d 6s 2s]
Seat 1: 97dacd30 (button) folded before Flop (didn't bet)
Seat 2: bb54cb76 (small blind) folded before Flop
Seat 3: a36379d9 (big blind) won ($0.6)
Seat 4: c427ddfc folded before Flop (didn't bet)
Seat 5: 2eabd980 folded on the Turn
Seat 6: Hero folded before Flop (didn't bet)


Poker Hand #RC92802045: Hold'em No Limit ($0.1/$0.25) - 2020/04/02 23:27:30
Table 'RushAndCash46334' 6-max Seat #1 is the button
Seat 1: e3fa4802 ($29.47 in chips)
Seat 2: e4b820db ($54.91 in chips)
Seat 3: 2611a367 ($22.55 in chips)
Seat 4: 1e7ee1e0 ($12.35 in chips)
Seat 5: Hero ($25.35 in chips)
Seat 6: 569c22a2 ($25 in chips)
e4b820db: posts small blind $0.1
2611a367: posts big blind $0.25
*** HOLE CARDS ***
Dealt to e3fa4802 
Dealt to e4b820db 
Dealt to 2611a367 
Dealt to 1e7ee1e0 
Dealt to Hero [4h 2s]
Dealt to 569c22a2 
1e7ee1e0: folds
Hero: folds
569c22a2: folds
e3fa4802: folds
e4b820db: raises $0.75 to $1
2611a367: folds
Uncalled bet ($0.75) returned to e4b820db
*** SHOWDOWN ***
e4b820db collected $0.5 from pot
*** SUMMARY ***
Total pot $0.5
Seat 1: e3fa4802 (button) folded before Flop (didn't bet)
Seat 2: e4b820db (small blind) collected ($0.5)
Seat 3: 2611a367 (big blind) folded before Flop
Seat 4: 1e7ee1e0 folded before Flop (didn't bet)
Seat 5: Hero folded before Flop (didn't bet)
Seat 6: 569c22a2 folded before Flop (didn't bet)


Poker Hand #RC92802060: Hold'em No Limit ($0.1/$0.25) - 2020/04/02 23:27:33
Table 'RushAndCash46337' 6-max Seat #1 is the button
Seat 1: 2bebd6e7 ($41.32 in chips)
Seat 2: 6d33a0cb ($33.4 in chips)
Seat 3: Hero ($25.35 in chips)
Seat 4: 2d8ae955 ($25.57 in chips)
Seat 5: f19292be ($30.69 in chips)
Seat 6: 97dacd30 ($9.4 in chips)
6d33a0cb: posts small blind $0.1
Hero: posts big blind $0.25
*** HOLE CARDS ***
Dealt to 2bebd6e7 
Dealt to 6d33a0cb 
Dealt to Hero [4d 2h]
Dealt to 2d8ae955 
Dealt to f19292be 
Dealt to 97dacd30 
2d8ae955: raises $0.5 to $0.75
f19292be: folds
97dacd30: folds
2bebd6e7: folds
6d33a0cb: folds
Hero: folds
Uncalled bet ($0.5) returned to 2d8ae955
*** SHOWDOWN ***
2d8ae955 collected $0.6 from pot
*** SUMMARY ***
Total pot $0.6
Seat 1: 2bebd6e7 (button) folded before Flop (didn't bet)
Seat 2: 6d33a0cb (small blind) folded before Flop
Seat 3: Hero (big blind) folded before Flop
Seat 4: 2d8ae955 collected ($0.6)
Seat 5: f19292be folded before Flop (didn't bet)
Seat 6: 97dacd30 folded before Flop (didn't bet)


Poker Hand #RC92802076: Hold'em No Limit ($0.1/$0.25) - 2020/04/02 23:27:35
Table 'RushAndCash46339' 6-max Seat #1 is the button
Seat 1: ca32c452 ($25.1 in chips)
Seat 2: Hero ($25.1 in chips)
Seat 3: 569c22a2 ($25 in chips)
Seat 4: 57b0a14c ($25.88 in chips)
Seat 5: 303a94f5 ($20 in chips)
Seat 6: 1e7ee1e0 ($12.35 in chips)
Hero: posts small blind $0.1
569c22a2: posts big blind $0.25
*** HOLE CARDS ***
Dealt to ca32c452 
Dealt to Hero [Tc 4d]
Dealt to 569c22a2 
Dealt to 57b0a14c 
Dealt to 303a94f5 
Dealt to 1e7ee1e0 
57b0a14c: folds
303a94f5: folds
1e7ee1e0: folds
ca32c452: folds
Hero: folds
Uncalled bet ($0.15) returned to 569c22a2
*** SHOWDOWN ***
569c22a2 collected $0.2 from pot
*** SUMMARY ***
Total pot $0.2
Seat 1: ca32c452 (button) folded before Flop (didn't bet)
Seat 2: Hero (small blind) folded before Flop
Seat 3: 569c22a2 (big blind) collected ($0.2)
Seat 4: 57b0a14c folded before Flop (didn't bet)
Seat 5: 303a94f5 folded before Flop (didn't bet)
Seat 6: 1e7ee1e0 folded before Flop (didn't bet)


Poker Hand #RC92802094: Hold'em No Limit ($0.1/$0.25) - 2020/04/02 23:27:39
Table 'RushAndCash46342' 6-max Seat #1 is the button
Seat 1: Hero ($25 in chips)
Seat 2: 3ce5fe08 ($28.74 in chips)
Seat 3: 2611a367 ($22.3 in chips)
Seat 4: c28873d2 ($50.13 in chips)
Seat 5: 7eb96805 ($11.02 in chips)
Seat 6: b320ed6a ($55.05 in chips)
3ce5fe08: posts small blind $0.1
2611a367: posts big blind $0.25
*** HOLE CARDS ***
Dealt to Hero [5c 2d]
Dealt to 3ce5fe08 
Dealt to 2611a367 
Dealt to c28873d2 
Dealt to 7eb96805 
Dealt to b320ed6a 
c28873d2: folds
7eb96805: folds
b320ed6a: folds
Hero: folds
3ce5fe08: folds
Uncalled bet ($0.15) returned to 2611a367
*** SHOWDOWN ***
2611a367 collected $0.2 from pot
*** SUMMARY ***
Total pot $0.2
Seat 1: Hero (button) folded before Flop (didn't bet)
Seat 2: 3ce5fe08 (small blind) folded before Flop
Seat 3: 2611a367 (big blind) collected ($0.2)
Seat 4: c28873d2 folded before Flop (didn't bet)
Seat 5: 7eb96805 folded before Flop (didn't bet)
Seat 6: b320ed6a folded before Flop (didn't bet)


Poker Hand #RC92802116: Hold'em No Limit ($0.1/$0.25) - 2020/04/02 23:27:42
Table 'RushAndCash46346' 6-max Seat #1 is the button
Seat 1: 2611a367 ($22.05 in chips)
Seat 2: 569c22a2 ($25 in chips)
Seat 3: 359d23bf ($29.05 in chips)
Seat 4: ec75d237 ($25.35 in chips)
Seat 5: Hero ($25 in chips)
Seat 6: bb9a5aea ($13.55 in chips)
569c22a2: posts small blind $0.1
359d23bf: posts big blind $0.25
*** HOLE CARDS ***
Dealt to 2611a367 
Dealt to 569c22a2 
Dealt to 359d23bf 
Dealt to ec75d237 
Dealt to Hero [Kd Qd]
Dealt to bb9a5aea 
ec75d237: folds
Hero: raises $0.38 to $0.63
bb9a5aea: folds
2611a367: folds
569c22a2: folds
359d23bf: folds
Uncalled bet ($0.38) returned to Hero
*** SHOWDOWN ***
Hero collected $0.6 from pot
*** SUMMARY ***
Total pot $0.6
Seat 1: 2611a367 (button) folded before Flop (didn't bet)
Seat 2: 569c22a2 (small blind) folded before Flop
Seat 3: 359d23bf (big blind) folded before Flop
Seat 4: ec75d237 folded before Flop (didn't bet)
Seat 5: Hero collected ($0.6)
Seat 6: bb9a5aea folded before Flop (didn't bet)


Poker Hand #RC92802181: Hold'em No Limit ($0.1/$0.25) - 2020/04/02 23:27:55
Table 'RushAndCash46357' 6-max Seat #1 is the button
Seat 1: 92614a31 ($61.11 in chips)
Seat 2: ab641f7 ($61.35 in chips)
Seat 3: 5a8dd9c3 ($25 in chips)
Seat 4: 2611a367 ($22.4 in chips)
Seat 5: f43af171 ($23.43 in chips)
Seat 6: Hero ($25.35 in chips)
ab641f7: posts small blind $0.1
5a8dd9c3: posts big blind $0.25
*** HOLE CARDS ***
Dealt to 92614a31 
Dealt to ab641f7 
Dealt to 5a8dd9c3 
Dealt to 2611a367 
Dealt to f43af171 
Dealt to Hero [Qs Qd]
2611a367: folds
f43af171: folds
Hero: raises $0.38 to $0.63
92614a31: folds
ab641f7: folds
5a8dd9c3: calls $0.38
*** FLOP *** [4h 6c 9d]
5a8dd9c3: checks
Hero: bets $0.55
5a8dd9c3: calls $0.55
*** TURN *** [4h 6c 9d] [5s]
5a8dd9c3: checks
Hero: bets $2.02
5a8dd9c3: calls $2.02
*** RIVER *** [4h 6c 9d 5s] [4c]
5a8dd9c3: checks
Hero: checks
5a8dd9c3: shows [9c Qc] (Pair of Nines and Pair of Fours)
Hero: shows [Qs Qd] (Pair of Queens and Pair of Fours)
*** SHOWDOWN ***
Hero collected $6.5 from pot
*** SUMMARY ***
Total pot $6.5
Board [4h 6c 9d 5s 4c]
Seat 1: 92614a31 (button) folded before Flop (didn't bet)
Seat 2: ab641f7 (small blind) folded before Flop
Seat 3: 5a8dd9c3 (big blind) showed [Qc 9c] and lost with Pair of Nines and Pair of Fours
Seat 4: 2611a367 folded before Flop (didn't bet)
Seat 5: f43af171 folded before Flop (didn't bet)
Seat 6: Hero showed [Qs Qd] and won ($6.5) with Pair of Queens and Pair of Fours


Poker Hand #RC92802543: Hold'em No Limit ($0.1/$0.25) - 2020/04/02 23:29:03
Table 'RushAndCash46405' 6-max Seat #1 is the button
Seat 1: Hero ($28.33 in chips)
Seat 2: 833dc1e7 ($82.43 in chips)
Seat 3: f92e6d28 ($33.42 in chips)
Seat 4: b912752f ($20.9 in chips)
Seat 5: ab641f7 ($60.9 in chips)
Seat 6: 5a8dd9c3 ($25 in chips)
833dc1e7: posts small blind $0.1
f92e6d28: posts big blind $0.25
*** HOLE CARDS ***
Dealt to Hero [Ah 2h]
Dealt to 833dc1e7 
Dealt to f92e6d28 
Dealt to b912752f 
Dealt to ab641f7 
Dealt to 5a8dd9c3 
b912752f: folds
ab641f7: folds
5a8dd9c3: folds
Hero: raises $0.38 to $0.63
833dc1e7: folds
f92e6d28: folds
Uncalled bet ($0.38) returned to Hero
*** SHOWDOWN ***
Hero collected $0.6 from pot
*** SUMMARY ***
Total pot $0.6
Seat 1: Hero (button) collected ($0.6)
Seat 2: 833dc1e7 (small blind) folded before Flop
Seat 3: f92e6d28 (big blind) folded before Flop
Seat 4: b912752f folded before Flop (didn't bet)
Seat 5: ab641f7 folded before Flop (didn't bet)
Seat 6: 5a8dd9c3 folded before Flop (didn't bet)


Poker Hand #RC92802666: Hold'em No Limit ($0.1/$0.25) - 2020/04/02 23:29:29
Table 'RushAndCash46424' 6-max Seat #1 is the button
Seat 1: c27aaa40 ($82.27 in chips)
Seat 2: b1240fa5 ($43.49 in chips)
Seat 3: Hero ($28.68 in chips)
Seat 4: eb18162e ($36 in chips)
Seat 5: 1e7ee1e0 ($13.78 in chips)
Seat 6: 57b0a14c ($26.2 in chips)
b1240fa5: posts small blind $0.1
Hero: posts big blind $0.25
*** HOLE CARDS ***
Dealt to c27aaa40 
Dealt to b1240fa5 
Dealt to Hero [Jd 7s]
Dealt to eb18162e 
Dealt to 1e7ee1e0 
Dealt to 57b0a14c 
eb18162e: folds
1e7ee1e0: raises $0.38 to $0.63
57b0a14c: folds
c27aaa40: folds
b1240fa5: folds
Hero: folds
Uncalled bet ($0.38) returned to 1e7ee1e0
*** SHOWDOWN ***
1e7ee1e0 collected $0.6 from pot
*** SUMMARY ***
Total pot $0.6
Seat 1: c27aaa40 (button) folded before Flop (didn't bet)
Seat 2: b1240fa5 (small blind) folded before Flop
Seat 3: Hero (big blind) folded before Flop
Seat 4: eb18162e folded before Flop (didn't bet)
Seat 5: 1e7ee1e0 collected ($0.6)
Seat 6: 57b0a14c folded before Flop (didn't bet)


Poker Hand #RC92802685: Hold'em No Limit ($0.1/$0.25) - 2020/04/02 23:29:33
Table 'RushAndCash46426' 6-max Seat #1 is the button
Seat 1: 7adcb578 ($42.63 in chips)
Seat 2: bd35f4c4 ($38.19 in chips)
Seat 3: bb9a5aea ($11.87 in chips)
Seat 4: Hero ($28.43 in chips)
Seat 5: eb18162e ($36 in chips)
Seat 6: 92614a31 ($57.96 in chips)
bd35f4c4: posts small blind $0.1
bb9a5aea: posts big blind $0.25
*** HOLE CARDS ***
Dealt to 7adcb578 
Dealt to bd35f4c4 
Dealt to bb9a5aea 
Dealt to Hero [Jh 8d]
Dealt to eb18162e 
Dealt to 92614a31 
Hero: folds
eb18162e: folds
92614a31: folds
7adcb578: raises $0.25 to $0.5
bd35f4c4: folds
bb9a5aea: raises $1.2 to $1.7
7adcb578: calls $1.2
*** FLOP *** [Kc 3d 9s]
bb9a5aea: bets $2
7adcb578: folds
Uncalled bet ($2) returned to bb9a5aea
*** SHOWDOWN ***
bb9a5aea collected $3.5 from pot
*** SUMMARY ***
Total pot $3.5
Board [Kc 3d 9s]
Seat 1: 7adcb578 (button) folded on the Flop
Seat 2: bd35f4c4 (small blind) folded before Flop
Seat 3: bb9a5aea (big blind) won ($3.5)
Seat 4: Hero folded before Flop (didn't bet)
Seat 5: eb18162e folded before Flop (didn't bet)
Seat 6: 92614a31 folded before Flop (didn't bet)


Poker Hand #RC92802700: Hold'em No Limit ($0.1/$0.25) - 2020/04/02 23:29:35
Table 'RushAndCash46427' 6-max Seat #1 is the button
Seat 1: d1e38640 ($30.76 in chips)
Seat 2: Hero ($28.43 in chips)
Seat 3: ec75d237 ($28.13 in chips)
Seat 4: e145ce2 ($12.95 in chips)
Seat 5: c28873d2 ($50.69 in chips)
Seat 6: 803a0c06 ($25 in chips)
Hero: posts small blind $0.1
ec75d237: posts big blind $0.25
*** HOLE CARDS ***
Dealt to d1e38640 
Dealt to Hero [8h 6d]
Dealt to ec75d237 
Dealt to e145ce2 
Dealt to c28873d2 
Dealt to 803a0c06 
e145ce2: folds
c28873d2: raises $0.38 to $0.63
803a0c06: folds
d1e38640: folds
Hero: folds
ec75d237: folds
Uncalled bet ($0.38) returned to c28873d2
*** SHOWDOWN ***
c28873d2 collected $0.6 from pot
*** SUMMARY ***
Total pot $0.6
Seat 1: d1e38640 (button) folded before Flop (didn't bet)
Seat 2: Hero (small blind) folded before Flop
Seat 3: ec75d237 (big blind) folded before Flop
Seat 4: e145ce2 folded before Flop (didn't bet)
Seat 5: c28873d2 collected ($0.6)
Seat 6: 803a0c06 folded before Flop (didn't bet)


Poker Hand #RC92802722: Hold'em No Limit ($0.1/$0.25) - 2020/04/02 23:29:39
Table 'RushAndCash46430' 6-max Seat #1 is the button
Seat 1: ec75d237 ($27.88 in chips)
Seat 2: 569c22a2 ($28.24 in chips)
Seat 3: f92e6d28 ($33.07 in chips)
Seat 4: 5a8dd9c3 ($25 in chips)
Seat 5: Hero ($28.33 in chips)
Seat 6: dc9aea4f ($5.47 in chips)
569c22a2: posts small blind $0.1
f92e6d28: posts big blind $0.25
*** HOLE CARDS ***
Dealt to ec75d237 
Dealt to 569c22a2 
Dealt to f92e6d28 
Dealt to 5a8dd9c3 
Dealt to Hero [Qh 7d]
Dealt to dc9aea4f 
5a8dd9c3: folds
Hero: folds
dc9aea4f: folds
ec75d237: raises $0.5 to $0.75
569c22a2: folds
f92e6d28: folds
Uncalled bet ($0.5) returned to ec75d237
*** SHOWDOWN ***
ec75d237 collected $0.6 from pot
*** SUMMARY ***
Total pot $0.6
Seat 1: ec75d237 (button) collected ($0.6)
Seat 2: 569c22a2 (small blind) folded before Flop
Seat 3: f92e6d28 (big blind) folded before Flop
Seat 4: 5a8dd9c3 folded before Flop (didn't bet)
Seat 5: Hero folded before Flop (didn't bet)
Seat 6: dc9aea4f folded before Flop (didn't bet)


Poker Hand #RC92802743: Hold'em No Limit ($0.1/$0.25) - 2020/04/02 23:29:45
Table 'RushAndCash46434' 6-max Seat #1 is the button
Seat 1: b320ed6a ($56.42 in chips)
Seat 2: b1240fa5 ($43.39 in chips)
Seat 3: f19292be ($29.71 in chips)
Seat 4: 9c1f26b8 ($25.25 in chips)
Seat 5: 2eabd980 ($19.67 in chips)
Seat 6: Hero ($28.33 in chips)
b1240fa5: posts small blind $0.1
f19292be: posts big blind $0.25
*** HOLE CARDS ***
Dealt to b320ed6a 
Dealt to b1240fa5 
Dealt to f19292be 
Dealt to 9c1f26b8 
Dealt to 2eabd980 
Dealt to Hero [Qd 8s]
9c1f26b8: folds
2eabd980: folds
Hero: folds
b320ed6a: raises $0.38 to $0.63
b1240fa5: folds
f19292be: folds
Uncalled bet ($0.38) returned to b320ed6a
*** SHOWDOWN ***
b320ed6a collected $0.6 from pot
*** SUMMARY ***
Total pot $0.6
Seat 1: b320ed6a (button) collected ($0.6)
Seat 2: b1240fa5 (small blind) folded before Flop
Seat 3: f19292be (big blind) folded before Flop
Seat 4: 9c1f26b8 folded before Flop (didn't bet)
Seat 5: 2eabd980 folded before Flop (didn't bet)
Seat 6: Hero folded before Flop (didn't bet)


Poker Hand #RC92802762: Hold'em No Limit ($0.1/$0.25) - 2020/04/02 23:29:48
Table 'RushAndCash46436' 6-max Seat #1 is the button
Seat 1: d548caa1 ($43.94 in chips)
Seat 2: Hero ($28.33 in chips)
Seat 3: 92614a31 ($57.96 in chips)
Seat 4: 33dc6448 ($41.48 in chips)
Seat 5: 803a0c06 ($25 in chips)
Seat 6: 5a8dd9c3 ($25 in chips)
Hero: posts small blind $0.1
92614a31: posts big blind $0.25
*** HOLE CARDS ***
Dealt to d548caa1 
Dealt to Hero [8s 6c]
Dealt to 92614a31 
Dealt to 33dc6448 
Dealt to 803a0c06 
Dealt to 5a8dd9c3 
33dc6448: folds
803a0c06: folds
5a8dd9c3: folds
d548caa1: raises $0.38 to $0.63
Hero: folds
92614a31: calls $0.38
*** FLOP *** [6h Th Ac]
92614a31: checks
d548caa1: checks
*** TURN *** [6h Th Ac] [Kc]
92614a31: checks
d548caa1: bets $0.5
92614a31: calls $0.5
*** RIVER *** [6h Th Ac Kc] [Kh]
92614a31: checks
d548caa1: checks
92614a31: shows [6d Qd] (Pair of Kings and Pair of Sixes)
d548caa1: shows [3c Ad] (Pair of Aces and Pair of Kings)
*** SHOWDOWN ***
d548caa1 collected $2.36 from pot
*** SUMMARY ***
Total pot $2.36
Board [6h Th Ac Kc Kh]
Seat 1: d548caa1 (button) showed [Ad 3c] and won ($2.36) with Pair of Aces and Pair of Kings
Seat 2: Hero (small blind) folded before Flop
Seat 3: 92614a31 (big blind) showed [Qd 6d] and lost with Pair of Kings and Pair of Sixes
Seat 4: 33dc6448 folded before Flop (didn't bet)
Seat 5: 803a0c06 folded before Flop (didn't bet)
Seat 6: 5a8dd9c3 folded before Flop (didn't bet)


Poker Hand #RC92802787: Hold'em No Limit ($0.1/$0.25) - 2020/04/02 23:29:53
Table 'RushAndCash46439' 6-max Seat #1 is the button
Seat 1: Hero ($28.23 in chips)
Seat 2: a36379d9 ($39.28 in chips)
Seat 3: 1e7ee1e0 ($14.13 in chips)
Seat 4: bd35f4c4 ($38.09 in chips)
Seat 5: c2669a0b ($42.33 in chips)
Seat 6: 9c1f26b8 ($25.25 in chips)
a36379d9: posts small blind $0.1
1e7ee1e0: posts big blind $0.25
*** HOLE CARDS ***
Dealt to Hero [Qh Td]
Dealt to a36379d9 
Dealt to 1e7ee1e0 
Dealt to bd35f4c4 
Dealt to c2669a0b 
Dealt to 9c1f26b8 
bd35f4c4: folds
c2669a0b: raises $0.38 to $0.63
9c1f26b8: folds
Hero: folds
a36379d9: folds
1e7ee1e0: raises $1.47 to $2.1
c2669a0b: calls $1.47
*** FLOP *** [4d 4s 8s]
1e7ee1e0: bets $2.2
c2669a0b: calls $2.2
*** TURN *** [4d 4s 8s] [5c]
1e7ee1e0: bets $9.83 and is all-in
c2669a0b: calls $9.83
1e7ee1e0: shows [Kd Ac] (Pair of Fours)
c2669a0b: shows [6h 6s] (Pair of Sixes and Pair of Fours)
*** FIRST RIVER *** [4d 4s 8s 5c] [Ts]
*** SECOND RIVER *** [4d 4s 8s 5c] [Js]
*** FIRST SHOWDOWN ***
c2669a0b collected $14.18 from pot
*** SECOND SHOWDOWN ***
c2669a0b collected $14.18 from pot
*** SUMMARY ***
Total pot $28.36
Hand was run two times
FIRST Board [4d 4s 8s 5c Ts]
SECOND Board [4d 4s 8s 5c Js]
Seat 1: Hero (button) folded before Flop (didn't bet)
Seat 2: a36379d9 (small blind) folded before Flop
Seat 3: 1e7ee1e0 (big blind) showed [Ac Kd] and lost with Pair of Fours, and lost with Pair of Fours
Seat 4: bd35f4c4 folded before Flop (didn't bet)
Seat 5: c2669a0b showed [6s 6h] and won ($14.18) with Pair of Sixes and Pair of Fours, and won ($14.18) with Pair of Sixes and Pair of Fours
Seat 6: 9c1f26b8 folded before Flop (didn't bet)


Poker Hand #RC92802851: Hold'em No Limit ($0.1/$0.25) - 2020/04/02 23:30:04
Table 'RushAndCash46447' 6-max Seat #1 is the button
Seat 1: a1320bd6 ($111.53 in chips)
Seat 2: 33dc6448 ($41.83 in chips)
Seat 3: Hero ($28.23 in chips)
Seat 4: f0b740a4 ($11.1 in chips)
Seat 5: f92e6d28 ($32.72 in chips)
Seat 6: b320ed6a ($56.77 in chips)
33dc6448: posts small blind $0.1
Hero: posts big blind $0.25
*** HOLE CARDS ***
Dealt to a1320bd6 
Dealt to 33dc6448 
Dealt to Hero [Ts 4c]
Dealt to f0b740a4 
Dealt to f92e6d28 
Dealt to b320ed6a 
f0b740a4: folds
f92e6d28: folds
b320ed6a: folds
a1320bd6: folds
33dc6448: raises $0.5 to $0.75
Hero: folds
Uncalled bet ($0.5) returned to 33dc6448
*** SHOWDOWN ***
33dc6448 collected $0.5 from pot
*** SUMMARY ***
Total pot $0.5
Seat 1: a1320bd6 (button) folded before Flop (didn't bet)
Seat 2: 33dc6448 (small blind) collected ($0.5)
Seat 3: Hero (big blind) folded before Flop
Seat 4: f0b740a4 folded before Flop (didn't bet)
Seat 5: f92e6d28 folded before Flop (didn't bet)
Seat 6: b320ed6a folded before Flop (didn't bet)


Poker Hand #RC92802869: Hold'em No Limit ($0.1/$0.25) - 2020/04/02 23:30:07
Table 'RushAndCash46449' 6-max Seat #1 is the button
Seat 1: 9c1f26b8 ($25.25 in chips)
Seat 2: b912752f ($18.95 in chips)
Seat 3: a36379d9 ($39.18 in chips)
Seat 4: 569c22a2 ($28.14 in chips)
Seat 5: Hero ($27.98 in chips)
Seat 6: c427ddfc ($29.58 in chips)
b912752f: posts small blind $0.1
a36379d9: posts big blind $0.25
*** HOLE CARDS ***
Dealt to 9c1f26b8 
Dealt to b912752f 
Dealt to a36379d9 
Dealt to 569c22a2 
Dealt to Hero [9d 6c]
Dealt to c427ddfc 
569c22a2: folds
Hero: folds
c427ddfc: folds
9c1f26b8: folds
b912752f: raises $0.5 to $0.75
a36379d9: folds
Uncalled bet ($0.5) returned to b912752f
*** SHOWDOWN ***
b912752f collected $0.5 from pot
*** SUMMARY ***
Total pot $0.5
Seat 1: 9c1f26b8 (button) folded before Flop (didn't bet)
Seat 2: b912752f (small blind) collected ($0.5)
Seat 3: a36379d9 (big blind) folded before Flop
Seat 4: 569c22a2 folded before Flop (didn't bet)
Seat 5: Hero folded before Flop (didn't bet)
Seat 6: c427ddfc folded before Flop (didn't bet)


Poker Hand #RC92802889: Hold'em No Limit ($0.1/$0.25) - 2020/04/02 23:30:10
Table 'RushAndCash46452' 6-max Seat #1 is the button
Seat 1: 533b95e8 ($26.73 in chips)
Seat 2: b320ed6a ($56.77 in chips)
Seat 3: b6875a20 ($25 in chips)
Seat 4: 6d33a0cb ($31.69 in chips)
Seat 5: Hero ($27.98 in chips)
Seat 6: 57b0a14c ($26.2 in chips)
b320ed6a: posts small blind $0.1
b6875a20: posts big blind $0.25
*** HOLE CARDS ***
Dealt to 533b95e8 
Dealt to b320ed6a 
Dealt to b6875a20 
Dealt to 6d33a0cb 
Dealt to Hero [Tc 6s]
Dealt to 57b0a14c 
6d33a0cb: raises $0.5 to $0.75
Hero: folds
57b0a14c: folds
533b95e8: folds
b320ed6a: folds
b6875a20: folds
Uncalled bet ($0.5) returned to 6d33a0cb
*** SHOWDOWN ***
6d33a0cb collected $0.6 from pot
*** SUMMARY ***
Total pot $0.6
Seat 1: 533b95e8 (button) folded before Flop (didn't bet)
Seat 2: b320ed6a (small blind) folded before Flop
Seat 3: b6875a20 (big blind) folded before Flop
Seat 4: 6d33a0cb collected ($0.6)
Seat 5: Hero folded before Flop (didn't bet)
Seat 6: 57b0a14c folded before Flop (didn't bet)


Poker Hand #RC92802921: Hold'em No Limit ($0.1/$0.25) - 2020/04/02 23:30:16
Table 'RushAndCash46454' 6-max Seat #1 is the button
Seat 1: 57b0a14c ($26.2 in chips)
Seat 2: e145ce2 ($13.72 in chips)
Seat 3: 33dc6448 ($42.08 in chips)
Seat 4: Hero ($27.98 in chips)
Seat 5: 163fde06 ($37.69 in chips)
Seat 6: 97dacd30 ($7.68 in chips)
e145ce2: posts small blind $0.1
33dc6448: posts big blind $0.25
*** HOLE CARDS ***
Dealt to 57b0a14c 
Dealt to e145ce2 
Dealt to 33dc6448 
Dealt to Hero [7h 2s]
Dealt to 163fde06 
Dealt to 97dacd30 
Hero: folds
163fde06: folds
97dacd30: folds
57b0a14c: folds
e145ce2: raises $0.5 to $0.75
33dc6448: folds
Uncalled bet ($0.5) returned to e145ce2
*** SHOWDOWN ***
e145ce2 collected $0.5 from pot
*** SUMMARY ***
Total pot $0.5
Seat 1: 57b0a14c (button) folded before Flop (didn't bet)
Seat 2: e145ce2 (small blind) collected ($0.5)
Seat 3: 33dc6448 (big blind) folded before Flop
Seat 4: Hero folded before Flop (didn't bet)
Seat 5: 163fde06 folded before Flop (didn't bet)
Seat 6: 97dacd30 folded before Flop (didn't bet)


Poker Hand #RC92802946: Hold'em No Limit ($0.1/$0.25) - 2020/04/02 23:30:21
Table 'RushAndCash46457' 6-max Seat #1 is the button
Seat 1: bb9a5aea ($13.4 in chips)
Seat 2: 7adcb578 ($40.68 in chips)
Seat 3: 533b95e8 ($26.73 in chips)
Seat 4: c28873d2 ($50.94 in chips)
Seat 5: Hero ($27.98 in chips)
Seat 6: 569c22a2 ($28.14 in chips)
7adcb578: posts small blind $0.1
533b95e8: posts big blind $0.25
*** HOLE CARDS ***
Dealt to bb9a5aea 
Dealt to 7adcb578 
Dealt to 533b95e8 
Dealt to c28873d2 
Dealt to Hero [Jh 6c]
Dealt to 569c22a2 
c28873d2: folds
Hero: folds
569c22a2: folds
bb9a5aea: raises $0.38 to $0.63
7adcb578: raises $1.87 to $2.5
533b95e8: folds
bb9a5aea: folds
Uncalled bet ($1.87) returned to 7adcb578
*** SHOWDOWN ***
7adcb578 collected $1.51 from pot
*** SUMMARY ***
Total pot $1.51
Seat 1: bb9a5aea (button) folded before Flop
Seat 2: 7adcb578 (small blind) collected ($1.51)
Seat 3: 533b95e8 (big blind) folded before Flop
Seat 4: c28873d2 folded before Flop (didn't bet)
Seat 5: Hero folded before Flop (didn't bet)
Seat 6: 569c22a2 folded before Flop (didn't bet)


Poker Hand #RC92802977: Hold'em No Limit ($0.1/$0.25) - 2020/04/02 23:30:26
Table 'RushAndCash46460' 6-max Seat #1 is the button
Seat 1: 569c22a2 ($28.14 in chips)
Seat 2: cbf0ae65 ($10.59 in chips)
Seat 3: Hero ($27.98 in chips)
Seat 4: 9c1f26b8 ($25.15 in chips)
Seat 5: 243ca57e ($26.01 in chips)
Seat 6: e4b820db ($55.38 in chips)
cbf0ae65: posts small blind $0.1
Hero: posts big blind $0.25
*** HOLE CARDS ***
Dealt to 569c22a2 
Dealt to cbf0ae65 
Dealt to Hero [Ks Jc]
Dealt to 9c1f26b8 
Dealt to 243ca57e 
Dealt to e4b820db 
9c1f26b8: folds
243ca57e: folds
e4b820db: folds
569c22a2: folds
cbf0ae65: calls $0.15
Hero: raises $0.55 to $0.8
cbf0ae65: folds
Uncalled bet ($0.55) returned to Hero
*** SHOWDOWN ***
Hero collected $0.5 from pot
*** SUMMARY ***
Total pot $0.5
Seat 1: 569c22a2 (button) folded before Flop (didn't bet)
Seat 2: cbf0ae65 (small blind) folded before Flop
Seat 3: Hero (big blind) collected ($0.5)
Seat 4: 9c1f26b8 folded before Flop (didn't bet)
Seat 5: 243ca57e folded before Flop (didn't bet)
Seat 6: e4b820db folded before Flop (didn't bet)


Poker Hand #RC92803114: Hold'em No Limit ($0.1/$0.25) - 2020/04/02 23:30:52
Table 'RushAndCash46479' 6-max Seat #1 is the button
Seat 1: cbf0ae65 ($10.34 in chips)
Seat 2: Hero ($28.23 in chips)
Seat 3: f0b740a4 ($10.47 in chips)
Seat 4: d1e38640 ($26.36 in chips)
Seat 5: e5667aa7 ($97.28 in chips)
Seat 6: ca32c452 ($25 in chips)
Hero: posts small blind $0.1
f0b740a4: posts big blind $0.25
*** HOLE CARDS ***
Dealt to cbf0ae65 
Dealt to Hero [Qc 9h]
Dealt to f0b740a4 
Dealt to d1e38640 
Dealt to e5667aa7 
Dealt to ca32c452 
d1e38640: folds
e5667aa7: folds
ca32c452: folds
cbf0ae65: raises $0.38 to $0.63
Hero: folds
f0b740a4: calls $0.38
*** FLOP *** [7c 8c 4c]
f0b740a4: checks
cbf0ae65: bets $0.9
f0b740a4: calls $0.9
*** TURN *** [7c 8c 4c] [8h]
f0b740a4: checks
cbf0ae65: checks
*** RIVER *** [7c 8c 4c 8h] [6s]
f0b740a4: bets $1.6
cbf0ae65: folds
Uncalled bet ($1.6) returned to f0b740a4
*** SHOWDOWN ***
f0b740a4 collected $3.16 from pot
*** SUMMARY ***
Total pot $3.16
Board [7c 8c 4c 8h 6s]
Seat 1: cbf0ae65 (button) folded on the River
Seat 2: Hero (small blind) folded before Flop
Seat 3: f0b740a4 (big blind) won ($3.16)
Seat 4: d1e38640 folded before Flop (didn't bet)
Seat 5: e5667aa7 folded before Flop (didn't bet)
Seat 6: ca32c452 folded before Flop (didn't bet)


Poker Hand #RC92803216: Hold'em No Limit ($0.1/$0.25) - 2020/04/02 23:31:10
Table 'RushAndCash46493' 6-max Seat #1 is the button
Seat 1: Hero ($28.13 in chips)
Seat 2: cf7b9ac1 ($28.25 in chips)
Seat 3: bd35f4c4 ($34.14 in chips)
Seat 4: b561aa9d ($36.13 in chips)
Seat 5: c6233f33 ($29.97 in chips)
Seat 6: f19292be ($29.01 in chips)
cf7b9ac1: posts small blind $0.1
bd35f4c4: posts big blind $0.25
*** HOLE CARDS ***
Dealt to Hero [Kh 9h]
Dealt to cf7b9ac1 
Dealt to bd35f4c4 
Dealt to b561aa9d 
Dealt to c6233f33 
Dealt to f19292be 
b561aa9d: folds
c6233f33: folds
f19292be: folds
Hero: raises $0.38 to $0.63
cf7b9ac1: folds
bd35f4c4: raises $1.97 to $2.6
Hero: folds
Uncalled bet ($1.97) returned to bd35f4c4
*** SHOWDOWN ***
bd35f4c4 collected $1.36 from pot
*** SUMMARY ***
Total pot $1.36
Seat 1: Hero (button) folded before Flop
Seat 2: cf7b9ac1 (small blind) folded before Flop
Seat 3: bd35f4c4 (big blind) collected ($1.36)
Seat 4: b561aa9d folded before Flop (didn't bet)
Seat 5: c6233f33 folded before Flop (didn't bet)
Seat 6: f19292be folded before Flop (didn't bet)


Poker Hand #RC92803353: Hold'em No Limit ($0.1/$0.25) - 2020/04/02 23:31:34
Table 'RushAndCash46511' 6-max Seat #1 is the button
Seat 1: c6233f33 ($29.72 in chips)
Seat 2: bd35f4c4 ($34.81 in chips)
Seat 3: a1320bd6 ($113.34 in chips)
Seat 4: b6875a20 ($25 in chips)
Seat 5: b912752f ($19.96 in chips)
Seat 6: Hero ($27.5 in chips)
bd35f4c4: posts small blind $0.1
a1320bd6: posts big blind $0.25
*** HOLE CARDS ***
Dealt to c6233f33 
Dealt to bd35f4c4 
Dealt to a1320bd6 
Dealt to b6875a20 
Dealt to b912752f 
Dealt to Hero [Qd 2s]
b6875a20: folds
b912752f: folds
Hero: folds
c6233f33: folds
bd35f4c4: folds
Uncalled bet ($0.15) returned to a1320bd6
*** SHOWDOWN ***
a1320bd6 collected $0.2 from pot
*** SUMMARY ***
Total pot $0.2
Seat 1: c6233f33 (button) folded before Flop (didn't bet)
Seat 2: bd35f4c4 (small blind) folded before Flop
Seat 3: a1320bd6 (big blind) collected ($0.2)
Seat 4: b6875a20 folded before Flop (didn't bet)
Seat 5: b912752f folded before Flop (didn't bet)
Seat 6: Hero folded before Flop (didn't bet)


Poker Hand #RC92803380: Hold'em No Limit ($0.1/$0.25) - 2020/04/02 23:31:40
Table 'RushAndCash46516' 6-max Seat #1 is the button
Seat 1: 5136ebb4 ($33 in chips)
Seat 2: 5b73fbfa ($47.89 in chips)
Seat 3: a36379d9 ($39.63 in chips)
Seat 4: f43af171 ($23.85 in chips)
Seat 5: cf7b9ac1 ($28.25 in chips)
Seat 6: Hero ($27.5 in chips)
5b73fbfa: posts small blind $0.1
a36379d9: posts big blind $0.25
*** HOLE CARDS ***
Dealt to 5136ebb4 
Dealt to 5b73fbfa 
Dealt to a36379d9 
Dealt to f43af171 
Dealt to cf7b9ac1 
Dealt to Hero [Tc 8d]
f43af171: folds
cf7b9ac1: raises $0.5 to $0.75
Hero: folds
5136ebb4: folds
5b73fbfa: folds
a36379d9: folds
Uncalled bet ($0.5) returned to cf7b9ac1
*** SHOWDOWN ***
cf7b9ac1 collected $0.6 from pot
*** SUMMARY ***
Total pot $0.6
Seat 1: 5136ebb4 (button) folded before Flop (didn't bet)
Seat 2: 5b73fbfa (small blind) folded before Flop
Seat 3: a36379d9 (big blind) folded before Flop
Seat 4: f43af171 folded before Flop (didn't bet)
Seat 5: cf7b9ac1 collected ($0.6)
Seat 6: Hero folded before Flop (didn't bet)


Poker Hand #RC92803402: Hold'em No Limit ($0.1/$0.25) - 2020/04/02 23:31:43
Table 'RushAndCash46520' 6-max Seat #1 is the button
Seat 1: 2611a367 ($16.45 in chips)
Seat 2: abf9b61c ($28.81 in chips)
Seat 3: e5667aa7 ($97.18 in chips)
Seat 4: f19292be ($29.01 in chips)
Seat 5: 5b73fbfa ($47.79 in chips)
Seat 6: Hero ($27.5 in chips)
abf9b61c: posts small blind $0.1
e5667aa7: posts big blind $0.25
*** HOLE CARDS ***
Dealt to 2611a367 
Dealt to abf9b61c 
Dealt to e5667aa7 
Dealt to f19292be 
Dealt to 5b73fbfa 
Dealt to Hero [Ah Ad]
f19292be: folds
5b73fbfa: folds
Hero: raises $0.38 to $0.63
2611a367: folds
abf9b61c: folds
e5667aa7: calls $0.38
*** FLOP *** [9c Qc 8s]
e5667aa7: checks
Hero: bets $1.1
e5667aa7: calls $1.1
*** TURN *** [9c Qc 8s] [Th]
e5667aa7: bets $3.2
Hero: folds
Uncalled bet ($3.2) returned to e5667aa7
*** SHOWDOWN ***
e5667aa7 collected $3.56 from pot
*** SUMMARY ***
Total pot $3.56
Board [9c Qc 8s Th]
Seat 1: 2611a367 (button) folded before Flop (didn't bet)
Seat 2: abf9b61c (small blind) folded before Flop
Seat 3: e5667aa7 (big blind) won ($3.56)
Seat 4: f19292be folded before Flop (didn't bet)
Seat 5: 5b73fbfa folded before Flop (didn't bet)
Seat 6: Hero folded on the Turn


Poker Hand #RC92803659: Hold'em No Limit ($0.1/$0.25) - 2020/04/02 23:32:28
Table 'RushAndCash46554' 6-max Seat #1 is the button
Seat 1: 1e7ee1e0 ($12.98 in chips)
Seat 2: 2611a367 ($16.3 in chips)
Seat 3: Hero ($25.77 in chips)
Seat 4: abf9b61c ($28.94 in chips)
Seat 5: e5667aa7 ($98.84 in chips)
Seat 6: f43af171 ($23.85 in chips)
2611a367: posts small blind $0.1
Hero: posts big blind $0.25
*** HOLE CARDS ***
Dealt to 1e7ee1e0 
Dealt to 2611a367 
Dealt to Hero [6s 2c]
Dealt to abf9b61c 
Dealt to e5667aa7 
Dealt to f43af171 
abf9b61c: folds
e5667aa7: folds
f43af171: folds
1e7ee1e0: folds
2611a367: folds
Uncalled bet ($0.15) returned to Hero
*** SHOWDOWN ***
Hero collected $0.2 from pot
*** SUMMARY ***
Total pot $0.2
Seat 1: 1e7ee1e0 (button) folded before Flop (didn't bet)
Seat 2: 2611a367 (small blind) folded before Flop
Seat 3: Hero (big blind) collected ($0.2)
Seat 4: abf9b61c folded before Flop (didn't bet)
Seat 5: e5667aa7 folded before Flop (didn't bet)
Seat 6: f43af171 folded before Flop (didn't bet)


Poker Hand #RC92803682: Hold'em No Limit ($0.1/$0.25) - 2020/04/02 23:32:32
Table 'RushAndCash46556' 6-max Seat #1 is the button
Seat 1: 7adcb578 ($42.82 in chips)
Seat 2: Hero ($25.52 in chips)
Seat 3: c27aaa40 ($79.12 in chips)
Seat 4: 569c22a2 ($26.88 in chips)
Seat 5: 97dacd30 ($8.1 in chips)
Seat 6: 2611a367 ($16.2 in chips)
Hero: posts small blind $0.1
c27aaa40: posts big blind $0.25
*** HOLE CARDS ***
Dealt to 7adcb578 
Dealt to Hero [Th 5s]
Dealt to c27aaa40 
Dealt to 569c22a2 
Dealt to 97dacd30 
Dealt to 2611a367 
569c22a2: folds
97dacd30: raises $0.38 to $0.63
2611a367: folds
7adcb578: folds
Hero: folds
c27aaa40: folds
Uncalled bet ($0.38) returned to 97dacd30
*** SHOWDOWN ***
97dacd30 collected $0.6 from pot
*** SUMMARY ***
Total pot $0.6
Seat 1: 7adcb578 (button) folded before Flop (didn't bet)
Seat 2: Hero (small blind) folded before Flop
Seat 3: c27aaa40 (big blind) folded before Flop
Seat 4: 569c22a2 folded before Flop (didn't bet)
Seat 5: 97dacd30 collected ($0.6)
Seat 6: 2611a367 folded before Flop (didn't bet)


Poker Hand #RC92803707: Hold'em No Limit ($0.1/$0.25) - 2020/04/02 23:32:36
Table 'RushAndCash46559' 6-max Seat #1 is the button
Seat 1: Hero ($25.42 in chips)
Seat 2: 569c22a2 ($26.88 in chips)
Seat 3: c427ddfc ($30.25 in chips)
Seat 4: e5667aa7 ($98.84 in chips)
Seat 5: 429a1329 ($25 in chips)
Seat 6: bcf79ef3 ($12.01 in chips)
569c22a2: posts small blind $0.1
c427ddfc: posts big blind $0.25
*** HOLE CARDS ***
Dealt to Hero [Kc 4c]
Dealt to 569c22a2 
Dealt to c427ddfc 
Dealt to e5667aa7 
Dealt to 429a1329 
Dealt to bcf79ef3 
e5667aa7: folds
429a1329: folds
bcf79ef3: folds
Hero: folds
569c22a2: raises $0.38 to $0.63
c427ddfc: folds
Uncalled bet ($0.38) returned to 569c22a2
*** SHOWDOWN ***
569c22a2 collected $0.5 from pot
*** SUMMARY ***
Total pot $0.5
Seat 1: Hero (button) folded before Flop (didn't bet)
Seat 2: 569c22a2 (small blind) collected ($0.5)
Seat 3: c427ddfc (big blind) folded before Flop
Seat 4: e5667aa7 folded before Flop (didn't bet)
Seat 5: 429a1329 folded before Flop (didn't bet)
Seat 6: bcf79ef3 folded before Flop (didn't bet)


Poker Hand #RC92803728: Hold'em No Limit ($0.1/$0.25) - 2020/04/02 23:32:39
Table 'RushAndCash46562' 6-max Seat #1 is the button
Seat 1: 163fde06 ($50.61 in chips)
Seat 2: c427ddfc ($30 in chips)
Seat 3: 359d23bf ($31.85 in chips)
Seat 4: Hero ($25.42 in chips)
Seat 5: ec75d237 ($28 in chips)
Seat 6: 3ce5fe08 ($19.41 in chips)
c427ddfc: posts small blind $0.1
359d23bf: posts big blind $0.25
*** HOLE CARDS ***
Dealt to 163fde06 
Dealt to c427ddfc 
Dealt to 359d23bf 
Dealt to Hero [Td 4d]
Dealt to ec75d237 
Dealt to 3ce5fe08 
Hero: folds
ec75d237: raises $0.38 to $0.63
3ce5fe08: raises $1.27 to $1.9
163fde06: folds
c427ddfc: raises $3.07 to $4.97
359d23bf: folds
ec75d237: folds
3ce5fe08: calls $3.07
*** FLOP *** [Jh 7h Qs]
c427ddfc: checks
3ce5fe08: bets $5.5
c427ddfc: raises $19.53 to $25.03 and is all-in
3ce5fe08: calls $8.94 and is all-in
Uncalled bet ($10.59) returned to c427ddfc
c427ddfc: shows [Qh Kh] (Pair of Queens)
3ce5fe08: shows [Tc Qd] (Pair of Queens)
*** TURN *** [Jh 7h Qs] [3d]
*** RIVER *** [Jh 7h Qs 3d] [4c]
*** SHOWDOWN ***
c427ddfc collected $39.7 from pot
*** SUMMARY ***
Total pot $39.7
Board [Jh 7h Qs 3d 4c]
Seat 1: 163fde06 (button) folded before Flop (didn't bet)
Seat 2: c427ddfc (small blind) showed [Kh Qh] and won ($39.7) with Pair of Queens
Seat 3: 359d23bf (big blind) folded before Flop
Seat 4: Hero folded before Flop (didn't bet)
Seat 5: ec75d237 folded before Flop
Seat 6: 3ce5fe08 showed [Qd Tc] and lost with Pair of Queens


Poker Hand #RC92803748: Hold'em No Limit ($0.1/$0.25) - 2020/04/02 23:32:43
Table 'RushAndCash46565' 6-max Seat #1 is the button
Seat 1: b561aa9d ($36.23 in chips)
Seat 2: 163fde06 ($50.61 in chips)
Seat 3: ab641f7 ($60 in chips)
Seat 4: 2bebd6e7 ($40.87 in chips)
Seat 5: f43af171 ($23.85 in chips)
Seat 6: Hero ($25.77 in chips)
163fde06: posts small blind $0.1
ab641f7: posts big blind $0.25
*** HOLE CARDS ***
Dealt to b561aa9d 
Dealt to 163fde06 
Dealt to ab641f7 
Dealt to 2bebd6e7 
Dealt to f43af171 
Dealt to Hero [As 5c]
2bebd6e7: raises $0.38 to $0.63
f43af171: folds
Hero: folds
b561aa9d: folds
163fde06: calls $0.53
ab641f7: folds
*** FLOP *** [Qs Qd 7c]
163fde06: checks
2bebd6e7: checks
*** TURN *** [Qs Qd 7c] [4c]
163fde06: bets $0.8
2bebd6e7: calls $0.8
*** RIVER *** [Qs Qd 7c 4c] [Kd]
163fde06: checks
2bebd6e7: checks
163fde06: shows [Ad 7d] (Pair of Queens and Pair of Sevens)
2bebd6e7: shows [Js Ac] (Pair of Queens)
*** SHOWDOWN ***
163fde06 collected $3.11 from pot
*** SUMMARY ***
Total pot $3.11
Board [Qs Qd 7c 4c Kd]
Seat 1: b561aa9d (button) folded before Flop (didn't bet)
Seat 2: 163fde06 (small blind) showed [Ad 7d] and won ($3.11) with Pair of Queens and Pair of Sevens
Seat 3: ab641f7 (big blind) folded before Flop
Seat 4: 2bebd6e7 showed [Ac Js] and lost with Pair of Queens
Seat 5: f43af171 folded before Flop (didn't bet)
Seat 6: Hero folded before Flop (didn't bet)


Poker Hand #RC92803764: Hold'em No Limit ($0.1/$0.25) - 2020/04/02 23:32:46
Table 'RushAndCash46568' 6-max Seat #1 is the button
Seat 1: 5b73fbfa ($47.69 in chips)
Seat 2: 7db17161 ($55.95 in chips)
Seat 3: 57b0a14c ($27.42 in chips)
Seat 4: e3fa4802 ($28.86 in chips)
Seat 5: bd35f4c4 ($34.71 in chips)
Seat 6: Hero ($25.77 in chips)
7db17161: posts small blind $0.1
57b0a14c: posts big blind $0.25
*** HOLE CARDS ***
Dealt to 5b73fbfa 
Dealt to 7db17161 
Dealt to 57b0a14c 
Dealt to e3fa4802 
Dealt to bd35f4c4 
Dealt to Hero [Th 8c]
e3fa4802: folds
bd35f4c4: folds
Hero: folds
5b73fbfa: raises $0.38 to $0.63
7db17161: calls $0.53
57b0a14c: folds
*** FLOP *** [9c 6h Ts]
7db17161: checks
5b73fbfa: checks
*** TURN *** [9c 6h Ts] [Ad]
7db17161: bets $1.3
5b73fbfa: calls $1.3
*** RIVER *** [9c 6h Ts Ad] [6d]
7db17161: bets $4
5b73fbfa: folds
Uncalled bet ($4) returned to 7db17161
*** SHOWDOWN ***
7db17161 collected $4.11 from pot
*** SUMMARY ***
Total pot $4.11
Board [9c 6h Ts Ad 6d]
Seat 1: 5b73fbfa (button) folded on the River
Seat 2: 7db17161 (small blind) won ($4.11)
Seat 3: 57b0a14c (big blind) folded before Flop
Seat 4: e3fa4802 folded before Flop (didn't bet)
Seat 5: bd35f4c4 folded before Flop (didn't bet)
Seat 6: Hero folded before Flop (didn't bet)


Poker Hand #RC92803784: Hold'em No Limit ($0.1/$0.25) - 2020/04/02 23:32:50
Table 'RushAndCash46571' 6-max Seat #1 is the button
Seat 1: 833dc1e7 ($89.81 in chips)
Seat 2: b561aa9d ($36.23 in chips)
Seat 3: Hero ($25.77 in chips)
Seat 4: e4b820db ($52.68 in chips)
Seat 5: eb18162e ($33.62 in chips)
Seat 6: 243ca57e ($26.9 in chips)
b561aa9d: posts small blind $0.1
Hero: posts big blind $0.25
*** HOLE CARDS ***
Dealt to 833dc1e7 
Dealt to b561aa9d 
Dealt to Hero [Ad Jc]
Dealt to e4b820db 
Dealt to eb18162e 
Dealt to 243ca57e 
e4b820db: folds
eb18162e: folds
243ca57e: folds
833dc1e7: folds
b561aa9d: raises $0.63 to $0.88
Hero: calls $0.63
*** FLOP *** [3h 7c Ks]
b561aa9d: bets $1.4
Hero: folds
Uncalled bet ($1.4) returned to b561aa9d
*** SHOWDOWN ***
b561aa9d collected $1.76 from pot
*** SUMMARY ***
Total pot $1.76
Board [3h 7c Ks]
Seat 1: 833dc1e7 (button) folded before Flop (didn't bet)
Seat 2: b561aa9d (small blind) won ($1.76)
Seat 3: Hero (big blind) folded on the Flop
Seat 4: e4b820db folded before Flop (didn't bet)
Seat 5: eb18162e folded before Flop (didn't bet)
Seat 6: 243ca57e folded before Flop (didn't bet)


Poker Hand #RC92803946: Hold'em No Limit ($0.1/$0.25) - 2020/04/02 23:33:20
Table 'RushAndCash46592' 6-max Seat #1 is the button
Seat 1: 803a0c06 ($25.68 in chips)
Seat 2: Hero ($25 in chips)
Seat 3: bcf79ef3 ($12.01 in chips)
Seat 4: e3fa4802 ($28.51 in chips)
Seat 5: 33dc6448 ($40.63 in chips)
Seat 6: 89a3eced ($212.4 in chips)
Hero: posts small blind $0.1
bcf79ef3: posts big blind $0.25
*** HOLE CARDS ***
Dealt to 803a0c06 
Dealt to Hero [Qd 3h]
Dealt to bcf79ef3 
Dealt to e3fa4802 
Dealt to 33dc6448 
Dealt to 89a3eced 
e3fa4802: folds
33dc6448: folds
89a3eced: raises $0.5 to $0.75
803a0c06: folds
Hero: folds
bcf79ef3: folds
Uncalled bet ($0.5) returned to 89a3eced
*** SHOWDOWN ***
89a3eced collected $0.6 from pot
*** SUMMARY ***
Total pot $0.6
Seat 1: 803a0c06 (button) folded before Flop (didn't bet)
Seat 2: Hero (small blind) folded before Flop
Seat 3: bcf79ef3 (big blind) folded before Flop
Seat 4: e3fa4802 folded before Flop (didn't bet)
Seat 5: 33dc6448 folded before Flop (didn't bet)
Seat 6: 89a3eced collected ($0.6)


Poker Hand #RC92803977: Hold'em No Limit ($0.1/$0.25) - 2020/04/02 23:33:25
Table 'RushAndCash46596' 6-max Seat #1 is the button
Seat 1: Hero ($25 in chips)
Seat 2: 7eb96805 ($13.46 in chips)
Seat 3: 5a8dd9c3 ($25 in chips)
Seat 4: d1e38640 ($28.9 in chips)
Seat 5: b320ed6a ($57.12 in chips)
Seat 6: 5f034738 ($27.15 in chips)
7eb96805: posts small blind $0.1
5a8dd9c3: posts big blind $0.25
*** HOLE CARDS ***
Dealt to Hero [Qs 2s]
Dealt to 7eb96805 
Dealt to 5a8dd9c3 
Dealt to d1e38640 
Dealt to b320ed6a 
Dealt to 5f034738 
d1e38640: folds
b320ed6a: raises $0.3 to $0.55
5f034738: folds
Hero: folds
7eb96805: calls $0.45
5a8dd9c3: folds
*** FLOP *** [Qc 4c 4s]
7eb96805: checks
b320ed6a: checks
*** TURN *** [Qc 4c 4s] [Kd]
7eb96805: bets $1.2
b320ed6a: folds
Uncalled bet ($1.2) returned to 7eb96805
*** SHOWDOWN ***
7eb96805 collected $1.35 from pot
*** SUMMARY ***
Total pot $1.35
Board [Qc 4c 4s Kd]
Seat 1: Hero (button) folded before Flop (didn't bet)
Seat 2: 7eb96805 (small blind) won ($1.35)
Seat 3: 5a8dd9c3 (big blind) folded before Flop
Seat 4: d1e38640 folded before Flop (didn't bet)
Seat 5: b320ed6a folded on the Turn
Seat 6: 5f034738 folded before Flop (didn't bet)


Poker Hand #RC92804001: Hold'em No Limit ($0.1/$0.25) - 2020/04/02 23:33:30
Table 'RushAndCash46599' 6-max Seat #1 is the button
Seat 1: d1e38640 ($28.9 in chips)
Seat 2: 57b0a14c ($27.17 in chips)
Seat 3: 44db54de ($28.18 in chips)
Seat 4: 5f034738 ($27.15 in chips)
Seat 5: Hero ($25 in chips)
Seat 6: 533b95e8 ($30.61 in chips)
57b0a14c: posts small blind $0.1
44db54de: posts big blind $0.25
*** HOLE CARDS ***
Dealt to d1e38640 
Dealt to 57b0a14c 
Dealt to 44db54de 
Dealt to 5f034738 
Dealt to Hero [Ah Ad]
Dealt to 533b95e8 
5f034738: folds
Hero: raises $0.38 to $0.63
533b95e8: folds
d1e38640: folds
57b0a14c: folds
44db54de: calls $0.38
*** FLOP *** [6s 2s 5h]
44db54de: checks
Hero: bets $1.1
44db54de: calls $1.1
*** TURN *** [6s 2s 5h] [8d]
44db54de: checks
Hero: bets $2.75
44db54de: raises $6.35 to $9.1
Hero: raises $14.17 to $23.27 and is all-in
44db54de: folds
Uncalled bet ($14.17) returned to Hero
*** SHOWDOWN ***
Hero collected $21.76 from pot
*** SUMMARY ***
Total pot $21.76
Board [6s 2s 5h 8d]
Seat 1: d1e38640 (button) folded before Flop (didn't bet)
Seat 2: 57b0a14c (small blind) folded before Flop
Seat 3: 44db54de (big blind) folded on the Turn
Seat 4: 5f034738 folded before Flop (didn't bet)
Seat 5: Hero won ($21.76)
Seat 6: 533b95e8 folded before Flop (didn't bet)


Poker Hand #RC92804327: Hold'em No Limit ($0.1/$0.25) - 2020/04/02 23:34:33
Table 'RushAndCash46632' 6-max Seat #1 is the button
Seat 1: 7adcb578 ($42.32 in chips)
Seat 2: 833dc1e7 ($89.71 in chips)
Seat 3: 5136ebb4 ($42.79 in chips)
Seat 4: b6875a20 ($26.38 in chips)
Seat 5: bcf79ef3 ($11.66 in chips)
Seat 6: Hero ($34.93 in chips)
833dc1e7: posts small blind $0.1
5136ebb4: posts big blind $0.25
*** HOLE CARDS ***
Dealt to 7adcb578 
Dealt to 833dc1e7 
Dealt to 5136ebb4 
Dealt to b6875a20 
Dealt to bcf79ef3 
Dealt to Hero [Jd 8c]
b6875a20: raises $0.38 to $0.63
bcf79ef3: folds
Hero: folds
7adcb578: folds
833dc1e7: calls $0.53
5136ebb4: folds
*** FLOP *** [3c Kd Ts]
833dc1e7: checks
b6875a20: bets $0.8
833dc1e7: calls $0.8
*** TURN *** [3c Kd Ts] [5c]
833dc1e7: checks
b6875a20: bets $2.4
833dc1e7: folds
Uncalled bet ($2.4) returned to b6875a20
*** SHOWDOWN ***
b6875a20 collected $3.11 from pot
*** SUMMARY ***
Total pot $3.11
Board [3c Kd Ts 5c]
Seat 1: 7adcb578 (button) folded before Flop (didn't bet)
Seat 2: 833dc1e7 (small blind) folded on the Turn
Seat 3: 5136ebb4 (big blind) folded before Flop
Seat 4: b6875a20 won ($3.11)
Seat 5: bcf79ef3 folded before Flop (didn't bet)
Seat 6: Hero folded before Flop (didn't bet)


Poker Hand #RC92804345: Hold'em No Limit ($0.1/$0.25) - 2020/04/02 23:34:36
Table 'RushAndCash46635' 6-max Seat #1 is the button
Seat 1: 33dc6448 ($39.65 in chips)
Seat 2: Hero ($34.93 in chips)
Seat 3: c427ddfc ($49.29 in chips)
Seat 4: 5a8dd9c3 ($25 in chips)
Seat 5: 1e7ee1e0 ($12.31 in chips)
Seat 6: 5f034738 ($27.81 in chips)
Hero: posts small blind $0.1
c427ddfc: posts big blind $0.25
*** HOLE CARDS ***
Dealt to 33dc6448 
Dealt to Hero [Kd Td]
Dealt to c427ddfc 
Dealt to 5a8dd9c3 
Dealt to 1e7ee1e0 
Dealt to 5f034738 
5a8dd9c3: raises $0.5 to $0.75
1e7ee1e0: folds
5f034738: raises $1.7 to $2.45
33dc6448: folds
Hero: folds
c427ddfc: folds
5a8dd9c3: folds
Uncalled bet ($1.7) returned to 5f034738
*** SHOWDOWN ***
5f034738 collected $1.85 from pot
*** SUMMARY ***
Total pot $1.85
Seat 1: 33dc6448 (button) folded before Flop (didn't bet)
Seat 2: Hero (small blind) folded before Flop
Seat 3: c427ddfc (big blind) folded before Flop
Seat 4: 5a8dd9c3 folded before Flop
Seat 5: 1e7ee1e0 folded before Flop (didn't bet)
Seat 6: 5f034738 collected ($1.85)


Poker Hand #RC92804417: Hold'em No Limit ($0.1/$0.25) - 2020/04/02 23:34:50
Table 'RushAndCash46644' 6-max Seat #1 is the button
Seat 1: 2eabd980 ($18.97 in chips)
Seat 2: 9c1f26b8 ($25 in chips)
Seat 3: Hero ($34.83 in chips)
Seat 4: ca32c452 ($27.26 in chips)
Seat 5: 5136ebb4 ($42.34 in chips)
Seat 6: 97dacd30 ($7.7 in chips)
9c1f26b8: posts small blind $0.1
Hero: posts big blind $0.25
*** HOLE CARDS ***
Dealt to 2eabd980 
Dealt to 9c1f26b8 
Dealt to Hero [Kh Jd]
Dealt to ca32c452 
Dealt to 5136ebb4 
Dealt to 97dacd30 
ca32c452: folds
5136ebb4: raises $0.5 to $0.75
97dacd30: folds
2eabd980: folds
9c1f26b8: calls $0.65
Hero: calls $0.5
*** FLOP *** [Js Tc 5s]
9c1f26b8: checks
Hero: checks
5136ebb4: checks
*** TURN *** [Js Tc 5s] [5d]
9c1f26b8: checks
Hero: bets $1.92
5136ebb4: folds
9c1f26b8: folds
Uncalled bet ($1.92) returned to Hero
*** SHOWDOWN ***
Hero collected $2.25 from pot
*** SUMMARY ***
Total pot $2.25
Board [Js Tc 5s 5d]
Seat 1: 2eabd980 (button) folded before Flop (didn't bet)
Seat 2: 9c1f26b8 (small blind) folded on the Turn
Seat 3: Hero (big blind) won ($2.25)
Seat 4: ca32c452 folded before Flop (didn't bet)
Seat 5: 5136ebb4 folded on the Turn
Seat 6: 97dacd30 folded before Flop (didn't bet)


Poker Hand #RC92804697: Hold'em No Limit ($0.1/$0.25) - 2020/04/02 23:35:39
Table 'RushAndCash46680' 6-max Seat #1 is the button
Seat 1: Hero ($36.22 in chips)
Seat 2: 1e7ee1e0 ($13.97 in chips)
Seat 3: eb18162e ($32.11 in chips)
Seat 4: 6d33a0cb ($32.83 in chips)
Seat 5: 803a0c06 ($28.01 in chips)
Seat 6: 5b73fbfa ($49.28 in chips)
1e7ee1e0: posts small blind $0.1
eb18162e: posts big blind $0.25
*** HOLE CARDS ***
Dealt to Hero [Qd 8h]
Dealt to 1e7ee1e0 
Dealt to eb18162e 
Dealt to 6d33a0cb 
Dealt to 803a0c06 
Dealt to 5b73fbfa 
6d33a0cb: folds
803a0c06: raises $0.38 to $0.63
5b73fbfa: raises $2.02 to $2.65
Hero: folds
1e7ee1e0: folds
eb18162e: folds
803a0c06: calls $2.02
*** FLOP *** [6d As Kh]
803a0c06: checks
5b73fbfa: checks
*** TURN *** [6d As Kh] [8c]
803a0c06: bets $5.3
5b73fbfa: folds
Uncalled bet ($5.3) returned to 803a0c06
*** SHOWDOWN ***
803a0c06 collected $5.65 from pot
*** SUMMARY ***
Total pot $5.65
Board [6d As Kh 8c]
Seat 1: Hero (button) folded before Flop (didn't bet)
Seat 2: 1e7ee1e0 (small blind) folded before Flop
Seat 3: eb18162e (big blind) folded before Flop
Seat 4: 6d33a0cb folded before Flop (didn't bet)
Seat 5: 803a0c06 won ($5.65)
Seat 6: 5b73fbfa folded on the Turn


Poker Hand #RC92804721: Hold'em No Limit ($0.1/$0.25) - 2020/04/02 23:35:43
Table 'RushAndCash46684' 6-max Seat #1 is the button
Seat 1: eb18162e ($31.86 in chips)
Seat 2: 7eb96805 ($14.3 in chips)
Seat 3: 89a3eced ($215.69 in chips)
Seat 4: 6d33a0cb ($32.83 in chips)
Seat 5: Hero ($36.22 in chips)
Seat 6: ab641f7 ($59.88 in chips)
7eb96805: posts small blind $0.1
89a3eced: posts big blind $0.25
*** HOLE CARDS ***
Dealt to eb18162e 
Dealt to 7eb96805 
Dealt to 89a3eced 
Dealt to 6d33a0cb 
Dealt to Hero [5s 2h]
Dealt to ab641f7 
6d33a0cb: folds
Hero: folds
ab641f7: folds
eb18162e: folds
7eb96805: raises $0.5 to $0.75
89a3eced: calls $0.5
*** FLOP *** [Jd Tc 4s]
7eb96805: bets $1.2
89a3eced: folds
Uncalled bet ($1.2) returned to 7eb96805
*** SHOWDOWN ***
7eb96805 collected $1.5 from pot
*** SUMMARY ***
Total pot $1.5
Board [Jd Tc 4s]
Seat 1: eb18162e (button) folded before Flop (didn't bet)
Seat 2: 7eb96805 (small blind) won ($1.5)
Seat 3: 89a3eced (big blind) folded on the Flop
Seat 4: 6d33a0cb folded before Flop (didn't bet)
Seat 5: Hero folded before Flop (didn't bet)
Seat 6: ab641f7 folded before Flop (didn't bet)


Poker Hand #RC92804736: Hold'em No Limit ($0.1/$0.25) - 2020/04/02 23:35:46
Table 'RushAndCash46687' 6-max Seat #1 is the button
Seat 1: 243ca57e ($27.25 in chips)
Seat 2: 97dacd30 ($8.25 in chips)
Seat 3: 2eabd980 ($18.47 in chips)
Seat 4: Hero ($36.22 in chips)
Seat 5: 7db17161 ($60.07 in chips)
Seat 6: 359d23bf ($26.04 in chips)
97dacd30: posts small blind $0.1
2eabd980: posts big blind $0.25
*** HOLE CARDS ***
Dealt to 243ca57e 
Dealt to 97dacd30 
Dealt to 2eabd980 
Dealt to Hero [Kd 8d]
Dealt to 7db17161 
Dealt to 359d23bf 
Hero: folds
7db17161: folds
359d23bf: folds
243ca57e: raises $0.5 to $0.75
97dacd30: calls $0.65
2eabd980: folds
*** FLOP *** [4c Ac Qc]
97dacd30: checks
243ca57e: checks
*** TURN *** [4c Ac Qc] [Ah]
97dacd30: checks
243ca57e: checks
*** RIVER *** [4c Ac Qc Ah] [9d]
97dacd30: checks
243ca57e: checks
97dacd30: shows [5h 5c] (Pair of Aces and Pair of Fives)
243ca57e: shows [Jh 8h] (Pair of Aces)
*** SHOWDOWN ***
97dacd30 collected $1.75 from pot
*** SUMMARY ***
Total pot $1.75
Board [4c Ac Qc Ah 9d]
Seat 1: 243ca57e (button) showed [Jh 8h] and lost with Pair of Aces
Seat 2: 97dacd30 (small blind) showed [5h 5c] and won ($1.75) with Pair of Aces and Pair of Fives
Seat 3: 2eabd980 (big blind) folded before Flop
Seat 4: Hero folded before Flop (didn't bet)
Seat 5: 7db17161 folded before Flop (didn't bet)
Seat 6: 359d23bf folded before Flop (didn't bet)


Poker Hand #RC92804762: Hold'em No Limit ($0.1/$0.25) - 2020/04/02 23:35:51
Table 'RushAndCash46691' 6-max Seat #1 is the button
Seat 1: 2eabd980 ($18.22 in chips)
Seat 2: 359d23bf ($26.04 in chips)
Seat 3: b320ed6a ($56.22 in chips)
Seat 4: Hero ($36.22 in chips)
Seat 5: f92e6d28 ($25.27 in chips)
Seat 6: bb9a5aea ($12.4 in chips)
359d23bf: posts small blind $0.1
b320ed6a: posts big blind $0.25
*** HOLE CARDS ***
Dealt to 2eabd980 
Dealt to 359d23bf 
Dealt to b320ed6a 
Dealt to Hero [Qd 3s]
Dealt to f92e6d28 
Dealt to bb9a5aea 
Hero: folds
f92e6d28: folds
bb9a5aea: raises $0.38 to $0.63
2eabd980: folds
359d23bf: folds
b320ed6a: raises $2.18 to $2.81
bb9a5aea: folds
Uncalled bet ($2.18) returned to b320ed6a
*** SHOWDOWN ***
b320ed6a collected $1.36 from pot
*** SUMMARY ***
Total pot $1.36
Seat 1: 2eabd980 (button) folded before Flop (didn't bet)
Seat 2: 359d23bf (small blind) folded before Flop
Seat 3: b320ed6a (big blind) collected ($1.36)
Seat 4: Hero folded before Flop (didn't bet)
Seat 5: f92e6d28 folded before Flop (didn't bet)
Seat 6: bb9a5aea folded before Flop


Poker Hand #RC92804785: Hold'em No Limit ($0.1/$0.25) - 2020/04/02 23:35:55
Table 'RushAndCash46695' 6-max Seat #1 is the button
Seat 1: a1320bd6 ($107.13 in chips)
Seat 2: ca32c452 ($27.26 in chips)
Seat 3: e5667aa7 ($108.81 in chips)
Seat 4: 49a470c7 ($12.85 in chips)
Seat 5: a36379d9 ($36.74 in chips)
Seat 6: Hero ($36.22 in chips)
ca32c452: posts small blind $0.1
e5667aa7: posts big blind $0.25
*** HOLE CARDS ***
Dealt to a1320bd6 
Dealt to ca32c452 
Dealt to e5667aa7 
Dealt to 49a470c7 
Dealt to a36379d9 
Dealt to Hero [Kd Jh]
49a470c7: raises $0.5 to $0.75
a36379d9: folds
Hero: folds
a1320bd6: folds
ca32c452: folds
e5667aa7: calls $0.5
*** FLOP *** [3c 9h 2h]
e5667aa7: checks
49a470c7: checks
*** TURN *** [3c 9h 2h] [Ac]
e5667aa7: bets $1.2
49a470c7: calls $1.2
*** RIVER *** [3c 9h 2h Ac] [Js]
e5667aa7: checks
49a470c7: bets $2
e5667aa7: folds
Uncalled bet ($2) returned to 49a470c7
*** SHOWDOWN ***
49a470c7 collected $4 from pot
*** SUMMARY ***
Total pot $4
Board [3c 9h 2h Ac Js]
Seat 1: a1320bd6 (button) folded before Flop (didn't bet)
Seat 2: ca32c452 (small blind) folded before Flop
Seat 3: e5667aa7 (big blind) folded on the River
Seat 4: 49a470c7 won ($4)
Seat 5: a36379d9 folded before Flop (didn't bet)
Seat 6: Hero folded before Flop (didn't bet)


Poker Hand #RC92804836: Hold'em No Limit ($0.1/$0.25) - 2020/04/02 23:36:05
Table 'RushAndCash46701' 6-max Seat #1 is the button
Seat 1: 2611a367 ($13.57 in chips)
Seat 2: a36379d9 ($36.74 in chips)
Seat 3: Hero ($36.22 in chips)
Seat 4: ab641f7 ($59.88 in chips)
Seat 5: f0b740a4 ($12.73 in chips)
Seat 6: 5a8dd9c3 ($25 in chips)
a36379d9: posts small blind $0.1
Hero: posts big blind $0.25
*** HOLE CARDS ***
Dealt to 2611a367 
Dealt to a36379d9 
Dealt to Hero [Qc 4d]
Dealt to ab641f7 
Dealt to f0b740a4 
Dealt to 5a8dd9c3 
ab641f7: folds
f0b740a4: folds
5a8dd9c3: folds
2611a367: folds
a36379d9: raises $0.5 to $0.75
Hero: folds
Uncalled bet ($0.5) returned to a36379d9
*** SHOWDOWN ***
a36379d9 collected $0.5 from pot
*** SUMMARY ***
Total pot $0.5
Seat 1: 2611a367 (button) folded before Flop (didn't bet)
Seat 2: a36379d9 (small blind) collected ($0.5)
Seat 3: Hero (big blind) folded before Flop
Seat 4: ab641f7 folded before Flop (didn't bet)
Seat 5: f0b740a4 folded before Flop (didn't bet)
Seat 6: 5a8dd9c3 folded before Flop (didn't bet)


Poker Hand #RC92804866: Hold'em No Limit ($0.1/$0.25) - 2020/04/02 23:36:11
Table 'RushAndCash46704' 6-max Seat #1 is the button
Seat 1: ca32c452 ($26.91 in chips)
Seat 2: Hero ($35.97 in chips)
Seat 3: 2bebd6e7 ($39.65 in chips)
Seat 4: 5f034738 ($29.73 in chips)
Seat 5: 833dc1e7 ($87.75 in chips)
Seat 6: 44db54de ($25.17 in chips)
Hero: posts small blind $0.1
2bebd6e7: posts big blind $0.25
*** HOLE CARDS ***
Dealt to ca32c452 
Dealt to Hero [Qh 6h]
Dealt to 2bebd6e7 
Dealt to 5f034738 
Dealt to 833dc1e7 
Dealt to 44db54de 
5f034738: folds
833dc1e7: folds
44db54de: raises $0.38 to $0.63
ca32c452: folds
Hero: folds
2bebd6e7: folds
Uncalled bet ($0.38) returned to 44db54de
*** SHOWDOWN ***
44db54de collected $0.6 from pot
*** SUMMARY ***
Total pot $0.6
Seat 1: ca32c452 (button) folded before Flop (didn't bet)
Seat 2: Hero (small blind) folded before Flop
Seat 3: 2bebd6e7 (big blind) folded before Flop
Seat 4: 5f034738 folded before Flop (didn't bet)
Seat 5: 833dc1e7 folded before Flop (didn't bet)
Seat 6: 44db54de collected ($0.6)


Poker Hand #RC92804887: Hold'em No Limit ($0.1/$0.25) - 2020/04/02 23:36:15
Table 'RushAndCash46706' 6-max Seat #1 is the button
Seat 1: Hero ($35.87 in chips)
Seat 2: a1320bd6 ($107.48 in chips)
Seat 3: 5f034738 ($29.73 in chips)
Seat 4: 359d23bf ($25.94 in chips)
Seat 5: 2eabd980 ($18.12 in chips)
Seat 6: bcf79ef3 ($11.38 in chips)
a1320bd6: posts small blind $0.1
5f034738: posts big blind $0.25
*** HOLE CARDS ***
Dealt to Hero [Jc 4h]
Dealt to a1320bd6 
Dealt to 5f034738 
Dealt to 359d23bf 
Dealt to 2eabd980 
Dealt to bcf79ef3 
359d23bf: folds
2eabd980: folds
bcf79ef3: folds
Hero: folds
a1320bd6: folds
Uncalled bet ($0.15) returned to 5f034738
*** SHOWDOWN ***
5f034738 collected $0.2 from pot
*** SUMMARY ***
Total pot $0.2
Seat 1: Hero (button) folded before Flop (didn't bet)
Seat 2: a1320bd6 (small blind) folded before Flop
Seat 3: 5f034738 (big blind) collected ($0.2)
Seat 4: 359d23bf folded before Flop (didn't bet)
Seat 5: 2eabd980 folded before Flop (didn't bet)
Seat 6: bcf79ef3 folded before Flop (didn't bet)


Poker Hand #RC92804908: Hold'em No Limit ($0.1/$0.25) - 2020/04/02 23:36:19
Table 'RushAndCash46708' 6-max Seat #1 is the button
Seat 1: 2eabd980 ($18.12 in chips)
Seat 2: 89a3eced ($214.94 in chips)
Seat 3: 5a8dd9c3 ($25 in chips)
Seat 4: Hero ($35.87 in chips)
Seat 5: 3ea34051 ($13.2 in chips)
Seat 6: 6d33a0cb ($32.83 in chips)
89a3eced: posts small blind $0.1
5a8dd9c3: posts big blind $0.25
*** HOLE CARDS ***
Dealt to 2eabd980 
Dealt to 89a3eced 
Dealt to 5a8dd9c3 
Dealt to Hero [4h 2d]
Dealt to 3ea34051 
Dealt to 6d33a0cb 
Hero: folds
3ea34051: folds
6d33a0cb: folds
2eabd980: folds
89a3eced: raises $0.5 to $0.75
5a8dd9c3: folds
Uncalled bet ($0.5) returned to 89a3eced
*** SHOWDOWN ***
89a3eced collected $0.5 from pot
*** SUMMARY ***
Total pot $0.5
Seat 1: 2eabd980 (button) folded before Flop (didn't bet)
Seat 2: 89a3eced (small blind) collected ($0.5)
Seat 3: 5a8dd9c3 (big blind) folded before Flop
Seat 4: Hero folded before Flop (didn't bet)
Seat 5: 3ea34051 folded before Flop (didn't bet)
Seat 6: 6d33a0cb folded before Flop (didn't bet)


Poker Hand #RC92804938: Hold'em No Limit ($0.1/$0.25) - 2020/04/02 23:36:24
Table 'RushAndCash46712' 6-max Seat #1 is the button
Seat 1: 359d23bf ($25.94 in chips)
Seat 2: f92e6d28 ($25.27 in chips)
Seat 3: 2eabd980 ($18.12 in chips)
Seat 4: Hero ($35.87 in chips)
Seat 5: a1320bd6 ($107.13 in chips)
Seat 6: f19292be ($33.28 in chips)
f92e6d28: posts small blind $0.1
2eabd980: posts big blind $0.25
*** HOLE CARDS ***
Dealt to 359d23bf 
Dealt to f92e6d28 
Dealt to 2eabd980 
Dealt to Hero [7d 7c]
Dealt to a1320bd6 
Dealt to f19292be 
Hero: raises $0.38 to $0.63
a1320bd6: folds
f19292be: folds
359d23bf: folds
f92e6d28: folds
2eabd980: folds
Uncalled bet ($0.38) returned to Hero
*** SHOWDOWN ***
Hero collected $0.6 from pot
*** SUMMARY ***
Total pot $0.6
Seat 1: 359d23bf (button) folded before Flop (didn't bet)
Seat 2: f92e6d28 (small blind) folded before Flop
Seat 3: 2eabd980 (big blind) folded before Flop
Seat 4: Hero collected ($0.6)
Seat 5: a1320bd6 folded before Flop (didn't bet)
Seat 6: f19292be folded before Flop (didn't bet)


Poker Hand #RC92804989: Hold'em No Limit ($0.1/$0.25) - 2020/04/02 23:36:33
Table 'RushAndCash46719' 6-max Seat #1 is the button
Seat 1: Hero ($36.22 in chips)
Seat 2: e3fa4802 ($25 in chips)
Seat 3: 89a3eced ($215.19 in chips)
Seat 4: 2d8ae955 ($25 in chips)
Seat 5: 1e7ee1e0 ($13.24 in chips)
Seat 6: 1c532a9e ($17.75 in chips)
e3fa4802: posts small blind $0.1
89a3eced: posts big blind $0.25
*** HOLE CARDS ***
Dealt to Hero [3s 2c]
Dealt to e3fa4802 
Dealt to 89a3eced 
Dealt to 2d8ae955 
Dealt to 1e7ee1e0 
Dealt to 1c532a9e 
2d8ae955: folds
1e7ee1e0: folds
1c532a9e: folds
Hero: folds
e3fa4802: folds
Uncalled bet ($0.15) returned to 89a3eced
*** SHOWDOWN ***
89a3eced collected $0.2 from pot
*** SUMMARY ***
Total pot $0.2
Seat 1: Hero (button) folded before Flop (didn't bet)
Seat 2: e3fa4802 (small blind) folded before Flop
Seat 3: 89a3eced (big blind) collected ($0.2)
Seat 4: 2d8ae955 folded before Flop (didn't bet)
Seat 5: 1e7ee1e0 folded before Flop (didn't bet)
Seat 6: 1c532a9e folded before Flop (didn't bet)


Poker Hand #RC92805014: Hold'em No Limit ($0.1/$0.25) - 2020/04/02 23:36:38
Table 'RushAndCash46722' 6-max Seat #1 is the button
Seat 1: 97dacd30 ($9.17 in chips)
Seat 2: ca320935 ($104.82 in chips)
Seat 3: Hero ($36.22 in chips)
Seat 4: 163fde06 ($52.06 in chips)
Seat 5: 33dc6448 ($39.3 in chips)
Seat 6: 1c532a9e ($17.75 in chips)
ca320935: posts small blind $0.1
Hero: posts big blind $0.25
*** HOLE CARDS ***
Dealt to 97dacd30 
Dealt to ca320935 
Dealt to Hero [Ah Kd]
Dealt to 163fde06 
Dealt to 33dc6448 
Dealt to 1c532a9e 
163fde06: raises $0.38 to $0.63
33dc6448: raises $1.37 to $2
1c532a9e: folds
97dacd30: folds
ca320935: folds
Hero: raises $2.95 to $4.95
163fde06: folds
33dc6448: folds
Uncalled bet ($2.95) returned to Hero
*** SHOWDOWN ***
Hero collected $4.73 from pot
*** SUMMARY ***
Total pot $4.73
Seat 1: 97dacd30 (button) folded before Flop (didn't bet)
Seat 2: ca320935 (small blind) folded before Flop
Seat 3: Hero (big blind) collected ($4.73)
Seat 4: 163fde06 folded before Flop
Seat 5: 33dc6448 folded before Flop
Seat 6: 1c532a9e folded before Flop (didn't bet)


Poker Hand #RC92805172: Hold'em No Limit ($0.1/$0.25) - 2020/04/02 23:37:06
Table 'RushAndCash46741' 6-max Seat #1 is the button
Seat 1: 163fde06 ($51.43 in chips)
Seat 2: 49a470c7 ($14.45 in chips)
Seat 3: 33dc6448 ($37.3 in chips)
Seat 4: abf9b61c ($28.28 in chips)
Seat 5: Hero ($38.72 in chips)
Seat 6: b912752f ($19.33 in chips)
49a470c7: posts small blind $0.1
33dc6448: posts big blind $0.25
*** HOLE CARDS ***
Dealt to 163fde06 
Dealt to 49a470c7 
Dealt to 33dc6448 
Dealt to abf9b61c 
Dealt to Hero [As 4s]
Dealt to b912752f 
abf9b61c: folds
Hero: raises $0.38 to $0.63
b912752f: folds
163fde06: folds
49a470c7: folds
33dc6448: folds
Uncalled bet ($0.38) returned to Hero
*** SHOWDOWN ***
Hero collected $0.6 from pot
*** SUMMARY ***
Total pot $0.6
Seat 1: 163fde06 (button) folded before Flop (didn't bet)
Seat 2: 49a470c7 (small blind) folded before Flop
Seat 3: 33dc6448 (big blind) folded before Flop
Seat 4: abf9b61c folded before Flop (didn't bet)
Seat 5: Hero collected ($0.6)
Seat 6: b912752f folded before Flop (didn't bet)


Poker Hand #RC92805247: Hold'em No Limit ($0.1/$0.25) - 2020/04/02 23:37:18
Table 'RushAndCash46750' 6-max Seat #1 is the button
Seat 1: 33dc6448 ($36.95 in chips)
Seat 2: Hero ($39.07 in chips)
Seat 3: 89a3eced ($215.19 in chips)
Seat 4: abf9b61c ($28.28 in chips)
Seat 5: beb120aa ($20.77 in chips)
Seat 6: f92e6d28 ($25 in chips)
Hero: posts small blind $0.1
89a3eced: posts big blind $0.25
*** HOLE CARDS ***
Dealt to 33dc6448 
Dealt to Hero [Ah 7d]
Dealt to 89a3eced 
Dealt to abf9b61c 
Dealt to beb120aa 
Dealt to f92e6d28 
abf9b61c: folds
beb120aa: folds
f92e6d28: raises $0.38 to $0.63
33dc6448: folds
Hero: folds
89a3eced: calls $0.38
*** FLOP *** [Kc 6s Qs]
89a3eced: checks
f92e6d28: checks
*** TURN *** [Kc 6s Qs] [Td]
89a3eced: checks
f92e6d28: checks
*** RIVER *** [Kc 6s Qs Td] [Ac]
89a3eced: checks
f92e6d28: checks
89a3eced: shows [Qh Kh] (Pair of Kings and Pair of Queens)
f92e6d28: shows [5c 5d] (Pair of Fives)
*** SHOWDOWN ***
89a3eced collected $1.36 from pot
*** SUMMARY ***
Total pot $1.36
Board [Kc 6s Qs Td Ac]
Seat 1: 33dc6448 (button) folded before Flop (didn't bet)
Seat 2: Hero (small blind) folded before Flop
Seat 3: 89a3eced (big blind) showed [Kh Qh] and won ($1.36) with Pair of Kings and Pair of Queens
Seat 4: abf9b61c folded before Flop (didn't bet)
Seat 5: beb120aa folded before Flop (didn't bet)
Seat 6: f92e6d28 showed [5d 5c] and lost with Pair of Fives


Poker Hand #RC92805275: Hold'em No Limit ($0.1/$0.25) - 2020/04/02 23:37:22
Table 'RushAndCash46753' 6-max Seat #1 is the button
Seat 1: 1e7ee1e0 ($13.24 in chips)
Seat 2: d0ad217d ($13.45 in chips)
Seat 3: beb120aa ($20.77 in chips)
Seat 4: Hero ($38.97 in chips)
Seat 5: 359d23bf ($25.59 in chips)
Seat 6: 33dc6448 ($36.95 in chips)
d0ad217d: posts small blind $0.1
beb120aa: posts big blind $0.25
*** HOLE CARDS ***
Dealt to 1e7ee1e0 
Dealt to d0ad217d 
Dealt to beb120aa 
Dealt to Hero [Td 3h]
Dealt to 359d23bf 
Dealt to 33dc6448 
Hero: folds
359d23bf: raises $0.38 to $0.63
33dc6448: folds
1e7ee1e0: folds
d0ad217d: raises $1.57 to $2.2
beb120aa: folds
359d23bf: raises $23.39 to $25.59 and is all-in
d0ad217d: calls $11.25 and is all-in
Uncalled bet ($12.14) returned to 359d23bf
359d23bf: shows [As Js]
d0ad217d: shows [Ah Kd]
*** FLOP *** [8d 3s 6h]
d0ad217d: get an all-in insurance (premium ($0/$1.35/$0) for ($0/$13.5/$0) - (Mandatory/Main/Sub))
*** TURN *** [8d 3s 6h] [4c]
d0ad217d: pay premium of all-in insurance ($1.35)
d0ad217d: get an all-in insurance (premium ($0/$0.9/$0) for ($0/$9/$0) - (Mandatory/Main/Sub))
*** RIVER *** [8d 3s 6h 4c] [7h]
d0ad217d: pay premium of all-in insurance ($0.9)
*** SHOWDOWN ***
d0ad217d collected $27.15 from pot
*** SUMMARY ***
Total pot $27.15
Board [8d 3s 6h 4c 7h]
Seat 1: 1e7ee1e0 (button) folded before Flop (didn't bet)
Seat 2: d0ad217d (small blind) showed [Ah Kd] and won ($27.15) with Ace-High, AII Premium ($2.25)
Seat 3: beb120aa (big blind) folded before Flop
Seat 4: Hero folded before Flop (didn't bet)
Seat 5: 359d23bf showed [As Js] and lost with Ace-High
Seat 6: 33dc6448 folded before Flop (didn't bet)


Poker Hand #RC92805293: Hold'em No Limit ($0.1/$0.25) - 2020/04/02 23:37:26
Table 'RushAndCash46755' 6-max Seat #1 is the button
Seat 1: ca320935 ($104.37 in chips)
Seat 2: a36379d9 ($37.19 in chips)
Seat 3: 40123cec ($15.2 in chips)
Seat 4: 5167702 ($44.31 in chips)
Seat 5: 163fde06 ($51.08 in chips)
Seat 6: Hero ($38.97 in chips)
a36379d9: posts small blind $0.1
40123cec: posts big blind $0.25
*** HOLE CARDS ***
Dealt to ca320935 
Dealt to a36379d9 
Dealt to 40123cec 
Dealt to 5167702 
Dealt to 163fde06 
Dealt to Hero [8c 5d]
5167702: folds
163fde06: raises $0.38 to $0.63
Hero: folds
ca320935: folds
a36379d9: folds
40123cec: folds
Uncalled bet ($0.38) returned to 163fde06
*** SHOWDOWN ***
163fde06 collected $0.6 from pot
*** SUMMARY ***
Total pot $0.6
Seat 1: ca320935 (button) folded before Flop (didn't bet)
Seat 2: a36379d9 (small blind) folded before Flop
Seat 3: 40123cec (big blind) folded before Flop
Seat 4: 5167702 folded before Flop (didn't bet)
Seat 5: 163fde06 collected ($0.6)
Seat 6: Hero folded before Flop (didn't bet)


Poker Hand #RC92805321: Hold'em No Limit ($0.1/$0.25) - 2020/04/02 23:37:31
Table 'RushAndCash46757' 6-max Seat #1 is the button
Seat 1: Hero ($38.97 in chips)
Seat 2: 5f034738 ($29.48 in chips)
Seat 3: ca32c452 ($25.06 in chips)
Seat 4: ca320935 ($104.37 in chips)
Seat 5: a36379d9 ($37.09 in chips)
Seat 6: 3ea34051 ($13.86 in chips)
5f034738: posts small blind $0.1
ca32c452: posts big blind $0.25
*** HOLE CARDS ***
Dealt to Hero [Kc Jh]
Dealt to 5f034738 
Dealt to ca32c452 
Dealt to ca320935 
Dealt to a36379d9 
Dealt to 3ea34051 
ca320935: folds
a36379d9: folds
3ea34051: folds
Hero: raises $0.38 to $0.63
5f034738: folds
ca32c452: calls $0.38
*** FLOP *** [Jc 7d 8d]
ca32c452: checks
Hero: bets $1.1
ca32c452: folds
Uncalled bet ($1.1) returned to Hero
*** SHOWDOWN ***
Hero collected $1.36 from pot
*** SUMMARY ***
Total pot $1.36
Board [Jc 7d 8d]
Seat 1: Hero (button) won ($1.36)
Seat 2: 5f034738 (small blind) folded before Flop
Seat 3: ca32c452 (big blind) folded on the Flop
Seat 4: ca320935 folded before Flop (didn't bet)
Seat 5: a36379d9 folded before Flop (didn't bet)
Seat 6: 3ea34051 folded before Flop (didn't bet)


Poker Hand #RC92805494: Hold'em No Limit ($0.1/$0.25) - 2020/04/02 23:38:03
Table 'RushAndCash46776' 6-max Seat #1 is the button
Seat 1: a36379d9 ($36.74 in chips)
Seat 2: cf7b9ac1 ($28.31 in chips)
Seat 3: Hero ($39.64 in chips)
Seat 4: b6875a20 ($31.53 in chips)
Seat 5: e5667aa7 ($107.21 in chips)
Seat 6: f43af171 ($25.8 in chips)
cf7b9ac1: posts small blind $0.1
Hero: posts big blind $0.25
*** HOLE CARDS ***
Dealt to a36379d9 
Dealt to cf7b9ac1 
Dealt to Hero [6c 4h]
Dealt to b6875a20 
Dealt to e5667aa7 
Dealt to f43af171 
b6875a20: folds
e5667aa7: folds
f43af171: folds
a36379d9: raises $0.38 to $0.63
cf7b9ac1: folds
Hero: folds
Uncalled bet ($0.38) returned to a36379d9
*** SHOWDOWN ***
a36379d9 collected $0.6 from pot
*** SUMMARY ***
Total pot $0.6
Seat 1: a36379d9 (button) collected ($0.6)
Seat 2: cf7b9ac1 (small blind) folded before Flop
Seat 3: Hero (big blind) folded before Flop
Seat 4: b6875a20 folded before Flop (didn't bet)
Seat 5: e5667aa7 folded before Flop (didn't bet)
Seat 6: f43af171 folded before Flop (didn't bet)


Poker Hand #RC92805514: Hold'em No Limit ($0.1/$0.25) - 2020/04/02 23:38:07
Table 'RushAndCash46779' 6-max Seat #1 is the button
Seat 1: f19292be ($32.63 in chips)
Seat 2: Hero ($39.39 in chips)
Seat 3: cf7b9ac1 ($28.21 in chips)
Seat 4: 49a470c7 ($14 in chips)
Seat 5: e5667aa7 ($107.21 in chips)
Seat 6: f92e6d28 ($25 in chips)
Hero: posts small blind $0.1
cf7b9ac1: posts big blind $0.25
*** HOLE CARDS ***
Dealt to f19292be 
Dealt to Hero [6d 4d]
Dealt to cf7b9ac1 
Dealt to 49a470c7 
Dealt to e5667aa7 
Dealt to f92e6d28 
49a470c7: folds
e5667aa7: folds
f92e6d28: raises $0.38 to $0.63
f19292be: folds
Hero: folds
cf7b9ac1: calls $0.38
*** FLOP *** [7h As 9d]
cf7b9ac1: checks
f92e6d28: bets $0.7
cf7b9ac1: folds
Uncalled bet ($0.7) returned to f92e6d28
*** SHOWDOWN ***
f92e6d28 collected $1.36 from pot
*** SUMMARY ***
Total pot $1.36
Board [7h As 9d]
Seat 1: f19292be (button) folded before Flop (didn't bet)
Seat 2: Hero (small blind) folded before Flop
Seat 3: cf7b9ac1 (big blind) folded on the Flop
Seat 4: 49a470c7 folded before Flop (didn't bet)
Seat 5: e5667aa7 folded before Flop (didn't bet)
Seat 6: f92e6d28 won ($1.36)


Poker Hand #RC92805547: Hold'em No Limit ($0.1/$0.25) - 2020/04/02 23:38:14
Table 'RushAndCash46782' 6-max Seat #1 is the button
Seat 1: ab641f7 ($59.88 in chips)
Seat 2: f19292be ($32.63 in chips)
Seat 3: c27aaa40 ($83.43 in chips)
Seat 4: Hero ($39.29 in chips)
Seat 5: 97dacd30 ($9.17 in chips)
Seat 6: e5667aa7 ($107.21 in chips)
f19292be: posts small blind $0.1
c27aaa40: posts big blind $0.25
*** HOLE CARDS ***
Dealt to ab641f7 
Dealt to f19292be 
Dealt to c27aaa40 
Dealt to Hero [Qs 2h]
Dealt to 97dacd30 
Dealt to e5667aa7 
Hero: folds
97dacd30: folds
e5667aa7: raises $0.38 to $0.63
ab641f7: folds
f19292be: folds
c27aaa40: folds
Uncalled bet ($0.38) returned to e5667aa7
*** SHOWDOWN ***
e5667aa7 collected $0.6 from pot
*** SUMMARY ***
Total pot $0.6
Seat 1: ab641f7 (button) folded before Flop (didn't bet)
Seat 2: f19292be (small blind) folded before Flop
Seat 3: c27aaa40 (big blind) folded before Flop
Seat 4: Hero folded before Flop (didn't bet)
Seat 5: 97dacd30 folded before Flop (didn't bet)
Seat 6: e5667aa7 collected ($0.6)


Poker Hand #RC92805568: Hold'em No Limit ($0.1/$0.25) - 2020/04/02 23:38:18
Table 'RushAndCash46785' 6-max Seat #1 is the button
Seat 1: 5167702 ($44.66 in chips)
Seat 2: 5136ebb4 ($41.09 in chips)
Seat 3: c27aaa40 ($83.18 in chips)
Seat 4: Hero ($39.29 in chips)
Seat 5: 49a470c7 ($14 in chips)
Seat 6: 33dc6448 ($37.3 in chips)
5136ebb4: posts small blind $0.1
c27aaa40: posts big blind $0.25
*** HOLE CARDS ***
Dealt to 5167702 
Dealt to 5136ebb4 
Dealt to c27aaa40 
Dealt to Hero [Jc 4h]
Dealt to 49a470c7 
Dealt to 33dc6448 
Hero: folds
49a470c7: folds
33dc6448: folds
5167702: folds
5136ebb4: raises $0.5 to $0.75
c27aaa40: folds
Uncalled bet ($0.5) returned to 5136ebb4
*** SHOWDOWN ***
5136ebb4 collected $0.5 from pot
*** SUMMARY ***
Total pot $0.5
Seat 1: 5167702 (button) folded before Flop (didn't bet)
Seat 2: 5136ebb4 (small blind) collected ($0.5)
Seat 3: c27aaa40 (big blind) folded before Flop
Seat 4: Hero folded before Flop (didn't bet)
Seat 5: 49a470c7 folded before Flop (didn't bet)
Seat 6: 33dc6448 folded before Flop (didn't bet)


Poker Hand #RC92805602: Hold'em No Limit ($0.1/$0.25) - 2020/04/02 23:38:23
Table 'RushAndCash46788' 6-max Seat #1 is the button
Seat 1: 833dc1e7 ($90.24 in chips)
Seat 2: b912752f ($15.95 in chips)
Seat 3: 7adcb578 ($50.92 in chips)
Seat 4: 49a470c7 ($14 in chips)
Seat 5: a36379d9 ($37.09 in chips)
Seat 6: Hero ($39.29 in chips)
b912752f: posts small blind $0.1
7adcb578: posts big blind $0.25
*** HOLE CARDS ***
Dealt to 833dc1e7 
Dealt to b912752f 
Dealt to 7adcb578 
Dealt to 49a470c7 
Dealt to a36379d9 
Dealt to Hero [Qd Ts]
49a470c7: folds
a36379d9: folds
Hero: folds
833dc1e7: raises $0.5 to $0.75
b912752f: raises $1.35 to $2.1
7adcb578: folds
833dc1e7: calls $1.35
*** FLOP *** [3d 9d 4d]
b912752f: checks
833dc1e7: bets $1.5
b912752f: raises $12.35 to $13.85 and is all-in
833dc1e7: calls $12.35
b912752f: shows [Kd 8s] (King-High)
833dc1e7: shows [Qs Ad] (Ace-High)
833dc1e7: get an all-in insurance (premium ($0/$2/$0) for ($0/$12/$0) - (Mandatory/Main/Sub))
*** TURN *** [3d 9d 4d] [Kc]
833dc1e7: get main compensation of all-in insurance ($12)
b912752f: get an all-in insurance (premium ($0/$7.25/$0) for ($0/$15.95/$0) - (Mandatory/Main/Sub))
*** RIVER *** [3d 9d 4d Kc] [8c]
b912752f: pay premium of all-in insurance ($7.25)
*** SHOWDOWN ***
b912752f collected $32.15 from pot
*** SUMMARY ***
Total pot $32.15
Board [3d 9d 4d Kc 8c]
Seat 1: 833dc1e7 (button) showed [Ad Qs] and lost with Ace-High, AII Compensation ($12)
Seat 2: b912752f (small blind) showed [Kd 8s] and won ($32.15) with Pair of Kings and Pair of Eights, AII Premium ($7.25)
Seat 3: 7adcb578 (big blind) folded before Flop
Seat 4: 49a470c7 folded before Flop (didn't bet)
Seat 5: a36379d9 folded before Flop (didn't bet)
Seat 6: Hero folded before Flop (didn't bet)


Poker Hand #RC92805637: Hold'em No Limit ($0.1/$0.25) - 2020/04/02 23:38:30
Table 'RushAndCash46793' 6-max Seat #1 is the button
Seat 1: 40123cec ($14.2 in chips)
Seat 2: c27aaa40 ($82.83 in chips)
Seat 3: 2eabd980 ($16.92 in chips)
Seat 4: e3fa4802 ($25.23 in chips)
Seat 5: Hero ($39.29 in chips)
Seat 6: 33dc6448 ($37.3 in chips)
c27aaa40: posts small blind $0.1
2eabd980: posts big blind $0.25
*** HOLE CARDS ***
Dealt to 40123cec 
Dealt to c27aaa40 
Dealt to 2eabd980 
Dealt to e3fa4802 
Dealt to Hero [Js 8h]
Dealt to 33dc6448 
e3fa4802: raises $0.5 to $0.75
Hero: folds
33dc6448: folds
40123cec: folds
c27aaa40: folds
2eabd980: folds
Uncalled bet ($0.5) returned to e3fa4802
*** SHOWDOWN ***
e3fa4802 collected $0.6 from pot
*** SUMMARY ***
Total pot $0.6
Seat 1: 40123cec (button) folded before Flop (didn't bet)
Seat 2: c27aaa40 (small blind) folded before Flop
Seat 3: 2eabd980 (big blind) folded before Flop
Seat 4: e3fa4802 collected ($0.6)
Seat 5: Hero folded before Flop (didn't bet)
Seat 6: 33dc6448 folded before Flop (didn't bet)


Poker Hand #RC92805665: Hold'em No Limit ($0.1/$0.25) - 2020/04/02 23:38:34
Table 'RushAndCash46797' 6-max Seat #1 is the button
Seat 1: Hero ($39.29 in chips)
Seat 2: 2eabd980 ($16.67 in chips)
Seat 3: 33dc6448 ($37.3 in chips)
Seat 4: 89a3eced ($216.55 in chips)
Seat 5: 40123cec ($14.2 in chips)
Seat 6: 1c532a9e ($14.3 in chips)
2eabd980: posts small blind $0.1
33dc6448: posts big blind $0.25
*** HOLE CARDS ***
Dealt to Hero [Ac 3d]
Dealt to 2eabd980 
Dealt to 33dc6448 
Dealt to 89a3eced 
Dealt to 40123cec 
Dealt to 1c532a9e 
89a3eced: folds
40123cec: folds
1c532a9e: folds
Hero: folds
2eabd980: raises $0.5 to $0.75
33dc6448: folds
Uncalled bet ($0.5) returned to 2eabd980
*** SHOWDOWN ***
2eabd980 collected $0.5 from pot
*** SUMMARY ***
Total pot $0.5
Seat 1: Hero (button) folded before Flop (didn't bet)
Seat 2: 2eabd980 (small blind) collected ($0.5)
Seat 3: 33dc6448 (big blind) folded before Flop
Seat 4: 89a3eced folded before Flop (didn't bet)
Seat 5: 40123cec folded before Flop (didn't bet)
Seat 6: 1c532a9e folded before Flop (didn't bet)


Poker Hand #RC92805683: Hold'em No Limit ($0.1/$0.25) - 2020/04/02 23:38:38
Table 'RushAndCash46800' 6-max Seat #1 is the button
Seat 1: 803a0c06 ($25.25 in chips)
Seat 2: ca320935 ($104.12 in chips)
Seat 3: Hero ($39.29 in chips)
Seat 4: ab641f7 ($59.53 in chips)
Seat 5: bcf79ef3 ($11.81 in chips)
Seat 6: 1c532a9e ($14.3 in chips)
ca320935: posts small blind $0.1
Hero: posts big blind $0.25
*** HOLE CARDS ***
Dealt to 803a0c06 
Dealt to ca320935 
Dealt to Hero [7c 5d]
Dealt to ab641f7 
Dealt to bcf79ef3 
Dealt to 1c532a9e 
ab641f7: folds
bcf79ef3: folds
1c532a9e: raises $0.5 to $0.75
803a0c06: folds
ca320935: folds
Hero: folds
Uncalled bet ($0.5) returned to 1c532a9e
*** SHOWDOWN ***
1c532a9e collected $0.6 from pot
*** SUMMARY ***
Total pot $0.6
Seat 1: 803a0c06 (button) folded before Flop (didn't bet)
Seat 2: ca320935 (small blind) folded before Flop
Seat 3: Hero (big blind) folded before Flop
Seat 4: ab641f7 folded before Flop (didn't bet)
Seat 5: bcf79ef3 folded before Flop (didn't bet)
Seat 6: 1c532a9e collected ($0.6)


Poker Hand #RC92805710: Hold'em No Limit ($0.1/$0.25) - 2020/04/02 23:38:43
Table 'RushAndCash46803' 6-max Seat #1 is the button
Seat 1: b320ed6a ($56.29 in chips)
Seat 2: b6875a20 ($31.28 in chips)
Seat 3: ab641f7 ($59.53 in chips)
Seat 4: Hero ($39.04 in chips)
Seat 5: 7eb96805 ($14.18 in chips)
Seat 6: f19292be ($32.28 in chips)
b6875a20: posts small blind $0.1
ab641f7: posts big blind $0.25
*** HOLE CARDS ***
Dealt to b320ed6a 
Dealt to b6875a20 
Dealt to ab641f7 
Dealt to Hero [8s 7s]
Dealt to 7eb96805 
Dealt to f19292be 
Hero: folds
7eb96805: raises $0.5 to $0.75
f19292be: folds
b320ed6a: folds
b6875a20: folds
ab641f7: folds
Uncalled bet ($0.5) returned to 7eb96805
*** SHOWDOWN ***
7eb96805 collected $0.6 from pot
*** SUMMARY ***
Total pot $0.6
Seat 1: b320ed6a (button) folded before Flop (didn't bet)
Seat 2: b6875a20 (small blind) folded before Flop
Seat 3: ab641f7 (big blind) folded before Flop
Seat 4: Hero folded before Flop (didn't bet)
Seat 5: 7eb96805 collected ($0.6)
Seat 6: f19292be folded before Flop (didn't bet)


Poker Hand #RC92805750: Hold'em No Limit ($0.1/$0.25) - 2020/04/02 23:38:50
Table 'RushAndCash46807' 6-max Seat #1 is the button
Seat 1: ab641f7 ($59.28 in chips)
Seat 2: Hero ($39.04 in chips)
Seat 3: 5f034738 ($30.06 in chips)
Seat 4: f19292be ($32.28 in chips)
Seat 5: 163fde06 ($50.98 in chips)
Seat 6: 57b0a14c ($26.82 in chips)
Hero: posts small blind $0.1
5f034738: posts big blind $0.25
*** HOLE CARDS ***
Dealt to ab641f7 
Dealt to Hero [8s 3s]
Dealt to 5f034738 
Dealt to f19292be 
Dealt to 163fde06 
Dealt to 57b0a14c 
f19292be: folds
163fde06: folds
57b0a14c: folds
ab641f7: folds
Hero: folds
Uncalled bet ($0.15) returned to 5f034738
*** SHOWDOWN ***
5f034738 collected $0.2 from pot
*** SUMMARY ***
Total pot $0.2
Seat 1: ab641f7 (button) folded before Flop (didn't bet)
Seat 2: Hero (small blind) folded before Flop
Seat 3: 5f034738 (big blind) collected ($0.2)
Seat 4: f19292be folded before Flop (didn't bet)
Seat 5: 163fde06 folded before Flop (didn't bet)
Seat 6: 57b0a14c folded before Flop (didn't bet)


Poker Hand #RC92805783: Hold'em No Limit ($0.1/$0.25) - 2020/04/02 23:38:56
Table 'RushAndCash46811' 6-max Seat #1 is the button
Seat 1: 163fde06 ($50.98 in chips)
Seat 2: f19292be ($32.28 in chips)
Seat 3: 7db17161 ($49.77 in chips)
Seat 4: eb18162e ($34.85 in chips)
Seat 5: Hero ($38.94 in chips)
Seat 6: ca320935 ($104.02 in chips)
f19292be: posts small blind $0.1
7db17161: posts big blind $0.25
*** HOLE CARDS ***
Dealt to 163fde06 
Dealt to f19292be 
Dealt to 7db17161 
Dealt to eb18162e 
Dealt to Hero [Ks Kd]
Dealt to ca320935 
eb18162e: folds
Hero: raises $0.38 to $0.63
ca320935: folds
163fde06: folds
f19292be: raises $1.97 to $2.6
7db17161: folds
Hero: raises $3.42 to $6.02
f19292be: folds
Uncalled bet ($3.42) returned to Hero
*** SHOWDOWN ***
Hero collected $5.45 from pot
*** SUMMARY ***
Total pot $5.45
Seat 1: 163fde06 (button) folded before Flop (didn't bet)
Seat 2: f19292be (small blind) folded before Flop
Seat 3: 7db17161 (big blind) folded before Flop
Seat 4: eb18162e folded before Flop (didn't bet)
Seat 5: Hero collected ($5.45)
Seat 6: ca320935 folded before Flop (didn't bet)


Poker Hand #RC92805930: Hold'em No Limit ($0.1/$0.25) - 2020/04/02 23:39:22
Table 'RushAndCash46825' 6-max Seat #1 is the button
Seat 1: 92614a31 ($51.17 in chips)
Seat 2: abf9b61c ($28.6 in chips)
Seat 3: c28873d2 ($59.24 in chips)
Seat 4: 5167702 ($44.56 in chips)
Seat 5: ca320935 ($103.92 in chips)
Seat 6: Hero ($41.52 in chips)
abf9b61c: posts small blind $0.1
c28873d2: posts big blind $0.25
*** HOLE CARDS ***
Dealt to 92614a31 
Dealt to abf9b61c 
Dealt to c28873d2 
Dealt to 5167702 
Dealt to ca320935 
Dealt to Hero [7h 6c]
5167702: folds
ca320935: raises $0.5 to $0.75
Hero: folds
92614a31: folds
abf9b61c: folds
c28873d2: folds
Uncalled bet ($0.5) returned to ca320935
*** SHOWDOWN ***
ca320935 collected $0.6 from pot
*** SUMMARY ***
Total pot $0.6
Seat 1: 92614a31 (button) folded before Flop (didn't bet)
Seat 2: abf9b61c (small blind) folded before Flop
Seat 3: c28873d2 (big blind) folded before Flop
Seat 4: 5167702 folded before Flop (didn't bet)
Seat 5: ca320935 collected ($0.6)
Seat 6: Hero folded before Flop (didn't bet)


Poker Hand #RC92805952: Hold'em No Limit ($0.1/$0.25) - 2020/04/02 23:39:26
Table 'RushAndCash46828' 6-max Seat #1 is the button
Seat 1: Hero ($41.52 in chips)
Seat 2: 7eb96805 ($14.28 in chips)
Seat 3: f19292be ($29.68 in chips)
Seat 4: 2bebd6e7 ($20.96 in chips)
Seat 5: ca32c452 ($25.1 in chips)
Seat 6: e5667aa7 ($107.5 in chips)
7eb96805: posts small blind $0.1
f19292be: posts big blind $0.25
*** HOLE CARDS ***
Dealt to Hero [4d 2d]
Dealt to 7eb96805 
Dealt to f19292be 
Dealt to 2bebd6e7 
Dealt to ca32c452 
Dealt to e5667aa7 
2bebd6e7: raises $0.38 to $0.63
ca32c452: folds
e5667aa7: folds
Hero: folds
7eb96805: folds
f19292be: folds
Uncalled bet ($0.38) returned to 2bebd6e7
*** SHOWDOWN ***
2bebd6e7 collected $0.6 from pot
*** SUMMARY ***
Total pot $0.6
Seat 1: Hero (button) folded before Flop (didn't bet)
Seat 2: 7eb96805 (small blind) folded before Flop
Seat 3: f19292be (big blind) folded before Flop
Seat 4: 2bebd6e7 collected ($0.6)
Seat 5: ca32c452 folded before Flop (didn't bet)
Seat 6: e5667aa7 folded before Flop (didn't bet)


Poker Hand #RC92805976: Hold'em No Limit ($0.1/$0.25) - 2020/04/02 23:39:31
Table 'RushAndCash46832' 6-max Seat #1 is the button
Seat 1: 163fde06 ($51.43 in chips)
Seat 2: cbf0ae65 ($12.25 in chips)
Seat 3: Hero ($41.52 in chips)
Seat 4: ab641f7 ($61.3 in chips)
Seat 5: 5a8dd9c3 ($26.64 in chips)
Seat 6: e5667aa7 ($107.5 in chips)
cbf0ae65: posts small blind $0.1
Hero: posts big blind $0.25
*** HOLE CARDS ***
Dealt to 163fde06 
Dealt to cbf0ae65 
Dealt to Hero [Ah 2d]
Dealt to ab641f7 
Dealt to 5a8dd9c3 
Dealt to e5667aa7 
ab641f7: folds
5a8dd9c3: raises $0.5 to $0.75
e5667aa7: folds
163fde06: folds
cbf0ae65: folds
Hero: folds
Uncalled bet ($0.5) returned to 5a8dd9c3
*** SHOWDOWN ***
5a8dd9c3 collected $0.6 from pot
*** SUMMARY ***
Total pot $0.6
Seat 1: 163fde06 (button) folded before Flop (didn't bet)
Seat 2: cbf0ae65 (small blind) folded before Flop
Seat 3: Hero (big blind) folded before Flop
Seat 4: ab641f7 folded before Flop (didn't bet)
Seat 5: 5a8dd9c3 collected ($0.6)
Seat 6: e5667aa7 folded before Flop (didn't bet)


Poker Hand #RC92805998: Hold'em No Limit ($0.1/$0.25) - 2020/04/02 23:39:35
Table 'RushAndCash46835' 6-max Seat #1 is the button
Seat 1: 1e7ee1e0 ($13.16 in chips)
Seat 2: Hero ($41.27 in chips)
Seat 3: 5d45f961 ($12.5 in chips)
Seat 4: 57b0a14c ($26.82 in chips)
Seat 5: 9c1f26b8 ($25 in chips)
Seat 6: c427ddfc ($59 in chips)
Hero: posts small blind $0.1
5d45f961: posts big blind $0.25
*** HOLE CARDS ***
Dealt to 1e7ee1e0 
Dealt to Hero [Ad Qh]
Dealt to 5d45f961 
Dealt to 57b0a14c 
Dealt to 9c1f26b8 
Dealt to c427ddfc 
57b0a14c: raises $0.38 to $0.63
9c1f26b8: folds
c427ddfc: folds
1e7ee1e0: folds
Hero: calls $0.53
5d45f961: folds
*** FLOP *** [5c 6s 4s]
Hero: checks
57b0a14c: bets $1
Hero: folds
Uncalled bet ($1) returned to 57b0a14c
*** SHOWDOWN ***
57b0a14c collected $1.51 from pot
*** SUMMARY ***
Total pot $1.51
Board [5c 6s 4s]
Seat 1: 1e7ee1e0 (button) folded before Flop (didn't bet)
Seat 2: Hero (small blind) folded on the Flop
Seat 3: 5d45f961 (big blind) folded before Flop
Seat 4: 57b0a14c won ($1.51)
Seat 5: 9c1f26b8 folded before Flop (didn't bet)
Seat 6: c427ddfc folded before Flop (didn't bet)


Poker Hand #RC92806232: Hold'em No Limit ($0.1/$0.25) - 2020/04/02 23:40:18
Table 'RushAndCash46869' 6-max Seat #1 is the button
Seat 1: e5667aa7 ($107.05 in chips)
Seat 2: e3fa4802 ($23.95 in chips)
Seat 3: 57b0a14c ($27.63 in chips)
Seat 4: Hero ($40.64 in chips)
Seat 5: 34343caf ($26.15 in chips)
Seat 6: bcf79ef3 ($11.91 in chips)
e3fa4802: posts small blind $0.1
57b0a14c: posts big blind $0.25
*** HOLE CARDS ***
Dealt to e5667aa7 
Dealt to e3fa4802 
Dealt to 57b0a14c 
Dealt to Hero [Ah Th]
Dealt to 34343caf 
Dealt to bcf79ef3 
Hero: raises $0.38 to $0.63
34343caf: calls $0.63
bcf79ef3: folds
e5667aa7: folds
e3fa4802: folds
57b0a14c: folds
*** FLOP *** [2h 9s Tc]
Hero: bets $0.87
34343caf: raises $2.28 to $3.15
Hero: raises $4.02 to $7.17
34343caf: raises $18.35 to $25.52 and is all-in
Hero: calls $18.35
34343caf: shows [9h 9d] (Three Nines)
Hero: shows [Th Ah] (Pair of Tens)
*** FIRST TURN *** [2h 9s Tc] [8s]
*** FIRST RIVER *** [2h 9s Tc 8s] [Qh]
*** SECOND TURN *** [2h 9s Tc] [Td]
*** SECOND RIVER *** [2h 9s Tc Td] [3d]
*** FIRST SHOWDOWN ***
34343caf collected $26.32 from pot
*** SECOND SHOWDOWN ***
34343caf collected $26.32 from pot
*** SUMMARY ***
Total pot $52.65
Hand was run two times
FIRST Board [2h 9s Tc 8s Qh]
SECOND Board [2h 9s Tc Td 3d]
Seat 1: e5667aa7 (button) folded before Flop (didn't bet)
Seat 2: e3fa4802 (small blind) folded before Flop
Seat 3: 57b0a14c (big blind) folded before Flop
Seat 4: Hero showed [Ah Th] and lost with Pair of Tens, and lost with Three Tens
Seat 5: 34343caf showed [9h 9d] and won ($26.32) with Three Nines, and won ($26.32) with Nines Full over Tens
Seat 6: bcf79ef3 folded before Flop (didn't bet)


Poker Hand #RC92806648: Hold'em No Limit ($0.1/$0.25) - 2020/04/02 23:41:30
Table 'RushAndCash46930' 6-max Seat #1 is the button
Seat 1: 9c1f26b8 ($25.1 in chips)
Seat 2: ca320935 ($104.22 in chips)
Seat 3: cbf0ae65 ($12.15 in chips)
Seat 4: e4b820db ($48.73 in chips)
Seat 5: Hero ($25 in chips)
Seat 6: 833dc1e7 ($86.85 in chips)
ca320935: posts small blind $0.1
cbf0ae65: posts big blind $0.25
*** HOLE CARDS ***
Dealt to 9c1f26b8 
Dealt to ca320935 
Dealt to cbf0ae65 
Dealt to e4b820db 
Dealt to Hero [6s 3h]
Dealt to 833dc1e7 
e4b820db: folds
Hero: folds
833dc1e7: folds
9c1f26b8: folds
ca320935: folds
Uncalled bet ($0.15) returned to cbf0ae65
*** SHOWDOWN ***
cbf0ae65 collected $0.2 from pot
*** SUMMARY ***
Total pot $0.2
Seat 1: 9c1f26b8 (button) folded before Flop (didn't bet)
Seat 2: ca320935 (small blind) folded before Flop
Seat 3: cbf0ae65 (big blind) collected ($0.2)
Seat 4: e4b820db folded before Flop (didn't bet)
Seat 5: Hero folded before Flop (didn't bet)
Seat 6: 833dc1e7 folded before Flop (didn't bet)


Poker Hand #RC92806673: Hold'em No Limit ($0.1/$0.25) - 2020/04/02 23:41:33
Table 'RushAndCash46933' 6-max Seat #1 is the button
Seat 1: 945e195e ($11.65 in chips)
Seat 2: 5136ebb4 ($42.55 in chips)
Seat 3: ad3d6d15 ($25.7 in chips)
Seat 4: 64268d2a ($25.35 in chips)
Seat 5: Hero ($25 in chips)
Seat 6: 49a470c7 ($14.66 in chips)
5136ebb4: posts small blind $0.1
ad3d6d15: posts big blind $0.25
*** HOLE CARDS ***
Dealt to 945e195e 
Dealt to 5136ebb4 
Dealt to ad3d6d15 
Dealt to 64268d2a 
Dealt to Hero [Jc 6h]
Dealt to 49a470c7 
64268d2a: raises $0.35 to $0.6
Hero: folds
49a470c7: raises $1.6 to $2.2
945e195e: folds
5136ebb4: folds
ad3d6d15: folds
64268d2a: folds
Uncalled bet ($1.6) returned to 49a470c7
*** SHOWDOWN ***
49a470c7 collected $1.55 from pot
*** SUMMARY ***
Total pot $1.55
Seat 1: 945e195e (button) folded before Flop (didn't bet)
Seat 2: 5136ebb4 (small blind) folded before Flop
Seat 3: ad3d6d15 (big blind) folded before Flop
Seat 4: 64268d2a folded before Flop
Seat 5: Hero folded before Flop (didn't bet)
Seat 6: 49a470c7 collected ($1.55)


Poker Hand #RC92806697: Hold'em No Limit ($0.1/$0.25) - 2020/04/02 23:41:37
Table 'RushAndCash46937' 6-max Seat #1 is the button
Seat 1: 7d3dbc6b ($25.67 in chips)
Seat 2: 9c1f26b8 ($25.1 in chips)
Seat 3: e5667aa7 ($105.15 in chips)
Seat 4: Hero ($25 in chips)
Seat 5: e3fa4802 ($24.3 in chips)
Seat 6: bcf79ef3 ($11.28 in chips)
9c1f26b8: posts small blind $0.1
e5667aa7: posts big blind $0.25
*** HOLE CARDS ***
Dealt to 7d3dbc6b 
Dealt to 9c1f26b8 
Dealt to e5667aa7 
Dealt to Hero [As 9s]
Dealt to e3fa4802 
Dealt to bcf79ef3 
Hero: raises $0.38 to $0.63
e3fa4802: folds
bcf79ef3: folds
7d3dbc6b: folds
9c1f26b8: folds
e5667aa7: folds
Uncalled bet ($0.38) returned to Hero
*** SHOWDOWN ***
Hero collected $0.6 from pot
*** SUMMARY ***
Total pot $0.6
Seat 1: 7d3dbc6b (button) folded before Flop (didn't bet)
Seat 2: 9c1f26b8 (small blind) folded before Flop
Seat 3: e5667aa7 (big blind) folded before Flop
Seat 4: Hero collected ($0.6)
Seat 5: e3fa4802 folded before Flop (didn't bet)
Seat 6: bcf79ef3 folded before Flop (didn't bet)


Poker Hand #RC92806772: Hold'em No Limit ($0.1/$0.25) - 2020/04/02 23:41:51
Table 'RushAndCash46947' 6-max Seat #1 is the button
Seat 1: 33dc6448 ($30.65 in chips)
Seat 2: Hero ($25.35 in chips)
Seat 3: 7eb96805 ($14.06 in chips)
Seat 4: 9c1f26b8 ($25 in chips)
Seat 5: 7d3dbc6b ($25.67 in chips)
Seat 6: 40123cec ($13.81 in chips)
Hero: posts small blind $0.1
7eb96805: posts big blind $0.25
*** HOLE CARDS ***
Dealt to 33dc6448 
Dealt to Hero [8s 8c]
Dealt to 7eb96805 
Dealt to 9c1f26b8 
Dealt to 7d3dbc6b 
Dealt to 40123cec 
9c1f26b8: folds
7d3dbc6b: folds
40123cec: folds
33dc6448: raises $0.38 to $0.63
Hero: calls $0.53
7eb96805: folds
*** FLOP *** [3h 4c 3c]
Hero: checks
33dc6448: bets $0.6
Hero: raises $1.57 to $2.17
33dc6448: calls $1.57
*** TURN *** [3h 4c 3c] [Tc]
Hero: bets $3.35
33dc6448: calls $3.35
*** RIVER *** [3h 4c 3c Tc] [Jc]
Hero: checks
33dc6448: checks
Hero: shows [8c 8s] (Jack High Flush)
33dc6448: shows [9s 9c] (Jack High Flush)
*** SHOWDOWN ***
33dc6448 collected $12.55 from pot
*** SUMMARY ***
Total pot $12.55
Board [3h 4c 3c Tc Jc]
Seat 1: 33dc6448 (button) showed [9s 9c] and won ($12.55) with Jack High Flush
Seat 2: Hero (small blind) showed [8s 8c] and lost with Jack High Flush
Seat 3: 7eb96805 (big blind) folded before Flop
Seat 4: 9c1f26b8 folded before Flop (didn't bet)
Seat 5: 7d3dbc6b folded before Flop (didn't bet)
Seat 6: 40123cec folded before Flop (didn't bet)


Poker Hand #RC92807251: Hold'em No Limit ($0.1/$0.25) - 2020/04/02 23:43:17
Table 'RushAndCash47004' 6-max Seat #1 is the button
Seat 1: Hero ($25 in chips)
Seat 2: 9c1f26b8 ($25 in chips)
Seat 3: 1dfa358e ($36.9 in chips)
Seat 4: 2117df3e ($18.42 in chips)
Seat 5: 40123cec ($13.11 in chips)
Seat 6: ab641f7 ($62.69 in chips)
9c1f26b8: posts small blind $0.1
1dfa358e: posts big blind $0.25
*** HOLE CARDS ***
Dealt to Hero [7s 6h]
Dealt to 9c1f26b8 
Dealt to 1dfa358e 
Dealt to 2117df3e 
Dealt to 40123cec 
Dealt to ab641f7 
2117df3e: folds
40123cec: raises $0.5 to $0.75
ab641f7: folds
Hero: folds
9c1f26b8: folds
1dfa358e: folds
Uncalled bet ($0.5) returned to 40123cec
*** SHOWDOWN ***
40123cec collected $0.6 from pot
*** SUMMARY ***
Total pot $0.6
Seat 1: Hero (button) folded before Flop (didn't bet)
Seat 2: 9c1f26b8 (small blind) folded before Flop
Seat 3: 1dfa358e (big blind) folded before Flop
Seat 4: 2117df3e folded before Flop (didn't bet)
Seat 5: 40123cec collected ($0.6)
Seat 6: ab641f7 folded before Flop (didn't bet)


Poker Hand #RC92807270: Hold'em No Limit ($0.1/$0.25) - 2020/04/02 23:43:21
Table 'RushAndCash47008' 6-max Seat #1 is the button
Seat 1: Hero ($25 in chips)
Seat 2: 7adcb578 ($58.06 in chips)
Seat 3: fd2fdc90 ($25.73 in chips)
Seat 4: 945e195e ($13.19 in chips)
Seat 5: a6687bdc ($25 in chips)
Seat 6: beb120aa ($23.19 in chips)
7adcb578: posts small blind $0.1
fd2fdc90: posts big blind $0.25
*** HOLE CARDS ***
Dealt to Hero [As Kh]
Dealt to 7adcb578 
Dealt to fd2fdc90 
Dealt to 945e195e 
Dealt to a6687bdc 
Dealt to beb120aa 
945e195e: folds
a6687bdc: raises $0.5 to $0.75
beb120aa: folds
Hero: raises $1.75 to $2.5
7adcb578: folds
fd2fdc90: folds
a6687bdc: folds
Uncalled bet ($1.75) returned to Hero
*** SHOWDOWN ***
Hero collected $1.85 from pot
*** SUMMARY ***
Total pot $1.85
Seat 1: Hero (button) collected ($1.85)
Seat 2: 7adcb578 (small blind) folded before Flop
Seat 3: fd2fdc90 (big blind) folded before Flop
Seat 4: 945e195e folded before Flop (didn't bet)
Seat 5: a6687bdc folded before Flop
Seat 6: beb120aa folded before Flop (didn't bet)


Poker Hand #RC92807427: Hold'em No Limit ($0.1/$0.25) - 2020/04/02 23:43:50
Table 'RushAndCash47033' 6-max Seat #1 is the button
Seat 1: 5167702 ($43.53 in chips)
Seat 2: a36379d9 ($33.13 in chips)
Seat 3: 4e104cf ($17.36 in chips)
Seat 4: ab641f7 ($62.34 in chips)
Seat 5: f43af171 ($28.1 in chips)
Seat 6: Hero ($26.01 in chips)
a36379d9: posts small blind $0.1
4e104cf: posts big blind $0.25
*** HOLE CARDS ***
Dealt to 5167702 
Dealt to a36379d9 
Dealt to 4e104cf 
Dealt to ab641f7 
Dealt to f43af171 
Dealt to Hero [Qc 6d]
ab641f7: folds
f43af171: folds
Hero: folds
5167702: raises $0.5 to $0.75
a36379d9: folds
4e104cf: folds
Uncalled bet ($0.5) returned to 5167702
*** SHOWDOWN ***
5167702 collected $0.6 from pot
*** SUMMARY ***
Total pot $0.6
Seat 1: 5167702 (button) collected ($0.6)
Seat 2: a36379d9 (small blind) folded before Flop
Seat 3: 4e104cf (big blind) folded before Flop
Seat 4: ab641f7 folded before Flop (didn't bet)
Seat 5: f43af171 folded before Flop (didn't bet)
Seat 6: Hero folded before Flop (didn't bet)


Poker Hand #RC92807469: Hold'em No Limit ($0.1/$0.25) - 2020/04/02 23:43:57
Table 'RushAndCash47038' 6-max Seat #1 is the button
Seat 1: 163fde06 ($44.27 in chips)
Seat 2: 7eb96805 ($13.18 in chips)
Seat 3: Hero ($26.01 in chips)
Seat 4: e4b820db ($42.53 in chips)
Seat 5: 5136ebb4 ($42.12 in chips)
Seat 6: abf9b61c ($26.29 in chips)
7eb96805: posts small blind $0.1
Hero: posts big blind $0.25
*** HOLE CARDS ***
Dealt to 163fde06 
Dealt to 7eb96805 
Dealt to Hero [9d 4s]
Dealt to e4b820db 
Dealt to 5136ebb4 
Dealt to abf9b61c 
e4b820db: folds
5136ebb4: raises $0.5 to $0.75
abf9b61c: folds
163fde06: raises $1.7 to $2.45
7eb96805: folds
Hero: folds
5136ebb4: calls $1.7
*** FLOP *** [4c 6d Jd]
5136ebb4: checks
163fde06: bets $2.7
5136ebb4: calls $2.7
*** TURN *** [4c 6d Jd] [Kc]
5136ebb4: checks
163fde06: checks
*** RIVER *** [4c 6d Jd Kc] [Qc]
5136ebb4: checks
163fde06: checks
5136ebb4: shows [Ac Kd] (Pair of Kings)
163fde06: shows [Ts Tc] (Pair of Tens)
*** SHOWDOWN ***
5136ebb4 collected $10.65 from pot
*** SUMMARY ***
Total pot $10.65
Board [4c 6d Jd Kc Qc]
Seat 1: 163fde06 (button) showed [Ts Tc] and lost with Pair of Tens
Seat 2: 7eb96805 (small blind) folded before Flop
Seat 3: Hero (big blind) folded before Flop
Seat 4: e4b820db folded before Flop (didn't bet)
Seat 5: 5136ebb4 showed [Ac Kd] and won ($10.65) with Pair of Kings
Seat 6: abf9b61c folded before Flop (didn't bet)


Poker Hand #RC92807521: Hold'em No Limit ($0.1/$0.25) - 2020/04/02 23:44:06
Table 'RushAndCash47046' 6-max Seat #1 is the button
Seat 1: 97dacd30 ($12.87 in chips)
Seat 2: 429a1329 ($41.23 in chips)
Seat 3: Hero ($25.76 in chips)
Seat 4: 7d3dbc6b ($25.25 in chips)
Seat 5: 7adcb578 ($58.63 in chips)
Seat 6: e35929c8 ($11.65 in chips)
429a1329: posts small blind $0.1
Hero: posts big blind $0.25
*** HOLE CARDS ***
Dealt to 97dacd30 
Dealt to 429a1329 
Dealt to Hero [Kd 7c]
Dealt to 7d3dbc6b 
Dealt to 7adcb578 
Dealt to e35929c8 
7d3dbc6b: folds
7adcb578: folds
e35929c8: raises $0.38 to $0.63
97dacd30: folds
429a1329: calls $0.53
Hero: folds
*** FLOP *** [2h Qd Jh]
429a1329: checks
e35929c8: bets $0.5
429a1329: folds
Uncalled bet ($0.5) returned to e35929c8
*** SHOWDOWN ***
e35929c8 collected $1.51 from pot
*** SUMMARY ***
Total pot $1.51
Board [2h Qd Jh]
Seat 1: 97dacd30 (button) folded before Flop (didn't bet)
Seat 2: 429a1329 (small blind) folded on the Flop
Seat 3: Hero (big blind) folded before Flop
Seat 4: 7d3dbc6b folded before Flop (didn't bet)
Seat 5: 7adcb578 folded before Flop (didn't bet)
Seat 6: e35929c8 won ($1.51)


Poker Hand #RC92807559: Hold'em No Limit ($0.1/$0.25) - 2020/04/02 23:44:14
Table 'RushAndCash47052' 6-max Seat #1 is the button
Seat 1: 5610efa8 ($6.29 in chips)
Seat 2: Hero ($25.51 in chips)
Seat 3: 2eabd980 ($15.02 in chips)
Seat 4: cbf0ae65 ($16.26 in chips)
Seat 5: 49a470c7 ($16.43 in chips)
Seat 6: 64268d2a ($27.49 in chips)
Hero: posts small blind $0.1
2eabd980: posts big blind $0.25
*** HOLE CARDS ***
Dealt to 5610efa8 
Dealt to Hero [5d 2s]
Dealt to 2eabd980 
Dealt to cbf0ae65 
Dealt to 49a470c7 
Dealt to 64268d2a 
cbf0ae65: folds
49a470c7: folds
64268d2a: raises $0.35 to $0.6
5610efa8: folds
Hero: folds
2eabd980: raises $1.3 to $1.9
64268d2a: folds
Uncalled bet ($1.3) returned to 2eabd980
*** SHOWDOWN ***
2eabd980 collected $1.3 from pot
*** SUMMARY ***
Total pot $1.3
Seat 1: 5610efa8 (button) folded before Flop (didn't bet)
Seat 2: Hero (small blind) folded before Flop
Seat 3: 2eabd980 (big blind) collected ($1.3)
Seat 4: cbf0ae65 folded before Flop (didn't bet)
Seat 5: 49a470c7 folded before Flop (didn't bet)
Seat 6: 64268d2a folded before Flop


Poker Hand #RC92807579: Hold'em No Limit ($0.1/$0.25) - 2020/04/02 23:44:17
Table 'RushAndCash47054' 6-max Seat #1 is the button
Seat 1: ab641f7 ($61.99 in chips)
Seat 2: 49a470c7 ($16.43 in chips)
Seat 3: 73e63459 ($7.34 in chips)
Seat 4: e3fa4802 ($28.5 in chips)
Seat 5: Hero ($25.41 in chips)
Seat 6: a1320bd6 ($99.19 in chips)
49a470c7: posts small blind $0.1
73e63459: posts big blind $0.25
*** HOLE CARDS ***
Dealt to ab641f7 
Dealt to 49a470c7 
Dealt to 73e63459 
Dealt to e3fa4802 
Dealt to Hero [As Js]
Dealt to a1320bd6 
e3fa4802: raises $0.5 to $0.75
Hero: calls $0.75
a1320bd6: folds
ab641f7: calls $0.75
49a470c7: folds
73e63459: folds
*** FLOP *** [2h 4s 7h]
e3fa4802: checks
Hero: bets $0.72
ab641f7: raises $3.48 to $4.2
e3fa4802: folds
Hero: folds
Uncalled bet ($3.48) returned to ab641f7
*** SHOWDOWN ***
ab641f7 collected $4.04 from pot
*** SUMMARY ***
Total pot $4.04
Board [2h 4s 7h]
Seat 1: ab641f7 (button) won ($4.04)
Seat 2: 49a470c7 (small blind) folded before Flop
Seat 3: 73e63459 (big blind) folded before Flop
Seat 4: e3fa4802 folded on the Flop
Seat 5: Hero folded on the Flop
Seat 6: a1320bd6 folded before Flop (didn't bet)


Poker Hand #RC92807828: Hold'em No Limit ($0.1/$0.25) - 2020/04/02 23:45:01
Table 'RushAndCash47084' 6-max Seat #1 is the button
Seat 1: 7adcb578 ($58.28 in chips)
Seat 2: 9333dd47 ($25 in chips)
Seat 3: e5667aa7 ($103.15 in chips)
Seat 4: 40123cec ($15.88 in chips)
Seat 5: Hero ($25 in chips)
Seat 6: 1e7ee1e0 ($14.41 in chips)
9333dd47: posts small blind $0.1
e5667aa7: posts big blind $0.25
*** HOLE CARDS ***
Dealt to 7adcb578 
Dealt to 9333dd47 
Dealt to e5667aa7 
Dealt to 40123cec 
Dealt to Hero [Ad Kh]
Dealt to 1e7ee1e0 
40123cec: folds
Hero: raises $0.38 to $0.63
1e7ee1e0: folds
7adcb578: folds
9333dd47: folds
e5667aa7: calls $0.38
*** FLOP *** [7c Ah 8d]
e5667aa7: checks
Hero: bets $0.5
e5667aa7: calls $0.5
*** TURN *** [7c Ah 8d] [7d]
e5667aa7: checks
Hero: bets $1.8
e5667aa7: raises $3.45 to $5.25
Hero: calls $3.45
*** RIVER *** [7c Ah 8d 7d] [9c]
e5667aa7: checks
Hero: checks
e5667aa7: shows [7h 9d] (Sevens Full over Nines)
Hero: shows [Kh Ad] (Pair of Aces and Pair of Sevens)
*** SHOWDOWN ***
e5667aa7 collected $12.86 from pot
*** SUMMARY ***
Total pot $12.86
Board [7c Ah 8d 7d 9c]
Seat 1: 7adcb578 (button) folded before Flop (didn't bet)
Seat 2: 9333dd47 (small blind) folded before Flop
Seat 3: e5667aa7 (big blind) showed [9d 7h] and won ($12.86) with Sevens Full over Nines
Seat 4: 40123cec folded before Flop (didn't bet)
Seat 5: Hero showed [Ad Kh] and lost with Pair of Aces and Pair of Sevens
Seat 6: 1e7ee1e0 folded before Flop (didn't bet)


Poker Hand #RC92808302: Hold'em No Limit ($0.1/$0.25) - 2020/04/02 23:46:26
Table 'RushAndCash47152' 6-max Seat #1 is the button
Seat 1: 64268d2a ($25.44 in chips)
Seat 2: 97dacd30 ($12.5 in chips)
Seat 3: a1320bd6 ($105.95 in chips)
Seat 4: b320ed6a ($55.86 in chips)
Seat 5: 6d33a0cb ($46.35 in chips)
Seat 6: Hero ($25 in chips)
97dacd30: posts small blind $0.1
a1320bd6: posts big blind $0.25
*** HOLE CARDS ***
Dealt to 64268d2a 
Dealt to 97dacd30 
Dealt to a1320bd6 
Dealt to b320ed6a 
Dealt to 6d33a0cb 
Dealt to Hero [Ts 4s]
b320ed6a: folds
6d33a0cb: folds
Hero: folds
64268d2a: raises $0.35 to $0.6
97dacd30: folds
a1320bd6: folds
Uncalled bet ($0.35) returned to 64268d2a
*** SHOWDOWN ***
64268d2a collected $0.6 from pot
*** SUMMARY ***
Total pot $0.6
Seat 1: 64268d2a (button) collected ($0.6)
Seat 2: 97dacd30 (small blind) folded before Flop
Seat 3: a1320bd6 (big blind) folded before Flop
Seat 4: b320ed6a folded before Flop (didn't bet)
Seat 5: 6d33a0cb folded before Flop (didn't bet)
Seat 6: Hero folded before Flop (didn't bet)


Poker Hand #RC92808321: Hold'em No Limit ($0.1/$0.25) - 2020/04/02 23:46:30
Table 'RushAndCash47154' 6-max Seat #1 is the button
Seat 1: a1320bd6 ($105.7 in chips)
Seat 2: a6687bdc ($26.91 in chips)
Seat 3: 40123cec ($14.93 in chips)
Seat 4: e3fa4802 ($28.95 in chips)
Seat 5: Hero ($25 in chips)
Seat 6: c27aaa40 ($75.46 in chips)
a6687bdc: posts small blind $0.1
40123cec: posts big blind $0.25
*** HOLE CARDS ***
Dealt to a1320bd6 
Dealt to a6687bdc 
Dealt to 40123cec 
Dealt to e3fa4802 
Dealt to Hero [9s 2s]
Dealt to c27aaa40 
e3fa4802: folds
Hero: folds
c27aaa40: folds
a1320bd6: folds
a6687bdc: raises $0.5 to $0.75
40123cec: calls $0.5
*** FLOP *** [Jd Kh 4h]
a6687bdc: bets $0.5
40123cec: calls $0.5
*** TURN *** [Jd Kh 4h] [Js]
a6687bdc: checks
40123cec: checks
*** RIVER *** [Jd Kh 4h Js] [6h]
a6687bdc: checks
40123cec: checks
a6687bdc: shows [6s 8h] (Pair of Jacks and Pair of Sixes)
40123cec: shows [9c 9h] (Pair of Jacks and Pair of Nines)
*** SHOWDOWN ***
40123cec collected $2.5 from pot
*** SUMMARY ***
Total pot $2.5
Board [Jd Kh 4h Js 6h]
Seat 1: a1320bd6 (button) folded before Flop (didn't bet)
Seat 2: a6687bdc (small blind) showed [8h 6s] and lost with Pair of Jacks and Pair of Sixes
Seat 3: 40123cec (big blind) showed [9h 9c] and won ($2.5) with Pair of Jacks and Pair of Nines
Seat 4: e3fa4802 folded before Flop (didn't bet)
Seat 5: Hero folded before Flop (didn't bet)
Seat 6: c27aaa40 folded before Flop (didn't bet)


Poker Hand #RC92808348: Hold'em No Limit ($0.1/$0.25) - 2020/04/02 23:46:35
Table 'RushAndCash47157' 6-max Seat #1 is the button
Seat 1: b912752f ($20.9 in chips)
Seat 2: Hero ($25 in chips)
Seat 3: c427ddfc ($61.64 in chips)
Seat 4: e3fa4802 ($28.95 in chips)
Seat 5: c27aaa40 ($75.46 in chips)
Seat 6: e4b820db ($42.18 in chips)
Hero: posts small blind $0.1
c427ddfc: posts big blind $0.25
*** HOLE CARDS ***
Dealt to b912752f 
Dealt to Hero [Ah 6d]
Dealt to c427ddfc 
Dealt to e3fa4802 
Dealt to c27aaa40 
Dealt to e4b820db 
e3fa4802: folds
c27aaa40: raises $0.38 to $0.63
e4b820db: folds
b912752f: folds
Hero: folds
c427ddfc: folds
Uncalled bet ($0.38) returned to c27aaa40
*** SHOWDOWN ***
c27aaa40 collected $0.6 from pot
*** SUMMARY ***
Total pot $0.6
Seat 1: b912752f (button) folded before Flop (didn't bet)
Seat 2: Hero (small blind) folded before Flop
Seat 3: c427ddfc (big blind) folded before Flop
Seat 4: e3fa4802 folded before Flop (didn't bet)
Seat 5: c27aaa40 collected ($0.6)
Seat 6: e4b820db folded before Flop (didn't bet)


Poker Hand #RC92808380: Hold'em No Limit ($0.1/$0.25) - 2020/04/02 23:46:43
Table 'RushAndCash47160' 6-max Seat #1 is the button
Seat 1: 7eb96805 ($12.78 in chips)
Seat 2: c204bed8 ($25 in chips)
Seat 3: Hero ($25 in chips)
Seat 4: ec75d237 ($31.58 in chips)
Seat 5: 64268d2a ($25.79 in chips)
Seat 6: e4b820db ($42.18 in chips)
c204bed8: posts small blind $0.1
Hero: posts big blind $0.25
*** HOLE CARDS ***
Dealt to 7eb96805 
Dealt to c204bed8 
Dealt to Hero [Th 2c]
Dealt to ec75d237 
Dealt to 64268d2a 
Dealt to e4b820db 
ec75d237: folds
64268d2a: folds
e4b820db: folds
7eb96805: folds
c204bed8: folds
Uncalled bet ($0.15) returned to Hero
*** SHOWDOWN ***
Hero collected $0.2 from pot
*** SUMMARY ***
Total pot $0.2
Seat 1: 7eb96805 (button) folded before Flop (didn't bet)
Seat 2: c204bed8 (small blind) folded before Flop
Seat 3: Hero (big blind) collected ($0.2)
Seat 4: ec75d237 folded before Flop (didn't bet)
Seat 5: 64268d2a folded before Flop (didn't bet)
Seat 6: e4b820db folded before Flop (didn't bet)


Poker Hand #RC92808402: Hold'em No Limit ($0.1/$0.25) - 2020/04/02 23:46:47
Table 'RushAndCash47163' 6-max Seat #1 is the button
Seat 1: Hero ($25 in chips)
Seat 2: 25bc93df ($12.5 in chips)
Seat 3: 97dacd30 ($12.4 in chips)
Seat 4: 5b73fbfa ($44 in chips)
Seat 5: 64268d2a ($25.79 in chips)
Seat 6: 5136ebb4 ($48.16 in chips)
25bc93df: posts small blind $0.1
97dacd30: posts big blind $0.25
*** HOLE CARDS ***
Dealt to Hero [7d 5c]
Dealt to 25bc93df 
Dealt to 97dacd30 
Dealt to 5b73fbfa 
Dealt to 64268d2a 
Dealt to 5136ebb4 
5b73fbfa: raises $0.38 to $0.63
64268d2a: folds
5136ebb4: folds
Hero: folds
25bc93df: calls $0.53
97dacd30: calls $0.38
*** FLOP *** [3s 6c 5d]
25bc93df: checks
97dacd30: checks
5b73fbfa: checks
*** TURN *** [3s 6c 5d] [4h]
25bc93df: checks
97dacd30: checks
5b73fbfa: bets $1
25bc93df: folds
97dacd30: folds
Uncalled bet ($1) returned to 5b73fbfa
*** SHOWDOWN ***
5b73fbfa collected $1.89 from pot
*** SUMMARY ***
Total pot $1.89
Board [3s 6c 5d 4h]
Seat 1: Hero (button) folded before Flop (didn't bet)
Seat 2: 25bc93df (small blind) folded on the Turn
Seat 3: 97dacd30 (big blind) folded on the Turn
Seat 4: 5b73fbfa won ($1.89)
Seat 5: 64268d2a folded before Flop (didn't bet)
Seat 6: 5136ebb4 folded before Flop (didn't bet)


Poker Hand #RC92808416: Hold'em No Limit ($0.1/$0.25) - 2020/04/02 23:46:50
Table 'RushAndCash47166' 6-max Seat #1 is the button
Seat 1: b912752f ($20.9 in chips)
Seat 2: 7db17161 ($42.77 in chips)
Seat 3: 7d3dbc6b ($26.36 in chips)
Seat 4: ad3d6d15 ($27.41 in chips)
Seat 5: Hero ($25 in chips)
Seat 6: 2117df3e ($18.35 in chips)
7db17161: posts small blind $0.1
7d3dbc6b: posts big blind $0.25
*** HOLE CARDS ***
Dealt to b912752f 
Dealt to 7db17161 
Dealt to 7d3dbc6b 
Dealt to ad3d6d15 
Dealt to Hero [Kh 2s]
Dealt to 2117df3e 
ad3d6d15: folds
Hero: folds
2117df3e: folds
b912752f: folds
7db17161: folds
Uncalled bet ($0.15) returned to 7d3dbc6b
*** SHOWDOWN ***
7d3dbc6b collected $0.2 from pot
*** SUMMARY ***
Total pot $0.2
Seat 1: b912752f (button) folded before Flop (didn't bet)
Seat 2: 7db17161 (small blind) folded before Flop
Seat 3: 7d3dbc6b (big blind) collected ($0.2)
Seat 4: ad3d6d15 folded before Flop (didn't bet)
Seat 5: Hero folded before Flop (didn't bet)
Seat 6: 2117df3e folded before Flop (didn't bet)


Poker Hand #RC92808436: Hold'em No Limit ($0.1/$0.25) - 2020/04/02 23:46:53
Table 'RushAndCash47169' 6-max Seat #1 is the button
Seat 1: fd2fdc90 ($25 in chips)
Seat 2: 52bba349 ($25 in chips)
Seat 3: a3a8cfd ($32.88 in chips)
Seat 4: ec75d237 ($31.58 in chips)
Seat 5: e4b820db ($42.18 in chips)
Seat 6: Hero ($25 in chips)
52bba349: posts small blind $0.1
a3a8cfd: posts big blind $0.25
*** HOLE CARDS ***
Dealt to fd2fdc90 
Dealt to 52bba349 
Dealt to a3a8cfd 
Dealt to ec75d237 
Dealt to e4b820db 
Dealt to Hero [As 5d]
ec75d237: folds
e4b820db: folds
Hero: folds
fd2fdc90: raises $0.35 to $0.6
52bba349: raises $1.1 to $1.7
a3a8cfd: folds
fd2fdc90: calls $1.1
*** FLOP *** [Qh 6d 3d]
52bba349: bets $1.3
fd2fdc90: raises $3.2 to $4.5
52bba349: folds
Uncalled bet ($3.2) returned to fd2fdc90
*** SHOWDOWN ***
fd2fdc90 collected $6.25 from pot
*** SUMMARY ***
Total pot $6.25
Board [Qh 6d 3d]
Seat 1: fd2fdc90 (button) won ($6.25)
Seat 2: 52bba349 (small blind) folded on the Flop
Seat 3: a3a8cfd (big blind) folded before Flop
Seat 4: ec75d237 folded before Flop (didn't bet)
Seat 5: e4b820db folded before Flop (didn't bet)
Seat 6: Hero folded before Flop (didn't bet)


Poker Hand #RC92808456: Hold'em No Limit ($0.1/$0.25) - 2020/04/02 23:46:56
Table 'RushAndCash47172' 6-max Seat #1 is the button
Seat 1: 7eb96805 ($12.78 in chips)
Seat 2: 6afd0518 ($27.3 in chips)
Seat 3: e4b820db ($42.18 in chips)
Seat 4: c427ddfc ($61.39 in chips)
Seat 5: Hero ($25.35 in chips)
Seat 6: e5667aa7 ($110.09 in chips)
6afd0518: posts small blind $0.1
e4b820db: posts big blind $0.25
*** HOLE CARDS ***
Dealt to 7eb96805 
Dealt to 6afd0518 
Dealt to e4b820db 
Dealt to c427ddfc 
Dealt to Hero [Qs 9c]
Dealt to e5667aa7 
c427ddfc: folds
Hero: folds
e5667aa7: folds
7eb96805: folds
6afd0518: folds
Uncalled bet ($0.15) returned to e4b820db
*** SHOWDOWN ***
e4b820db collected $0.2 from pot
*** SUMMARY ***
Total pot $0.2
Seat 1: 7eb96805 (button) folded before Flop (didn't bet)
Seat 2: 6afd0518 (small blind) folded before Flop
Seat 3: e4b820db (big blind) collected ($0.2)
Seat 4: c427ddfc folded before Flop (didn't bet)
Seat 5: Hero folded before Flop (didn't bet)
Seat 6: e5667aa7 folded before Flop (didn't bet)


Poker Hand #RC92808487: Hold'em No Limit ($0.1/$0.25) - 2020/04/02 23:47:03
Table 'RushAndCash47177' 6-max Seat #1 is the button
Seat 1: Hero ($25.35 in chips)
Seat 2: 5136ebb4 ($48.26 in chips)
Seat 3: bb9a5aea ($12.12 in chips)
Seat 4: ec75d237 ($31.33 in chips)
Seat 5: b912752f ($20.9 in chips)
Seat 6: e5667aa7 ($110.09 in chips)
5136ebb4: posts small blind $0.1
bb9a5aea: posts big blind $0.25
*** HOLE CARDS ***
Dealt to Hero [Ks 2d]
Dealt to 5136ebb4 
Dealt to bb9a5aea 
Dealt to ec75d237 
Dealt to b912752f 
Dealt to e5667aa7 
ec75d237: folds
b912752f: raises $0.5 to $0.75
e5667aa7: raises $1.5 to $2.25
Hero: folds
5136ebb4: folds
bb9a5aea: folds
b912752f: calls $1.5
*** FLOP *** [5c 6h 4c]
b912752f: checks
e5667aa7: checks
*** TURN *** [5c 6h 4c] [3s]
b912752f: bets $2.5
e5667aa7: calls $2.5
*** RIVER *** [5c 6h 4c 3s] [8d]
b912752f: bets $5
e5667aa7: calls $5
b912752f: shows [Jc 8s] (Pair of Eights)
e5667aa7: shows [4d Ac] (Pair of Fours)
*** SHOWDOWN ***
b912752f collected $19.85 from pot
*** SUMMARY ***
Total pot $19.85
Board [5c 6h 4c 3s 8d]
Seat 1: Hero (button) folded before Flop (didn't bet)
Seat 2: 5136ebb4 (small blind) folded before Flop
Seat 3: bb9a5aea (big blind) folded before Flop
Seat 4: ec75d237 folded before Flop (didn't bet)
Seat 5: b912752f showed [Jc 8s] and won ($19.85) with Pair of Eights
Seat 6: e5667aa7 showed [Ac 4d] and lost with Pair of Fours


Poker Hand #RC92808506: Hold'em No Limit ($0.1/$0.25) - 2020/04/02 23:47:06
Table 'RushAndCash47179' 6-max Seat #1 is the button
Seat 1: 6afd0518 ($27.2 in chips)
Seat 2: 64268d2a ($25.54 in chips)
Seat 3: e35929c8 ($15.95 in chips)
Seat 4: 44db54de ($29.03 in chips)
Seat 5: e4b820db ($41.93 in chips)
Seat 6: Hero ($25.35 in chips)
64268d2a: posts small blind $0.1
e35929c8: posts big blind $0.25
*** HOLE CARDS ***
Dealt to 6afd0518 
Dealt to 64268d2a 
Dealt to e35929c8 
Dealt to 44db54de 
Dealt to e4b820db 
Dealt to Hero [Td 8d]
44db54de: folds
e4b820db: folds
Hero: raises $0.38 to $0.63
6afd0518: folds
64268d2a: folds
e35929c8: folds
Uncalled bet ($0.38) returned to Hero
*** SHOWDOWN ***
Hero collected $0.6 from pot
*** SUMMARY ***
Total pot $0.6
Seat 1: 6afd0518 (button) folded before Flop (didn't bet)
Seat 2: 64268d2a (small blind) folded before Flop
Seat 3: e35929c8 (big blind) folded before Flop
Seat 4: 44db54de folded before Flop (didn't bet)
Seat 5: e4b820db folded before Flop (didn't bet)
Seat 6: Hero collected ($0.6)


Poker Hand #RC92808568: Hold'em No Limit ($0.1/$0.25) - 2020/04/02 23:47:18
Table 'RushAndCash47188' 6-max Seat #1 is the button
Seat 1: ec75d237 ($31.23 in chips)
Seat 2: Hero ($25.7 in chips)
Seat 3: 178af15d ($12.5 in chips)
Seat 4: 2eabd980 ($9.53 in chips)
Seat 5: 833dc1e7 ($81.49 in chips)
Seat 6: 163fde06 ($35.62 in chips)
Hero: posts small blind $0.1
178af15d: posts big blind $0.25
*** HOLE CARDS ***
Dealt to ec75d237 
Dealt to Hero [7s 4s]
Dealt to 178af15d 
Dealt to 2eabd980 
Dealt to 833dc1e7 
Dealt to 163fde06 
2eabd980: folds
833dc1e7: folds
163fde06: folds
ec75d237: raises $0.38 to $0.63
Hero: folds
178af15d: calls $0.38
*** FLOP *** [Qh 3c 4c]
178af15d: checks
ec75d237: bets $0.5
178af15d: folds
Uncalled bet ($0.5) returned to ec75d237
*** SHOWDOWN ***
ec75d237 collected $1.36 from pot
*** SUMMARY ***
Total pot $1.36
Board [Qh 3c 4c]
Seat 1: ec75d237 (button) won ($1.36)
Seat 2: Hero (small blind) folded before Flop
Seat 3: 178af15d (big blind) folded on the Flop
Seat 4: 2eabd980 folded before Flop (didn't bet)
Seat 5: 833dc1e7 folded before Flop (didn't bet)
Seat 6: 163fde06 folded before Flop (didn't bet)


Poker Hand #RC92808588: Hold'em No Limit ($0.1/$0.25) - 2020/04/02 23:47:21
Table 'RushAndCash47190' 6-max Seat #1 is the button
Seat 1: c27aaa40 ($75.71 in chips)
Seat 2: 7eb96805 ($12.88 in chips)
Seat 3: Hero ($25.6 in chips)
Seat 4: a3a8cfd ($32.98 in chips)
Seat 5: f032dc5a ($13.4 in chips)
Seat 6: 6d33a0cb ($48.06 in chips)
7eb96805: posts small blind $0.1
Hero: posts big blind $0.25
*** HOLE CARDS ***
Dealt to c27aaa40 
Dealt to 7eb96805 
Dealt to Hero [9d 7d]
Dealt to a3a8cfd 
Dealt to f032dc5a 
Dealt to 6d33a0cb 
a3a8cfd: raises $0.38 to $0.63
f032dc5a: folds
6d33a0cb: calls $0.63
c27aaa40: folds
7eb96805: folds
Hero: calls $0.38
*** FLOP *** [7c Ts 6c]
Hero: checks
a3a8cfd: bets $1.4
6d33a0cb: folds
Hero: calls $1.4
*** TURN *** [7c Ts 6c] [9h]
Hero: checks
a3a8cfd: bets $3.2
Hero: raises $6.47 to $9.67
a3a8cfd: folds
Uncalled bet ($6.47) returned to Hero
*** SHOWDOWN ***
Hero collected $11.19 from pot
*** SUMMARY ***
Total pot $11.19
Board [7c Ts 6c 9h]
Seat 1: c27aaa40 (button) folded before Flop (didn't bet)
Seat 2: 7eb96805 (small blind) folded before Flop
Seat 3: Hero (big blind) won ($11.19)
Seat 4: a3a8cfd folded on the Turn
Seat 5: f032dc5a folded before Flop (didn't bet)
Seat 6: 6d33a0cb folded on the Flop


Poker Hand #RC92809034: Hold'em No Limit ($0.1/$0.25) - 2020/04/02 23:48:44
Table 'RushAndCash47254' 6-max Seat #1 is the button
Seat 1: 97dacd30 ($11.42 in chips)
Seat 2: 5b73fbfa ($45.97 in chips)
Seat 3: 25bc93df ($13.27 in chips)
Seat 4: 9333dd47 ($29.29 in chips)
Seat 5: Hero ($30.75 in chips)
Seat 6: 2eabd980 ($3.43 in chips)
5b73fbfa: posts small blind $0.1
25bc93df: posts big blind $0.25
*** HOLE CARDS ***
Dealt to 97dacd30 
Dealt to 5b73fbfa 
Dealt to 25bc93df 
Dealt to 9333dd47 
Dealt to Hero [Jh Ts]
Dealt to 2eabd980 
9333dd47: raises $0.38 to $0.63
Hero: folds
2eabd980: folds
97dacd30: raises $1.67 to $2.3
5b73fbfa: folds
25bc93df: folds
9333dd47: folds
Uncalled bet ($1.67) returned to 97dacd30
*** SHOWDOWN ***
97dacd30 collected $1.61 from pot
*** SUMMARY ***
Total pot $1.61
Seat 1: 97dacd30 (button) collected ($1.61)
Seat 2: 5b73fbfa (small blind) folded before Flop
Seat 3: 25bc93df (big blind) folded before Flop
Seat 4: 9333dd47 folded before Flop
Seat 5: Hero folded before Flop (didn't bet)
Seat 6: 2eabd980 folded before Flop (didn't bet)


Poker Hand #RC92809082: Hold'em No Limit ($0.1/$0.25) - 2020/04/02 23:48:53
Table 'RushAndCash47262' 6-max Seat #1 is the button
Seat 1: 44db54de ($25 in chips)
Seat 2: 5610efa8 ($21.82 in chips)
Seat 3: 2eabd980 ($3.43 in chips)
Seat 4: e3fa4802 ($31.71 in chips)
Seat 5: Hero ($30.75 in chips)
Seat 6: 163fde06 ($38.74 in chips)
5610efa8: posts small blind $0.1
2eabd980: posts big blind $0.25
*** HOLE CARDS ***
Dealt to 44db54de 
Dealt to 5610efa8 
Dealt to 2eabd980 
Dealt to e3fa4802 
Dealt to Hero [Kh 6s]
Dealt to 163fde06 
e3fa4802: raises $0.5 to $0.75
Hero: folds
163fde06: folds
44db54de: folds
5610efa8: calls $0.65
2eabd980: folds
*** FLOP *** [3c 9d 9s]
5610efa8: checks
e3fa4802: checks
*** TURN *** [3c 9d 9s] [4h]
5610efa8: checks
e3fa4802: checks
*** RIVER *** [3c 9d 9s 4h] [Jd]
5610efa8: bets $0.75
e3fa4802: folds
Uncalled bet ($0.75) returned to 5610efa8
*** SHOWDOWN ***
5610efa8 collected $1.75 from pot
*** SUMMARY ***
Total pot $1.75
Board [3c 9d 9s 4h Jd]
Seat 1: 44db54de (button) folded before Flop (didn't bet)
Seat 2: 5610efa8 (small blind) won ($1.75)
Seat 3: 2eabd980 (big blind) folded before Flop
Seat 4: e3fa4802 folded on the River
Seat 5: Hero folded before Flop (didn't bet)
Seat 6: 163fde06 folded before Flop (didn't bet)


Poker Hand #RC92809172: Hold'em No Limit ($0.1/$0.25) - 2020/04/02 23:49:10
Table 'RushAndCash47276' 6-max Seat #1 is the button
Seat 1: c27aaa40 ($75.51 in chips)
Seat 2: Hero ($30.75 in chips)
Seat 3: 9333dd47 ($28.66 in chips)
Seat 4: 64268d2a ($28.03 in chips)
Seat 5: 2117df3e ($18.55 in chips)
Seat 6: 2eabd980 ($3.18 in chips)
Hero: posts small blind $0.1
9333dd47: posts big blind $0.25
*** HOLE CARDS ***
Dealt to c27aaa40 
Dealt to Hero [As Ah]
Dealt to 9333dd47 
Dealt to 64268d2a 
Dealt to 2117df3e 
Dealt to 2eabd980 
64268d2a: folds
2117df3e: raises $0.38 to $0.63
2eabd980: folds
c27aaa40: folds
Hero: raises $2.12 to $2.75
9333dd47: folds
2117df3e: calls $2.12
*** FLOP *** [4s 6s 3d]
Hero: bets $2.3
2117df3e: folds
Uncalled bet ($2.3) returned to Hero
*** SHOWDOWN ***
Hero collected $5.75 from pot
*** SUMMARY ***
Total pot $5.75
Board [4s 6s 3d]
Seat 1: c27aaa40 (button) folded before Flop (didn't bet)
Seat 2: Hero (small blind) won ($5.75)
Seat 3: 9333dd47 (big blind) folded before Flop
Seat 4: 64268d2a folded before Flop (didn't bet)
Seat 5: 2117df3e folded on the Flop
Seat 6: 2eabd980 folded before Flop (didn't bet)


Poker Hand #RC92809453: Hold'em No Limit ($0.1/$0.25) - 2020/04/02 23:50:01
Table 'RushAndCash47313' 6-max Seat #1 is the button
Seat 1: Hero ($33.47 in chips)
Seat 2: 9c1f26b8 ($37.41 in chips)
Seat 3: 44db54de ($25 in chips)
Seat 4: 73e63459 ($30.48 in chips)
Seat 5: c27aaa40 ($75.16 in chips)
Seat 6: 97dacd30 ($12.32 in chips)
9c1f26b8: posts small blind $0.1
44db54de: posts big blind $0.25
*** HOLE CARDS ***
Dealt to Hero [6s 2h]
Dealt to 9c1f26b8 
Dealt to 44db54de 
Dealt to 73e63459 
Dealt to c27aaa40 
Dealt to 97dacd30 
73e63459: raises $0.38 to $0.63
c27aaa40: folds
97dacd30: folds
Hero: folds
9c1f26b8: folds
44db54de: folds
Uncalled bet ($0.38) returned to 73e63459
*** SHOWDOWN ***
73e63459 collected $0.6 from pot
*** SUMMARY ***
Total pot $0.6
Seat 1: Hero (button) folded before Flop (didn't bet)
Seat 2: 9c1f26b8 (small blind) folded before Flop
Seat 3: 44db54de (big blind) folded before Flop
Seat 4: 73e63459 collected ($0.6)
Seat 5: c27aaa40 folded before Flop (didn't bet)
Seat 6: 97dacd30 folded before Flop (didn't bet)


Poker Hand #RC92809492: Hold'em No Limit ($0.1/$0.25) - 2020/04/02 23:50:08
Table 'RushAndCash47319' 6-max Seat #1 is the button
Seat 1: e4b820db ($34.78 in chips)
Seat 2: 40123cec ($15.41 in chips)
Seat 3: Hero ($33.47 in chips)
Seat 4: 64268d2a ($28.03 in chips)
Seat 5: 2611a367 ($15.17 in chips)
Seat 6: 5b73fbfa ($45.62 in chips)
40123cec: posts small blind $0.1
Hero: posts big blind $0.25
*** HOLE CARDS ***
Dealt to e4b820db 
Dealt to 40123cec 
Dealt to Hero [Jh Jd]
Dealt to 64268d2a 
Dealt to 2611a367 
Dealt to 5b73fbfa 
64268d2a: folds
2611a367: folds
5b73fbfa: raises $0.38 to $0.63
e4b820db: folds
40123cec: folds
Hero: raises $2.12 to $2.75
5b73fbfa: calls $2.12
*** FLOP *** [8s 3h Qd]
Hero: bets $2.05
5b73fbfa: calls $2.05
*** TURN *** [8s 3h Qd] [Ts]
Hero: bets $5.6
5b73fbfa: raises $6.65 to $12.25
Hero: calls $6.65
*** RIVER *** [8s 3h Qd Ts] [4s]
Hero: checks
5b73fbfa: bets $25.7
Hero: folds
Uncalled bet ($25.7) returned to 5b73fbfa
*** SHOWDOWN ***
5b73fbfa collected $34.2 from pot
*** SUMMARY ***
Total pot $34.2
Board [8s 3h Qd Ts 4s]
Seat 1: e4b820db (button) folded before Flop (didn't bet)
Seat 2: 40123cec (small blind) folded before Flop
Seat 3: Hero (big blind) folded on the River
Seat 4: 64268d2a folded before Flop (didn't bet)
Seat 5: 2611a367 folded before Flop (didn't bet)
Seat 6: 5b73fbfa won ($34.2)


Poker Hand #RC92810095: Hold'em No Limit ($0.1/$0.25) - 2020/04/02 23:51:54
Table 'RushAndCash47402' 6-max Seat #1 is the button
Seat 1: c204bed8 ($28.1 in chips)
Seat 2: b320ed6a ($55.01 in chips)
Seat 3: 6d33a0cb ($67.86 in chips)
Seat 4: 33dc6448 ($28.34 in chips)
Seat 5: a44aa940 ($18.01 in chips)
Seat 6: Hero ($25 in chips)
b320ed6a: posts small blind $0.1
6d33a0cb: posts big blind $0.25
*** HOLE CARDS ***
Dealt to c204bed8 
Dealt to b320ed6a 
Dealt to 6d33a0cb 
Dealt to 33dc6448 
Dealt to a44aa940 
Dealt to Hero [As Qc]
33dc6448: folds
a44aa940: calls $0.25
Hero: raises $0.75 to $1
c204bed8: folds
b320ed6a: folds
6d33a0cb: folds
a44aa940: calls $0.75
*** FLOP *** [3h 5c 5h]
a44aa940: checks
Hero: checks
*** TURN *** [3h 5c 5h] [4c]
a44aa940: bets $1.2
Hero: calls $1.2
*** RIVER *** [3h 5c 5h 4c] [Jh]
a44aa940: checks
Hero: checks
a44aa940: shows [6d 9d] (Pair of Fives)
Hero: shows [As Qc] (Pair of Fives)
*** SHOWDOWN ***
Hero collected $4.75 from pot
*** SUMMARY ***
Total pot $4.75
Board [3h 5c 5h 4c Jh]
Seat 1: c204bed8 (button) folded before Flop (didn't bet)
Seat 2: b320ed6a (small blind) folded before Flop
Seat 3: 6d33a0cb (big blind) folded before Flop
Seat 4: 33dc6448 folded before Flop (didn't bet)
Seat 5: a44aa940 showed [9d 6d] and lost with Pair of Fives
Seat 6: Hero showed [As Qc] and won ($4.75) with Pair of Fives


Poker Hand #RC92810390: Hold'em No Limit ($0.1/$0.25) - 2020/04/02 23:52:50
Table 'RushAndCash47441' 6-max Seat #1 is the button
Seat 1: 7adcb578 ($51.18 in chips)
Seat 2: 2611a367 ($15.64 in chips)
Seat 3: 2eabd980 ($12.93 in chips)
Seat 4: 5610efa8 ($22.44 in chips)
Seat 5: eb18162e ($37.9 in chips)
Seat 6: Hero ($27.32 in chips)
2611a367: posts small blind $0.1
2eabd980: posts big blind $0.25
*** HOLE CARDS ***
Dealt to 7adcb578 
Dealt to 2611a367 
Dealt to 2eabd980 
Dealt to 5610efa8 
Dealt to eb18162e 
Dealt to Hero [Td 3d]
5610efa8: raises $0.38 to $0.63
eb18162e: folds
Hero: folds
7adcb578: folds
2611a367: folds
2eabd980: folds
Uncalled bet ($0.38) returned to 5610efa8
*** SHOWDOWN ***
5610efa8 collected $0.6 from pot
*** SUMMARY ***
Total pot $0.6
Seat 1: 7adcb578 (button) folded before Flop (didn't bet)
Seat 2: 2611a367 (small blind) folded before Flop
Seat 3: 2eabd980 (big blind) folded before Flop
Seat 4: 5610efa8 collected ($0.6)
Seat 5: eb18162e folded before Flop (didn't bet)
Seat 6: Hero folded before Flop (didn't bet)


Poker Hand #RC92810415: Hold'em No Limit ($0.1/$0.25) - 2020/04/02 23:52:54
Table 'RushAndCash47445' 6-max Seat #1 is the button
Seat 1: 73e63459 ($29.22 in chips)
Seat 2: beb120aa ($24.86 in chips)
Seat 3: 57b0a14c ($32.42 in chips)
Seat 4: 2eabd980 ($12.68 in chips)
Seat 5: Hero ($27.32 in chips)
Seat 6: f43af171 ($25.17 in chips)
beb120aa: posts small blind $0.1
57b0a14c: posts big blind $0.25
*** HOLE CARDS ***
Dealt to 73e63459 
Dealt to beb120aa 
Dealt to 57b0a14c 
Dealt to 2eabd980 
Dealt to Hero [Jc 9d]
Dealt to f43af171 
2eabd980: folds
Hero: folds
f43af171: folds
73e63459: folds
beb120aa: folds
Uncalled bet ($0.15) returned to 57b0a14c
*** SHOWDOWN ***
57b0a14c collected $0.2 from pot
*** SUMMARY ***
Total pot $0.2
Seat 1: 73e63459 (button) folded before Flop (didn't bet)
Seat 2: beb120aa (small blind) folded before Flop
Seat 3: 57b0a14c (big blind) collected ($0.2)
Seat 4: 2eabd980 folded before Flop (didn't bet)
Seat 5: Hero folded before Flop (didn't bet)
Seat 6: f43af171 folded before Flop (didn't bet)


Poker Hand #RC92810437: Hold'em No Limit ($0.1/$0.25) - 2020/04/02 23:52:57
Table 'RushAndCash47448' 6-max Seat #1 is the button
Seat 1: ab641f7 ($78.43 in chips)
Seat 2: Hero ($27.32 in chips)
Seat 3: 5136ebb4 ($48.84 in chips)
Seat 4: bb9a5aea ($13.46 in chips)
Seat 5: beb120aa ($24.76 in chips)
Seat 6: 64268d2a ($28.81 in chips)
Hero: posts small blind $0.1
5136ebb4: posts big blind $0.25
*** HOLE CARDS ***
Dealt to ab641f7 
Dealt to Hero [4h 3h]
Dealt to 5136ebb4 
Dealt to bb9a5aea 
Dealt to beb120aa 
Dealt to 64268d2a 
bb9a5aea: folds
beb120aa: folds
64268d2a: folds
ab641f7: folds
Hero: folds
Uncalled bet ($0.15) returned to 5136ebb4
*** SHOWDOWN ***
5136ebb4 collected $0.2 from pot
*** SUMMARY ***
Total pot $0.2
Seat 1: ab641f7 (button) folded before Flop (didn't bet)
Seat 2: Hero (small blind) folded before Flop
Seat 3: 5136ebb4 (big blind) collected ($0.2)
Seat 4: bb9a5aea folded before Flop (didn't bet)
Seat 5: beb120aa folded before Flop (didn't bet)
Seat 6: 64268d2a folded before Flop (didn't bet)


Poker Hand #RC92810470: Hold'em No Limit ($0.1/$0.25) - 2020/04/02 23:53:04
Table 'RushAndCash47452' 6-max Seat #1 is the button
Seat 1: Hero ($27.22 in chips)
Seat 2: bb9a5aea ($13.46 in chips)
Seat 3: a957a98a ($20 in chips)
Seat 4: a44aa940 ($16.13 in chips)
Seat 5: 5610efa8 ($22.79 in chips)
Seat 6: 2eabd980 ($12.68 in chips)
bb9a5aea: posts small blind $0.1
a957a98a: posts big blind $0.25
*** HOLE CARDS ***
Dealt to Hero [Jd 4d]
Dealt to bb9a5aea 
Dealt to a957a98a 
Dealt to a44aa940 
Dealt to 5610efa8 
Dealt to 2eabd980 
a44aa940: calls $0.25
5610efa8: folds
2eabd980: folds
Hero: folds
bb9a5aea: calls $0.15
a957a98a: checks
*** FLOP *** [3s Kh Js]
bb9a5aea: checks
a957a98a: checks
a44aa940: checks
*** TURN *** [3s Kh Js] [4c]
bb9a5aea: checks
a957a98a: checks
a44aa940: bets $0.4
bb9a5aea: folds
a957a98a: folds
Uncalled bet ($0.4) returned to a44aa940
*** SHOWDOWN ***
a44aa940 collected $0.75 from pot
*** SUMMARY ***
Total pot $0.75
Board [3s Kh Js 4c]
Seat 1: Hero (button) folded before Flop (didn't bet)
Seat 2: bb9a5aea (small blind) folded on the Turn
Seat 3: a957a98a (big blind) folded on the Turn
Seat 4: a44aa940 won ($0.75)
Seat 5: 5610efa8 folded before Flop (didn't bet)
Seat 6: 2eabd980 folded before Flop (didn't bet)


Poker Hand #RC92810492: Hold'em No Limit ($0.1/$0.25) - 2020/04/02 23:53:07
Table 'RushAndCash47455' 6-max Seat #1 is the button
Seat 1: c27aaa40 ($85.73 in chips)
Seat 2: 7adcb578 ($50.93 in chips)
Seat 3: 4eef848d ($25 in chips)
Seat 4: ad3d6d15 ($27.21 in chips)
Seat 5: Hero ($27.22 in chips)
Seat 6: fd2fdc90 ($25 in chips)
7adcb578: posts small blind $0.1
4eef848d: posts big blind $0.25
*** HOLE CARDS ***
Dealt to c27aaa40 
Dealt to 7adcb578 
Dealt to 4eef848d 
Dealt to ad3d6d15 
Dealt to Hero [As 8h]
Dealt to fd2fdc90 
ad3d6d15: folds
Hero: folds
fd2fdc90: folds
c27aaa40: raises $0.38 to $0.63
7adcb578: calls $0.53
4eef848d: raises $4.37 to $5
c27aaa40: folds
7adcb578: folds
Uncalled bet ($4.37) returned to 4eef848d
*** SHOWDOWN ***
4eef848d collected $1.89 from pot
*** SUMMARY ***
Total pot $1.89
Seat 1: c27aaa40 (button) folded before Flop
Seat 2: 7adcb578 (small blind) folded before Flop
Seat 3: 4eef848d (big blind) collected ($1.89)
Seat 4: ad3d6d15 folded before Flop (didn't bet)
Seat 5: Hero folded before Flop (didn't bet)
Seat 6: fd2fdc90 folded before Flop (didn't bet)


Poker Hand #RC92810524: Hold'em No Limit ($0.1/$0.25) - 2020/04/02 23:53:13
Table 'RushAndCash47460' 6-max Seat #1 is the button
Seat 1: 2eabd980 ($12.58 in chips)
Seat 2: dc9aea4f ($27.19 in chips)
Seat 3: Hero ($27.22 in chips)
Seat 4: e5667aa7 ($102.88 in chips)
Seat 5: 25bc93df ($12.85 in chips)
Seat 6: 5136ebb4 ($48.84 in chips)
dc9aea4f: posts small blind $0.1
Hero: posts big blind $0.25
*** HOLE CARDS ***
Dealt to 2eabd980 
Dealt to dc9aea4f 
Dealt to Hero [Kd Jh]
Dealt to e5667aa7 
Dealt to 25bc93df 
Dealt to 5136ebb4 
e5667aa7: folds
25bc93df: folds
5136ebb4: folds
2eabd980: folds
dc9aea4f: raises $0.5 to $0.75
Hero: calls $0.5
*** FLOP *** [6s 6h 4s]
dc9aea4f: bets $1.05
Hero: calls $1.05
*** TURN *** [6s 6h 4s] [8s]
dc9aea4f: checks
Hero: checks
*** RIVER *** [6s 6h 4s 8s] [Qh]
dc9aea4f: checks
Hero: bets $2.7
dc9aea4f: folds
Uncalled bet ($2.7) returned to Hero
*** SHOWDOWN ***
Hero collected $3.6 from pot
*** SUMMARY ***
Total pot $3.6
Board [6s 6h 4s 8s Qh]
Seat 1: 2eabd980 (button) folded before Flop (didn't bet)
Seat 2: dc9aea4f (small blind) folded on the River
Seat 3: Hero (big blind) won ($3.6)
Seat 4: e5667aa7 folded before Flop (didn't bet)
Seat 5: 25bc93df folded before Flop (didn't bet)
Seat 6: 5136ebb4 folded before Flop (didn't bet)


Poker Hand #RC92810741: Hold'em No Limit ($0.1/$0.25) - 2020/04/02 23:53:53
Table 'RushAndCash47490' 6-max Seat #1 is the button
Seat 1: 8d45281f ($27.79 in chips)
Seat 2: f032dc5a ($16.51 in chips)
Seat 3: 2458c9bb ($13.4 in chips)
Seat 4: e5667aa7 ($103.58 in chips)
Seat 5: dc9aea4f ($25.39 in chips)
Seat 6: Hero ($28.84 in chips)
f032dc5a: posts small blind $0.1
2458c9bb: posts big blind $0.25
*** HOLE CARDS ***
Dealt to 8d45281f 
Dealt to f032dc5a 
Dealt to 2458c9bb 
Dealt to e5667aa7 
Dealt to dc9aea4f 
Dealt to Hero [Ah Js]
e5667aa7: folds
dc9aea4f: folds
Hero: raises $0.38 to $0.63
8d45281f: folds
f032dc5a: folds
2458c9bb: raises $1.37 to $2
Hero: calls $1.37
*** FLOP *** [Kc 9c 4s]
2458c9bb: bets $2.1
Hero: folds
Uncalled bet ($2.1) returned to 2458c9bb
*** SHOWDOWN ***
2458c9bb collected $4.1 from pot
*** SUMMARY ***
Total pot $4.1
Board [Kc 9c 4s]
Seat 1: 8d45281f (button) folded before Flop (didn't bet)
Seat 2: f032dc5a (small blind) folded before Flop
Seat 3: 2458c9bb (big blind) won ($4.1)
Seat 4: e5667aa7 folded before Flop (didn't bet)
Seat 5: dc9aea4f folded before Flop (didn't bet)
Seat 6: Hero folded on the Flop


Poker Hand #RC92810928: Hold'em No Limit ($0.1/$0.25) - 2020/04/02 23:54:27
Table 'RushAndCash47515' 6-max Seat #1 is the button
Seat 1: 5136ebb4 ($48.73 in chips)
Seat 2: 2458c9bb ($15.3 in chips)
Seat 3: e4b820db ($38.29 in chips)
Seat 4: 25bc93df ($12.85 in chips)
Seat 5: Hero ($26.84 in chips)
Seat 6: a44aa940 ($16.6 in chips)
2458c9bb: posts small blind $0.1
e4b820db: posts big blind $0.25
*** HOLE CARDS ***
Dealt to 5136ebb4 
Dealt to 2458c9bb 
Dealt to e4b820db 
Dealt to 25bc93df 
Dealt to Hero [Jh 9d]
Dealt to a44aa940 
25bc93df: folds
Hero: folds
a44aa940: folds
5136ebb4: folds
2458c9bb: raises $0.5 to $0.75
e4b820db: folds
Uncalled bet ($0.5) returned to 2458c9bb
*** SHOWDOWN ***
2458c9bb collected $0.5 from pot
*** SUMMARY ***
Total pot $0.5
Seat 1: 5136ebb4 (button) folded before Flop (didn't bet)
Seat 2: 2458c9bb (small blind) collected ($0.5)
Seat 3: e4b820db (big blind) folded before Flop
Seat 4: 25bc93df folded before Flop (didn't bet)
Seat 5: Hero folded before Flop (didn't bet)
Seat 6: a44aa940 folded before Flop (didn't bet)


Poker Hand #RC92810954: Hold'em No Limit ($0.1/$0.25) - 2020/04/02 23:54:32
Table 'RushAndCash47519' 6-max Seat #1 is the button
Seat 1: a6687bdc ($25.5 in chips)
Seat 2: e4b820db ($38.04 in chips)
Seat 3: Hero ($26.84 in chips)
Seat 4: a44aa940 ($16.6 in chips)
Seat 5: 40123cec ($13.76 in chips)
Seat 6: 5136ebb4 ($48.73 in chips)
e4b820db: posts small blind $0.1
Hero: posts big blind $0.25
*** HOLE CARDS ***
Dealt to a6687bdc 
Dealt to e4b820db 
Dealt to Hero [Qc Th]
Dealt to a44aa940 
Dealt to 40123cec 
Dealt to 5136ebb4 
a44aa940: folds
40123cec: folds
5136ebb4: folds
a6687bdc: folds
e4b820db: raises $0.75 to $1
Hero: calls $0.75
*** FLOP *** [Ts Td 6c]
e4b820db: checks
Hero: checks
*** TURN *** [Ts Td 6c] [8c]
e4b820db: bets $1.7
Hero: raises $4.1 to $5.8
e4b820db: calls $4.1
*** RIVER *** [Ts Td 6c 8c] [7c]
e4b820db: checks
Hero: checks
e4b820db: shows [Kd Ks] (Pair of Kings and Pair of Tens)
Hero: shows [Qc Th] (Three Tens)
*** SHOWDOWN ***
Hero collected $13.6 from pot
*** SUMMARY ***
Total pot $13.6
Board [Ts Td 6c 8c 7c]
Seat 1: a6687bdc (button) folded before Flop (didn't bet)
Seat 2: e4b820db (small blind) showed [Ks Kd] and lost with Pair of Kings and Pair of Tens
Seat 3: Hero (big blind) showed [Qc Th] and won ($13.6) with Three Tens
Seat 4: a44aa940 folded before Flop (didn't bet)
Seat 5: 40123cec folded before Flop (didn't bet)
Seat 6: 5136ebb4 folded before Flop (didn't bet)


Poker Hand #RC92811206: Hold'em No Limit ($0.1/$0.25) - 2020/04/02 23:55:19
Table 'RushAndCash47551' 6-max Seat #1 is the button
Seat 1: 30b9401d ($10.92 in chips)
Seat 2: Hero ($32.71 in chips)
Seat 3: c427ddfc ($48.77 in chips)
Seat 4: c204bed8 ($25.92 in chips)
Seat 5: e4b820db ($31.24 in chips)
Seat 6: 8d45281f ($27.44 in chips)
Hero: posts small blind $0.1
c427ddfc: posts big blind $0.25
*** HOLE CARDS ***
Dealt to 30b9401d 
Dealt to Hero [8s 8c]
Dealt to c427ddfc 
Dealt to c204bed8 
Dealt to e4b820db 
Dealt to 8d45281f 
c204bed8: folds
e4b820db: folds
8d45281f: folds
30b9401d: raises $0.5 to $0.75
Hero: calls $0.65
c427ddfc: calls $0.5
*** FLOP *** [4s Kc Td]
Hero: checks
c427ddfc: checks
30b9401d: checks
*** TURN *** [4s Kc Td] [Kh]
Hero: checks
c427ddfc: bets $1.7
30b9401d: folds
Hero: folds
Uncalled bet ($1.7) returned to c427ddfc
*** SHOWDOWN ***
c427ddfc collected $2.25 from pot
*** SUMMARY ***
Total pot $2.25
Board [4s Kc Td Kh]
Seat 1: 30b9401d (button) folded on the Turn
Seat 2: Hero (small blind) folded on the Turn
Seat 3: c427ddfc (big blind) won ($2.25)
Seat 4: c204bed8 folded before Flop (didn't bet)
Seat 5: e4b820db folded before Flop (didn't bet)
Seat 6: 8d45281f folded before Flop (didn't bet)


Poker Hand #RC92811448: Hold'em No Limit ($0.1/$0.25) - 2020/04/02 23:56:05
Table 'RushAndCash47589' 6-max Seat #1 is the button
Seat 1: Hero ($31.96 in chips)
Seat 2: 2eabd980 ($10.03 in chips)
Seat 3: 73e63459 ($45.93 in chips)
Seat 4: dc9aea4f ($28.54 in chips)
Seat 5: 2611a367 ($15.72 in chips)
Seat 6: bb9a5aea ($14.12 in chips)
2eabd980: posts small blind $0.1
73e63459: posts big blind $0.25
*** HOLE CARDS ***
Dealt to Hero [7s 2c]
Dealt to 2eabd980 
Dealt to 73e63459 
Dealt to dc9aea4f 
Dealt to 2611a367 
Dealt to bb9a5aea 
dc9aea4f: folds
2611a367: folds
bb9a5aea: raises $0.5 to $0.75
Hero: folds
2eabd980: folds
73e63459: folds
Uncalled bet ($0.5) returned to bb9a5aea
*** SHOWDOWN ***
bb9a5aea collected $0.6 from pot
*** SUMMARY ***
Total pot $0.6
Seat 1: Hero (button) folded before Flop (didn't bet)
Seat 2: 2eabd980 (small blind) folded before Flop
Seat 3: 73e63459 (big blind) folded before Flop
Seat 4: dc9aea4f folded before Flop (didn't bet)
Seat 5: 2611a367 folded before Flop (didn't bet)
Seat 6: bb9a5aea collected ($0.6)


Poker Hand #RC92811468: Hold'em No Limit ($0.1/$0.25) - 2020/04/02 23:56:09
Table 'RushAndCash47592' 6-max Seat #1 is the button
Seat 1: f19292be ($37.09 in chips)
Seat 2: 9c1f26b8 ($35.67 in chips)
Seat 3: 64268d2a ($29.87 in chips)
Seat 4: a6687bdc ($25 in chips)
Seat 5: c9779842 ($25 in chips)
Seat 6: Hero ($31.96 in chips)
9c1f26b8: posts small blind $0.1
64268d2a: posts big blind $0.25
*** HOLE CARDS ***
Dealt to f19292be 
Dealt to 9c1f26b8 
Dealt to 64268d2a 
Dealt to a6687bdc 
Dealt to c9779842 
Dealt to Hero [Ad 4c]
a6687bdc: folds
c9779842: folds
Hero: folds
f19292be: raises $0.38 to $0.63
9c1f26b8: folds
64268d2a: folds
Uncalled bet ($0.38) returned to f19292be
*** SHOWDOWN ***
f19292be collected $0.6 from pot
*** SUMMARY ***
Total pot $0.6
Seat 1: f19292be (button) collected ($0.6)
Seat 2: 9c1f26b8 (small blind) folded before Flop
Seat 3: 64268d2a (big blind) folded before Flop
Seat 4: a6687bdc folded before Flop (didn't bet)
Seat 5: c9779842 folded before Flop (didn't bet)
Seat 6: Hero folded before Flop (didn't bet)


Poker Hand #RC92811480: Hold'em No Limit ($0.1/$0.25) - 2020/04/02 23:56:12
Table 'RushAndCash47595' 6-max Seat #1 is the button
Seat 1: b289f27a ($25 in chips)
Seat 2: 44db54de ($40.9 in chips)
Seat 3: 7eb96805 ($9.7 in chips)
Seat 4: Hero ($31.96 in chips)
Seat 5: c5697ac1 ($25 in chips)
Seat 6: 1dfa358e ($36.16 in chips)
44db54de: posts small blind $0.1
7eb96805: posts big blind $0.25
*** HOLE CARDS ***
Dealt to b289f27a 
Dealt to 44db54de 
Dealt to 7eb96805 
Dealt to Hero [Kc Jh]
Dealt to c5697ac1 
Dealt to 1dfa358e 
Hero: folds
c5697ac1: folds
1dfa358e: folds
b289f27a: raises $0.38 to $0.63
44db54de: folds
7eb96805: calls $0.38
*** FLOP *** [Kd Td 8c]
7eb96805: checks
b289f27a: checks
*** TURN *** [Kd Td 8c] [6d]
7eb96805: bets $1.4
b289f27a: raises $5.1 to $6.5
7eb96805: folds
Uncalled bet ($5.1) returned to b289f27a
*** SHOWDOWN ***
b289f27a collected $4.16 from pot
*** SUMMARY ***
Total pot $4.16
Board [Kd Td 8c 6d]
Seat 1: b289f27a (button) won ($4.16)
Seat 2: 44db54de (small blind) folded before Flop
Seat 3: 7eb96805 (big blind) folded on the Turn
Seat 4: Hero folded before Flop (didn't bet)
Seat 5: c5697ac1 folded before Flop (didn't bet)
Seat 6: 1dfa358e folded before Flop (didn't bet)


Poker Hand #RC92811501: Hold'em No Limit ($0.1/$0.25) - 2020/04/02 23:56:16
Table 'RushAndCash47599' 6-max Seat #1 is the button
Seat 1: 44db54de ($40.8 in chips)
Seat 2: c5697ac1 ($25 in chips)
Seat 3: 5167702 ($36.79 in chips)
Seat 4: Hero ($31.96 in chips)
Seat 5: a44aa940 ($14.85 in chips)
Seat 6: 7d3dbc6b ($53.81 in chips)
Cash Drop to Pot : total $2.5 
c5697ac1: posts small blind $0.1
5167702: posts big blind $0.25
*** HOLE CARDS ***
Dealt to 44db54de 
Dealt to c5697ac1 
Dealt to 5167702 
Dealt to Hero [7d 4d]
Dealt to a44aa940 
Dealt to 7d3dbc6b 
Hero: folds
a44aa940: folds
7d3dbc6b: folds
44db54de: raises $40.55 to $40.8 and is all-in
c5697ac1: folds
5167702: folds
Uncalled bet ($40.55) returned to 44db54de
*** SHOWDOWN ***
44db54de collected $3.1 from pot
*** SUMMARY ***
Total pot $3.1
Seat 1: 44db54de (button) collected ($3.1)
Seat 2: c5697ac1 (small blind) folded before Flop
Seat 3: 5167702 (big blind) folded before Flop
Seat 4: Hero folded before Flop (didn't bet)
Seat 5: a44aa940 folded before Flop (didn't bet)
Seat 6: 7d3dbc6b folded before Flop (didn't bet)


Poker Hand #RC92811562: Hold'em No Limit ($0.1/$0.25) - 2020/04/02 23:56:27
Table 'RushAndCash47608' 6-max Seat #1 is the button
Seat 1: a1320bd6 ($111.45 in chips)
Seat 2: 89a3eced ($218.1 in chips)
Seat 3: 8d45281f ($27.09 in chips)
Seat 4: a36379d9 ($27.57 in chips)
Seat 5: e35929c8 ($15.78 in chips)
Seat 6: Hero ($31.96 in chips)
89a3eced: posts small blind $0.1
8d45281f: posts big blind $0.25
*** HOLE CARDS ***
Dealt to a1320bd6 
Dealt to 89a3eced 
Dealt to 8d45281f 
Dealt to a36379d9 
Dealt to e35929c8 
Dealt to Hero [Ts 7s]
a36379d9: raises $0.38 to $0.63
e35929c8: folds
Hero: folds
a1320bd6: folds
89a3eced: calls $0.53
8d45281f: folds
*** FLOP *** [9d 6c 4c]
89a3eced: checks
a36379d9: checks
*** TURN *** [9d 6c 4c] [5s]
89a3eced: bets $1.25
a36379d9: calls $1.25
*** RIVER *** [9d 6c 4c 5s] [Qs]
89a3eced: checks
a36379d9: bets $3.5
89a3eced: calls $3.5
a36379d9: shows [Ks Kh] (Pair of Kings)
89a3eced: shows [Qc 9c] (Pair of Queens and Pair of Nines)
*** SHOWDOWN ***
89a3eced collected $11.01 from pot
*** SUMMARY ***
Total pot $11.01
Board [9d 6c 4c 5s Qs]
Seat 1: a1320bd6 (button) folded before Flop (didn't bet)
Seat 2: 89a3eced (small blind) showed [Qc 9c] and won ($11.01) with Pair of Queens and Pair of Nines
Seat 3: 8d45281f (big blind) folded before Flop
Seat 4: a36379d9 showed [Ks Kh] and lost with Pair of Kings
Seat 5: e35929c8 folded before Flop (didn't bet)
Seat 6: Hero folded before Flop (didn't bet)


Poker Hand #RC92811612: Hold'em No Limit ($0.1/$0.25) - 2020/04/02 23:56:37
Table 'RushAndCash47614' 6-max Seat #1 is the button
Seat 1: 40d3b492 ($25 in chips)
Seat 2: bb9a5aea ($14.47 in chips)
Seat 3: fd2fdc90 ($26.18 in chips)
Seat 4: 2eabd980 ($9.93 in chips)
Seat 5: b320ed6a ($54.73 in chips)
Seat 6: Hero ($31.96 in chips)
bb9a5aea: posts small blind $0.1
fd2fdc90: posts big blind $0.25
*** HOLE CARDS ***
Dealt to 40d3b492 
Dealt to bb9a5aea 
Dealt to fd2fdc90 
Dealt to 2eabd980 
Dealt to b320ed6a 
Dealt to Hero [9s 7d]
2eabd980: folds
b320ed6a: raises $0.3 to $0.55
Hero: folds
40d3b492: raises $1.45 to $2
bb9a5aea: folds
fd2fdc90: folds
b320ed6a: folds
Uncalled bet ($1.45) returned to 40d3b492
*** SHOWDOWN ***
40d3b492 collected $1.45 from pot
*** SUMMARY ***
Total pot $1.45
Seat 1: 40d3b492 (button) collected ($1.45)
Seat 2: bb9a5aea (small blind) folded before Flop
Seat 3: fd2fdc90 (big blind) folded before Flop
Seat 4: 2eabd980 folded before Flop (didn't bet)
Seat 5: b320ed6a folded before Flop
Seat 6: Hero folded before Flop (didn't bet)


Poker Hand #RC92811636: Hold'em No Limit ($0.1/$0.25) - 2020/04/02 23:56:42
Table 'RushAndCash47617' 6-max Seat #1 is the button
Seat 1: 2117df3e ($19.69 in chips)
Seat 2: 8d45281f ($26.84 in chips)
Seat 3: ae3a6d93 ($20.06 in chips)
Seat 4: f43af171 ($25.32 in chips)
Seat 5: Hero ($31.96 in chips)
Seat 6: b912752f ($20.27 in chips)
8d45281f: posts small blind $0.1
ae3a6d93: posts big blind $0.25
*** HOLE CARDS ***
Dealt to 2117df3e 
Dealt to 8d45281f 
Dealt to ae3a6d93 
Dealt to f43af171 
Dealt to Hero [9c 7s]
Dealt to b912752f 
f43af171: folds
Hero: folds
b912752f: folds
2117df3e: folds
8d45281f: folds
Uncalled bet ($0.15) returned to ae3a6d93
*** SHOWDOWN ***
ae3a6d93 collected $0.2 from pot
*** SUMMARY ***
Total pot $0.2
Seat 1: 2117df3e (button) folded before Flop (didn't bet)
Seat 2: 8d45281f (small blind) folded before Flop
Seat 3: ae3a6d93 (big blind) collected ($0.2)
Seat 4: f43af171 folded before Flop (didn't bet)
Seat 5: Hero folded before Flop (didn't bet)
Seat 6: b912752f folded before Flop (didn't bet)


Poker Hand #RC92811657: Hold'em No Limit ($0.1/$0.25) - 2020/04/02 23:56:46
Table 'RushAndCash47621' 6-max Seat #1 is the button
Seat 1: a9b011a7 ($26.31 in chips)
Seat 2: f43af171 ($25.32 in chips)
Seat 3: Hero ($31.96 in chips)
Seat 4: c27aaa40 ($87.75 in chips)
Seat 5: 2117df3e ($19.69 in chips)
Seat 6: 30b9401d ($10.52 in chips)
f43af171: posts small blind $0.1
Hero: posts big blind $0.25
*** HOLE CARDS ***
Dealt to a9b011a7 
Dealt to f43af171 
Dealt to Hero [Qd 5d]
Dealt to c27aaa40 
Dealt to 2117df3e 
Dealt to 30b9401d 
c27aaa40: folds
2117df3e: folds
30b9401d: folds
a9b011a7: folds
f43af171: raises $0.5 to $0.75
Hero: folds
Uncalled bet ($0.5) returned to f43af171
*** SHOWDOWN ***
f43af171 collected $0.5 from pot
*** SUMMARY ***
Total pot $0.5
Seat 1: a9b011a7 (button) folded before Flop (didn't bet)
Seat 2: f43af171 (small blind) collected ($0.5)
Seat 3: Hero (big blind) folded before Flop
Seat 4: c27aaa40 folded before Flop (didn't bet)
Seat 5: 2117df3e folded before Flop (didn't bet)
Seat 6: 30b9401d folded before Flop (didn't bet)


Poker Hand #RC92811670: Hold'em No Limit ($0.1/$0.25) - 2020/04/02 23:56:49
Table 'RushAndCash47623' 6-max Seat #1 is the button
Seat 1: f032dc5a ($15.86 in chips)
Seat 2: Hero ($31.71 in chips)
Seat 3: f19292be ($37.79 in chips)
Seat 4: cbf0ae65 ($13.46 in chips)
Seat 5: e3fa4802 ($30.14 in chips)
Seat 6: 8d45281f ($26.74 in chips)
Hero: posts small blind $0.1
f19292be: posts big blind $0.25
*** HOLE CARDS ***
Dealt to f032dc5a 
Dealt to Hero [Ts 7s]
Dealt to f19292be 
Dealt to cbf0ae65 
Dealt to e3fa4802 
Dealt to 8d45281f 
cbf0ae65: folds
e3fa4802: folds
8d45281f: folds
f032dc5a: folds
Hero: folds
Uncalled bet ($0.15) returned to f19292be
*** SHOWDOWN ***
f19292be collected $0.2 from pot
*** SUMMARY ***
Total pot $0.2
Seat 1: f032dc5a (button) folded before Flop (didn't bet)
Seat 2: Hero (small blind) folded before Flop
Seat 3: f19292be (big blind) collected ($0.2)
Seat 4: cbf0ae65 folded before Flop (didn't bet)
Seat 5: e3fa4802 folded before Flop (didn't bet)
Seat 6: 8d45281f folded before Flop (didn't bet)


Poker Hand #RC92811690: Hold'em No Limit ($0.1/$0.25) - 2020/04/02 23:56:53
Table 'RushAndCash47625' 6-max Seat #1 is the button
Seat 1: Hero ($31.61 in chips)
Seat 2: deb72131 ($12.6 in chips)
Seat 3: 30b9401d ($10.52 in chips)
Seat 4: a3a8cfd ($33.99 in chips)
Seat 5: 6d33a0cb ($64.81 in chips)
Seat 6: a9b011a7 ($26.31 in chips)
deb72131: posts small blind $0.1
30b9401d: posts big blind $0.25
*** HOLE CARDS ***
Dealt to Hero [As 5d]
Dealt to deb72131 
Dealt to 30b9401d 
Dealt to a3a8cfd 
Dealt to 6d33a0cb 
Dealt to a9b011a7 
a3a8cfd: folds
6d33a0cb: folds
a9b011a7: folds
Hero: folds
deb72131: folds
Uncalled bet ($0.15) returned to 30b9401d
*** SHOWDOWN ***
30b9401d collected $0.2 from pot
*** SUMMARY ***
Total pot $0.2
Seat 1: Hero (button) folded before Flop (didn't bet)
Seat 2: deb72131 (small blind) folded before Flop
Seat 3: 30b9401d (big blind) collected ($0.2)
Seat 4: a3a8cfd folded before Flop (didn't bet)
Seat 5: 6d33a0cb folded before Flop (didn't bet)
Seat 6: a9b011a7 folded before Flop (didn't bet)


Poker Hand #RC92811711: Hold'em No Limit ($0.1/$0.25) - 2020/04/02 23:56:56
Table 'RushAndCash47627' 6-max Seat #1 is the button
Seat 1: 8d45281f ($26.74 in chips)
Seat 2: 833dc1e7 ($85.86 in chips)
Seat 3: c5697ac1 ($25 in chips)
Seat 4: Hero ($31.61 in chips)
Seat 5: 2117df3e ($19.69 in chips)
Seat 6: 44db54de ($43.5 in chips)
833dc1e7: posts small blind $0.1
c5697ac1: posts big blind $0.25
*** HOLE CARDS ***
Dealt to 8d45281f 
Dealt to 833dc1e7 
Dealt to c5697ac1 
Dealt to Hero [Kh 7d]
Dealt to 2117df3e 
Dealt to 44db54de 
Hero: folds
2117df3e: folds
44db54de: folds
8d45281f: folds
833dc1e7: folds
Uncalled bet ($0.15) returned to c5697ac1
*** SHOWDOWN ***
c5697ac1 collected $0.2 from pot
*** SUMMARY ***
Total pot $0.2
Seat 1: 8d45281f (button) folded before Flop (didn't bet)
Seat 2: 833dc1e7 (small blind) folded before Flop
Seat 3: c5697ac1 (big blind) collected ($0.2)
Seat 4: Hero folded before Flop (didn't bet)
Seat 5: 2117df3e folded before Flop (didn't bet)
Seat 6: 44db54de folded before Flop (didn't bet)


Poker Hand #RC92811729: Hold'em No Limit ($0.1/$0.25) - 2020/04/02 23:57:00
Table 'RushAndCash47630' 6-max Seat #1 is the button
Seat 1: f43af171 ($25.57 in chips)
Seat 2: 7eb96805 ($7.67 in chips)
Seat 3: Hero ($31.61 in chips)
Seat 4: 64268d2a ($29.84 in chips)
Seat 5: 2458c9bb ($26.09 in chips)
Seat 6: 8d45281f ($26.74 in chips)
7eb96805: posts small blind $0.1
Hero: posts big blind $0.25
*** HOLE CARDS ***
Dealt to f43af171 
Dealt to 7eb96805 
Dealt to Hero [6d 6c]
Dealt to 64268d2a 
Dealt to 2458c9bb 
Dealt to 8d45281f 
64268d2a: folds
2458c9bb: raises $0.5 to $0.75
8d45281f: folds
f43af171: folds
7eb96805: folds
Hero: calls $0.5
*** FLOP *** [4c Kc Qc]
Hero: checks
2458c9bb: bets $0.8
Hero: folds
Uncalled bet ($0.8) returned to 2458c9bb
*** SHOWDOWN ***
2458c9bb collected $1.6 from pot
*** SUMMARY ***
Total pot $1.6
Board [4c Kc Qc]
Seat 1: f43af171 (button) folded before Flop (didn't bet)
Seat 2: 7eb96805 (small blind) folded before Flop
Seat 3: Hero (big blind) folded on the Flop
Seat 4: 64268d2a folded before Flop (didn't bet)
Seat 5: 2458c9bb won ($1.6)
Seat 6: 8d45281f folded before Flop (didn't bet)


Poker Hand #RC92811856: Hold'em No Limit ($0.1/$0.25) - 2020/04/02 23:57:26
Table 'RushAndCash47645' 6-max Seat #1 is the button
Seat 1: Hero ($30.86 in chips)
Seat 2: 97dacd30 ($11.96 in chips)
Seat 3: 44db54de ($43.5 in chips)
Seat 4: 2458c9bb ($26.86 in chips)
Seat 5: a6687bdc ($25.6 in chips)
Seat 6: 7d3dbc6b ($53.46 in chips)
97dacd30: posts small blind $0.1
44db54de: posts big blind $0.25
*** HOLE CARDS ***
Dealt to Hero [Ac 4s]
Dealt to 97dacd30 
Dealt to 44db54de 
Dealt to 2458c9bb 
Dealt to a6687bdc 
Dealt to 7d3dbc6b 
2458c9bb: folds
a6687bdc: folds
7d3dbc6b: folds
Hero: folds
97dacd30: calls $0.15
44db54de: checks
*** FLOP *** [4h Jc Ad]
97dacd30: checks
44db54de: checks
*** TURN *** [4h Jc Ad] [Qs]
97dacd30: checks
44db54de: checks
*** RIVER *** [4h Jc Ad Qs] [5h]
97dacd30: checks
44db54de: checks
97dacd30: shows [Th 5c] (Pair of Fives)
44db54de: shows [8d 5s] (Pair of Fives)
*** SHOWDOWN ***
44db54de collected $0.25 from pot
97dacd30 collected $0.25 from pot
*** SUMMARY ***
Total pot $0.5
Board [4h Jc Ad Qs 5h]
Seat 1: Hero (button) folded before Flop (didn't bet)
Seat 2: 97dacd30 (small blind) showed [Th 5c] and won ($0.25) with Pair of Fives
Seat 3: 44db54de (big blind) showed [8d 5s] and won ($0.25) with Pair of Fives
Seat 4: 2458c9bb folded before Flop (didn't bet)
Seat 5: a6687bdc folded before Flop (didn't bet)
Seat 6: 7d3dbc6b folded before Flop (didn't bet)


Poker Hand #RC92811891: Hold'em No Limit ($0.1/$0.25) - 2020/04/02 23:57:34
Table 'RushAndCash47650' 6-max Seat #1 is the button
Seat 1: dc9aea4f ($27.26 in chips)
Seat 2: Hero ($30.86 in chips)
Seat 3: 89a3eced ($222.93 in chips)
Seat 4: c5697ac1 ($26.11 in chips)
Seat 5: e35929c8 ($17.58 in chips)
Seat 6: b320ed6a ($53.93 in chips)
Hero: posts small blind $0.1
89a3eced: posts big blind $0.25
*** HOLE CARDS ***
Dealt to dc9aea4f 
Dealt to Hero [Ah Tc]
Dealt to 89a3eced 
Dealt to c5697ac1 
Dealt to e35929c8 
Dealt to b320ed6a 
c5697ac1: folds
e35929c8: raises $0.38 to $0.63
b320ed6a: folds
dc9aea4f: folds
Hero: folds
89a3eced: folds
Uncalled bet ($0.38) returned to e35929c8
*** SHOWDOWN ***
e35929c8 collected $0.6 from pot
*** SUMMARY ***
Total pot $0.6
Seat 1: dc9aea4f (button) folded before Flop (didn't bet)
Seat 2: Hero (small blind) folded before Flop
Seat 3: 89a3eced (big blind) folded before Flop
Seat 4: c5697ac1 folded before Flop (didn't bet)
Seat 5: e35929c8 collected ($0.6)
Seat 6: b320ed6a folded before Flop (didn't bet)


Poker Hand #RC92811934: Hold'em No Limit ($0.1/$0.25) - 2020/04/02 23:57:43
Table 'RushAndCash47655' 6-max Seat #1 is the button
Seat 1: Hero ($30.76 in chips)
Seat 2: 2611a367 ($30.54 in chips)
Seat 3: 5b73fbfa ($79.22 in chips)
Seat 4: c204bed8 ($25 in chips)
Seat 5: 2117df3e ($19.34 in chips)
Seat 6: c5697ac1 ($26.11 in chips)
2611a367: posts small blind $0.1
5b73fbfa: posts big blind $0.25
*** HOLE CARDS ***
Dealt to Hero [4h 3c]
Dealt to 2611a367 
Dealt to 5b73fbfa 
Dealt to c204bed8 
Dealt to 2117df3e 
Dealt to c5697ac1 
c204bed8: raises $0.5 to $0.75
2117df3e: calls $0.75
c5697ac1: folds
Hero: folds
2611a367: folds
5b73fbfa: folds
*** FLOP *** [3s Kh 2s]
c204bed8: bets $0.75
2117df3e: calls $0.75
*** TURN *** [3s Kh 2s] [8c]
c204bed8: checks
2117df3e: checks
*** RIVER *** [3s Kh 2s 8c] [2d]
c204bed8: bets $1.2
2117df3e: folds
Uncalled bet ($1.2) returned to c204bed8
*** SHOWDOWN ***
c204bed8 collected $3.35 from pot
*** SUMMARY ***
Total pot $3.35
Board [3s Kh 2s 8c 2d]
Seat 1: Hero (button) folded before Flop (didn't bet)
Seat 2: 2611a367 (small blind) folded before Flop
Seat 3: 5b73fbfa (big blind) folded before Flop
Seat 4: c204bed8 won ($3.35)
Seat 5: 2117df3e folded on the River
Seat 6: c5697ac1 folded before Flop (didn't bet)


Poker Hand #RC92811951: Hold'em No Limit ($0.1/$0.25) - 2020/04/02 23:57:47
Table 'RushAndCash47657' 6-max Seat #1 is the button
Seat 1: c427ddfc ($50.63 in chips)
Seat 2: fd2fdc90 ($26.53 in chips)
Seat 3: f43af171 ($25.57 in chips)
Seat 4: 30b9401d ($10.87 in chips)
Seat 5: Hero ($30.76 in chips)
Seat 6: 6afd0518 ($81.91 in chips)
fd2fdc90: posts small blind $0.1
f43af171: posts big blind $0.25
*** HOLE CARDS ***
Dealt to c427ddfc 
Dealt to fd2fdc90 
Dealt to f43af171 
Dealt to 30b9401d 
Dealt to Hero [Kc Th]
Dealt to 6afd0518 
30b9401d: folds
Hero: folds
6afd0518: folds
c427ddfc: folds
fd2fdc90: raises $0.35 to $0.6
f43af171: calls $0.35
*** FLOP *** [6d Ac 4d]
fd2fdc90: bets $0.6
f43af171: folds
Uncalled bet ($0.6) returned to fd2fdc90
*** SHOWDOWN ***
fd2fdc90 collected $1.2 from pot
*** SUMMARY ***
Total pot $1.2
Board [6d Ac 4d]
Seat 1: c427ddfc (button) folded before Flop (didn't bet)
Seat 2: fd2fdc90 (small blind) won ($1.2)
Seat 3: f43af171 (big blind) folded on the Flop
Seat 4: 30b9401d folded before Flop (didn't bet)
Seat 5: Hero folded before Flop (didn't bet)
Seat 6: 6afd0518 folded before Flop (didn't bet)


Poker Hand #RC92811971: Hold'em No Limit ($0.1/$0.25) - 2020/04/02 23:57:51
Table 'RushAndCash47661' 6-max Seat #1 is the button
Seat 1: 2611a367 ($30.44 in chips)
Seat 2: b320ed6a ($53.93 in chips)
Seat 3: 36f1561e ($25 in chips)
Seat 4: Hero ($30.76 in chips)
Seat 5: 833dc1e7 ($86.77 in chips)
Seat 6: 7eb96805 ($7.57 in chips)
b320ed6a: posts small blind $0.1
36f1561e: posts big blind $0.25
*** HOLE CARDS ***
Dealt to 2611a367 
Dealt to b320ed6a 
Dealt to 36f1561e 
Dealt to Hero [Td 2h]
Dealt to 833dc1e7 
Dealt to 7eb96805 
Hero: folds
833dc1e7: raises $0.38 to $0.63
7eb96805: folds
2611a367: folds
b320ed6a: folds
36f1561e: folds
Uncalled bet ($0.38) returned to 833dc1e7
*** SHOWDOWN ***
833dc1e7 collected $0.6 from pot
*** SUMMARY ***
Total pot $0.6
Seat 1: 2611a367 (button) folded before Flop (didn't bet)
Seat 2: b320ed6a (small blind) folded before Flop
Seat 3: 36f1561e (big blind) folded before Flop
Seat 4: Hero folded before Flop (didn't bet)
Seat 5: 833dc1e7 collected ($0.6)
Seat 6: 7eb96805 folded before Flop (didn't bet)


Poker Hand #RC92811996: Hold'em No Limit ($0.1/$0.25) - 2020/04/02 23:57:55
Table 'RushAndCash47665' 6-max Seat #1 is the button
Seat 1: 33dc6448 ($26.26 in chips)
Seat 2: 13078def ($25 in chips)
Seat 3: 25bc93df ($12.5 in chips)
Seat 4: 2611a367 ($30.44 in chips)
Seat 5: 5610efa8 ($21.96 in chips)
Seat 6: Hero ($30.76 in chips)
13078def: posts small blind $0.1
25bc93df: posts big blind $0.25
*** HOLE CARDS ***
Dealt to 33dc6448 
Dealt to 13078def 
Dealt to 25bc93df 
Dealt to 2611a367 
Dealt to 5610efa8 
Dealt to Hero [6d 6c]
2611a367: folds
5610efa8: folds
Hero: raises $0.38 to $0.63
33dc6448: raises $1.37 to $2
13078def: folds
25bc93df: folds
Hero: calls $1.37
*** FLOP *** [8c 5d 9d]
Hero: checks
33dc6448: checks
*** TURN *** [8c 5d 9d] [5c]
Hero: bets $1.97
33dc6448: calls $1.97
*** RIVER *** [8c 5d 9d 5c] [3s]
Hero: bets $5.85
33dc6448: folds
Uncalled bet ($5.85) returned to Hero
*** SHOWDOWN ***
Hero collected $8.29 from pot
*** SUMMARY ***
Total pot $8.29
Board [8c 5d 9d 5c 3s]
Seat 1: 33dc6448 (button) folded on the River
Seat 2: 13078def (small blind) folded before Flop
Seat 3: 25bc93df (big blind) folded before Flop
Seat 4: 2611a367 folded before Flop (didn't bet)
Seat 5: 5610efa8 folded before Flop (didn't bet)
Seat 6: Hero won ($8.29)


Poker Hand #RC92812218: Hold'em No Limit ($0.1/$0.25) - 2020/04/02 23:58:39
Table 'RushAndCash47699' 6-max Seat #1 is the button
Seat 1: 25bc93df ($12.5 in chips)
Seat 2: 97dacd30 ($11.7 in chips)
Seat 3: Hero ($34.42 in chips)
Seat 4: 36f1561e ($25 in chips)
Seat 5: 833dc1e7 ($87.12 in chips)
Seat 6: 2611a367 ($29.49 in chips)
97dacd30: posts small blind $0.1
Hero: posts big blind $0.25
*** HOLE CARDS ***
Dealt to 25bc93df 
Dealt to 97dacd30 
Dealt to Hero [Jh 6s]
Dealt to 36f1561e 
Dealt to 833dc1e7 
Dealt to 2611a367 
36f1561e: folds
833dc1e7: folds
2611a367: folds
25bc93df: raises $0.5 to $0.75
97dacd30: folds
Hero: folds
Uncalled bet ($0.5) returned to 25bc93df
*** SHOWDOWN ***
25bc93df collected $0.6 from pot
*** SUMMARY ***
Total pot $0.6
Seat 1: 25bc93df (button) collected ($0.6)
Seat 2: 97dacd30 (small blind) folded before Flop
Seat 3: Hero (big blind) folded before Flop
Seat 4: 36f1561e folded before Flop (didn't bet)
Seat 5: 833dc1e7 folded before Flop (didn't bet)
Seat 6: 2611a367 folded before Flop (didn't bet)


Poker Hand #RC92812234: Hold'em No Limit ($0.1/$0.25) - 2020/04/02 23:58:43
Table 'RushAndCash47700' 6-max Seat #1 is the button
Seat 1: a3a8cfd ($34.7 in chips)
Seat 2: Hero ($34.17 in chips)
Seat 3: a8727b90 ($25 in chips)
Seat 4: 2611a367 ($29.49 in chips)
Seat 5: e3fa4802 ($30.7 in chips)
Seat 6: 33dc6448 ($25 in chips)
Hero: posts small blind $0.1
a8727b90: posts big blind $0.25
*** HOLE CARDS ***
Dealt to a3a8cfd 
Dealt to Hero [9d 7c]
Dealt to a8727b90 
Dealt to 2611a367 
Dealt to e3fa4802 
Dealt to 33dc6448 
2611a367: raises $0.38 to $0.63
e3fa4802: folds
33dc6448: folds
a3a8cfd: folds
Hero: folds
a8727b90: calls $0.38
*** FLOP *** [3c 4d Qc]
a8727b90: checks
2611a367: bets $0.5
a8727b90: calls $0.5
*** TURN *** [3c 4d Qc] [Th]
a8727b90: bets $1.8
2611a367: calls $1.8
*** RIVER *** [3c 4d Qc Th] [5c]
a8727b90: bets $6
2611a367: folds
Uncalled bet ($6) returned to a8727b90
*** SHOWDOWN ***
a8727b90 collected $5.96 from pot
*** SUMMARY ***
Total pot $5.96
Board [3c 4d Qc Th 5c]
Seat 1: a3a8cfd (button) folded before Flop (didn't bet)
Seat 2: Hero (small blind) folded before Flop
Seat 3: a8727b90 (big blind) won ($5.96)
Seat 4: 2611a367 folded on the River
Seat 5: e3fa4802 folded before Flop (didn't bet)
Seat 6: 33dc6448 folded before Flop (didn't bet)


Poker Hand #RC92812251: Hold'em No Limit ($0.1/$0.25) - 2020/04/02 23:58:46
Table 'RushAndCash47702' 6-max Seat #1 is the button
Seat 1: 6afd0518 ($82.47 in chips)
Seat 2: a957a98a ($19.64 in chips)
Seat 3: 833dc1e7 ($87.12 in chips)
Seat 4: c27aaa40 ($87.61 in chips)
Seat 5: fd2fdc90 ($26.82 in chips)
Seat 6: Hero ($34.07 in chips)
a957a98a: posts small blind $0.1
833dc1e7: posts big blind $0.25
*** HOLE CARDS ***
Dealt to 6afd0518 
Dealt to a957a98a 
Dealt to 833dc1e7 
Dealt to c27aaa40 
Dealt to fd2fdc90 
Dealt to Hero [Js 2h]
c27aaa40: folds
fd2fdc90: folds
Hero: folds
6afd0518: folds
a957a98a: folds
Uncalled bet ($0.15) returned to 833dc1e7
*** SHOWDOWN ***
833dc1e7 collected $0.2 from pot
*** SUMMARY ***
Total pot $0.2
Seat 1: 6afd0518 (button) folded before Flop (didn't bet)
Seat 2: a957a98a (small blind) folded before Flop
Seat 3: 833dc1e7 (big blind) collected ($0.2)
Seat 4: c27aaa40 folded before Flop (didn't bet)
Seat 5: fd2fdc90 folded before Flop (didn't bet)
Seat 6: Hero folded before Flop (didn't bet)


Poker Hand #RC92812292: Hold'em No Limit ($0.1/$0.25) - 2020/04/02 23:58:55
Table 'RushAndCash47706' 6-max Seat #1 is the button
Seat 1: Hero ($34.07 in chips)
Seat 2: 40d3b492 ($27.61 in chips)
Seat 3: a1320bd6 ($112.41 in chips)
Seat 4: 6afd0518 ($82.47 in chips)
Seat 5: 4ceb6642 ($11.37 in chips)
Seat 6: a9b011a7 ($25.31 in chips)
40d3b492: posts small blind $0.1
a1320bd6: posts big blind $0.25
*** HOLE CARDS ***
Dealt to Hero [Td 5c]
Dealt to 40d3b492 
Dealt to a1320bd6 
Dealt to 6afd0518 
Dealt to 4ceb6642 
Dealt to a9b011a7 
6afd0518: folds
4ceb6642: folds
a9b011a7: raises $0.38 to $0.63
Hero: folds
40d3b492: folds
a1320bd6: folds
Uncalled bet ($0.38) returned to a9b011a7
*** SHOWDOWN ***
a9b011a7 collected $0.6 from pot
*** SUMMARY ***
Total pot $0.6
Seat 1: Hero (button) folded before Flop (didn't bet)
Seat 2: 40d3b492 (small blind) folded before Flop
Seat 3: a1320bd6 (big blind) folded before Flop
Seat 4: 6afd0518 folded before Flop (didn't bet)
Seat 5: 4ceb6642 folded before Flop (didn't bet)
Seat 6: a9b011a7 collected ($0.6)


Poker Hand #RC92812336: Hold'em No Limit ($0.1/$0.25) - 2020/04/02 23:59:03
Table 'RushAndCash47712' 6-max Seat #1 is the button
Seat 1: 37d48404 ($54.86 in chips)
Seat 2: 9333dd47 ($26.23 in chips)
Seat 3: f43af171 ($24.22 in chips)
Seat 4: Hero ($34.07 in chips)
Seat 5: b289f27a ($29.65 in chips)
Seat 6: 4ceb6642 ($11.37 in chips)
9333dd47: posts small blind $0.1
f43af171: posts big blind $0.25
*** HOLE CARDS ***
Dealt to 37d48404 
Dealt to 9333dd47 
Dealt to f43af171 
Dealt to Hero [Ks 5c]
Dealt to b289f27a 
Dealt to 4ceb6642 
Hero: folds
b289f27a: folds
4ceb6642: folds
37d48404: raises $0.35 to $0.6
9333dd47: folds
f43af171: folds
Uncalled bet ($0.35) returned to 37d48404
*** SHOWDOWN ***
37d48404 collected $0.6 from pot
*** SUMMARY ***
Total pot $0.6
Seat 1: 37d48404 (button) collected ($0.6)
Seat 2: 9333dd47 (small blind) folded before Flop
Seat 3: f43af171 (big blind) folded before Flop
Seat 4: Hero folded before Flop (didn't bet)
Seat 5: b289f27a folded before Flop (didn't bet)
Seat 6: 4ceb6642 folded before Flop (didn't bet)


Poker Hand #RC92812355: Hold'em No Limit ($0.1/$0.25) - 2020/04/02 23:59:06
Table 'RushAndCash47714' 6-max Seat #1 is the button
Seat 1: 44db54de ($43.49 in chips)
Seat 2: Hero ($34.07 in chips)
Seat 3: 8d45281f ($26.45 in chips)
Seat 4: d8ff3732 ($29.81 in chips)
Seat 5: 30b9401d ($11.22 in chips)
Seat 6: a1320bd6 ($112.16 in chips)
Hero: posts small blind $0.1
8d45281f: posts big blind $0.25
*** HOLE CARDS ***
Dealt to 44db54de 
Dealt to Hero [8d 4s]
Dealt to 8d45281f 
Dealt to d8ff3732 
Dealt to 30b9401d 
Dealt to a1320bd6 
d8ff3732: folds
30b9401d: folds
a1320bd6: folds
44db54de: raises $0.38 to $0.63
Hero: folds
8d45281f: folds
Uncalled bet ($0.38) returned to 44db54de
*** SHOWDOWN ***
44db54de collected $0.6 from pot
*** SUMMARY ***
Total pot $0.6
Seat 1: 44db54de (button) collected ($0.6)
Seat 2: Hero (small blind) folded before Flop
Seat 3: 8d45281f (big blind) folded before Flop
Seat 4: d8ff3732 folded before Flop (didn't bet)
Seat 5: 30b9401d folded before Flop (didn't bet)
Seat 6: a1320bd6 folded before Flop (didn't bet)


Poker Hand #RC92812379: Hold'em No Limit ($0.1/$0.25) - 2020/04/02 23:59:10
Table 'RushAndCash47717' 6-max Seat #1 is the button
Seat 1: 36f1561e ($25 in chips)
Seat 2: 40123cec ($13.07 in chips)
Seat 3: Hero ($33.97 in chips)
Seat 4: 89a3eced ($221.58 in chips)
Seat 5: 4ceb6642 ($11.37 in chips)
Seat 6: a1320bd6 ($112.16 in chips)
40123cec: posts small blind $0.1
Hero: posts big blind $0.25
*** HOLE CARDS ***
Dealt to 36f1561e 
Dealt to 40123cec 
Dealt to Hero [Jc 4c]
Dealt to 89a3eced 
Dealt to 4ceb6642 
Dealt to a1320bd6 
89a3eced: folds
4ceb6642: folds
a1320bd6: raises $0.75 to $1
36f1561e: folds
40123cec: folds
Hero: folds
Uncalled bet ($0.75) returned to a1320bd6
*** SHOWDOWN ***
a1320bd6 collected $0.6 from pot
*** SUMMARY ***
Total pot $0.6
Seat 1: 36f1561e (button) folded before Flop (didn't bet)
Seat 2: 40123cec (small blind) folded before Flop
Seat 3: Hero (big blind) folded before Flop
Seat 4: 89a3eced folded before Flop (didn't bet)
Seat 5: 4ceb6642 folded before Flop (didn't bet)
Seat 6: a1320bd6 collected ($0.6)


Poker Hand #RC92812395: Hold'em No Limit ($0.1/$0.25) - 2020/04/02 23:59:13
Table 'RushAndCash47720' 6-max Seat #1 is the button
Seat 1: a36379d9 ($25.77 in chips)
Seat 2: a8727b90 ($27.74 in chips)
Seat 3: 25bc93df ($12.75 in chips)
Seat 4: 7eb96805 ($6.72 in chips)
Seat 5: Hero ($33.72 in chips)
Seat 6: 2611a367 ($26.56 in chips)
a8727b90: posts small blind $0.1
25bc93df: posts big blind $0.25
*** HOLE CARDS ***
Dealt to a36379d9 
Dealt to a8727b90 
Dealt to 25bc93df 
Dealt to 7eb96805 
Dealt to Hero [9s 3s]
Dealt to 2611a367 
7eb96805: folds
Hero: folds
2611a367: folds
a36379d9: folds
a8727b90: folds
Uncalled bet ($0.15) returned to 25bc93df
*** SHOWDOWN ***
25bc93df collected $0.2 from pot
*** SUMMARY ***
Total pot $0.2
Seat 1: a36379d9 (button) folded before Flop (didn't bet)
Seat 2: a8727b90 (small blind) folded before Flop
Seat 3: 25bc93df (big blind) collected ($0.2)
Seat 4: 7eb96805 folded before Flop (didn't bet)
Seat 5: Hero folded before Flop (didn't bet)
Seat 6: 2611a367 folded before Flop (didn't bet)


Poker Hand #RC92812418: Hold'em No Limit ($0.1/$0.25) - 2020/04/02 23:59:18
Table 'RushAndCash47724' 6-max Seat #1 is the button
Seat 1: f43af171 ($23.72 in chips)
Seat 2: 2611a367 ($26.56 in chips)
Seat 3: 7eb96805 ($6.72 in chips)
Seat 4: Hero ($33.72 in chips)
Seat 5: 36f1561e ($25 in chips)
Seat 6: c9779842 ($33.43 in chips)
2611a367: posts small blind $0.1
7eb96805: posts big blind $0.25
*** HOLE CARDS ***
Dealt to f43af171 
Dealt to 2611a367 
Dealt to 7eb96805 
Dealt to Hero [Jc 4h]
Dealt to 36f1561e 
Dealt to c9779842 
Hero: folds
36f1561e: folds
c9779842: folds
f43af171: folds
2611a367: folds
Uncalled bet ($0.15) returned to 7eb96805
*** SHOWDOWN ***
7eb96805 collected $0.2 from pot
*** SUMMARY ***
Total pot $0.2
Seat 1: f43af171 (button) folded before Flop (didn't bet)
Seat 2: 2611a367 (small blind) folded before Flop
Seat 3: 7eb96805 (big blind) collected ($0.2)
Seat 4: Hero folded before Flop (didn't bet)
Seat 5: 36f1561e folded before Flop (didn't bet)
Seat 6: c9779842 folded before Flop (didn't bet)


Poker Hand #RC92812443: Hold'em No Limit ($0.1/$0.25) - 2020/04/02 23:59:23
Table 'RushAndCash47727' 6-max Seat #1 is the button
Seat 1: Hero ($33.72 in chips)
Seat 2: 37d48404 ($55.21 in chips)
Seat 3: a1320bd6 ($112.51 in chips)
Seat 4: deb72131 ($13.39 in chips)
Seat 5: a8727b90 ($27.64 in chips)
Seat 6: 455d2a69 ($25.9 in chips)
37d48404: posts small blind $0.1
a1320bd6: posts big blind $0.25
*** HOLE CARDS ***
Dealt to Hero [5h 2h]
Dealt to 37d48404 
Dealt to a1320bd6 
Dealt to deb72131 
Dealt to a8727b90 
Dealt to 455d2a69 
deb72131: folds
a8727b90: raises $0.25 to $0.5
455d2a69: folds
Hero: folds
37d48404: folds
a1320bd6: raises $1.65 to $2.15
a8727b90: calls $1.65
*** FLOP *** [Qc 7s 9s]
a1320bd6: bets $3.3
a8727b90: calls $3.3
*** TURN *** [Qc 7s 9s] [5s]
a1320bd6: bets $8.3
a8727b90: calls $8.3
*** RIVER *** [Qc 7s 9s 5s] [Kc]
a1320bd6: checks
a8727b90: bets $13.89 and is all-in
a1320bd6: folds
Uncalled bet ($13.89) returned to a8727b90
*** SHOWDOWN ***
a8727b90 collected $27.6 from pot
*** SUMMARY ***
Total pot $27.6
Board [Qc 7s 9s 5s Kc]
Seat 1: Hero (button) folded before Flop (didn't bet)
Seat 2: 37d48404 (small blind) folded before Flop
Seat 3: a1320bd6 (big blind) folded on the River
Seat 4: deb72131 folded before Flop (didn't bet)
Seat 5: a8727b90 won ($27.6)
Seat 6: 455d2a69 folded before Flop (didn't bet)


Poker Hand #RC92812457: Hold'em No Limit ($0.1/$0.25) - 2020/04/02 23:59:26
Table 'RushAndCash47729' 6-max Seat #1 is the button
Seat 1: 25bc93df ($12.5 in chips)
Seat 2: f43af171 ($23.72 in chips)
Seat 3: d8ff3732 ($29.71 in chips)
Seat 4: cbf0ae65 ($14.65 in chips)
Seat 5: Hero ($33.72 in chips)
Seat 6: 9333dd47 ($26.13 in chips)
f43af171: posts small blind $0.1
d8ff3732: posts big blind $0.25
*** HOLE CARDS ***
Dealt to 25bc93df 
Dealt to f43af171 
Dealt to d8ff3732 
Dealt to cbf0ae65 
Dealt to Hero [Kd 4h]
Dealt to 9333dd47 
cbf0ae65: folds
Hero: folds
9333dd47: folds
25bc93df: raises $0.25 to $0.5
f43af171: folds
d8ff3732: calls $0.25
*** FLOP *** [Th 2c Td]
d8ff3732: checks
25bc93df: bets $0.6
d8ff3732: folds
Uncalled bet ($0.6) returned to 25bc93df
*** SHOWDOWN ***
25bc93df collected $1.1 from pot
*** SUMMARY ***
Total pot $1.1
Board [Th 2c Td]
Seat 1: 25bc93df (button) won ($1.1)
Seat 2: f43af171 (small blind) folded before Flop
Seat 3: d8ff3732 (big blind) folded on the Flop
Seat 4: cbf0ae65 folded before Flop (didn't bet)
Seat 5: Hero folded before Flop (didn't bet)
Seat 6: 9333dd47 folded before Flop (didn't bet)


Poker Hand #RC92812483: Hold'em No Limit ($0.1/$0.25) - 2020/04/02 23:59:32
Table 'RushAndCash47733' 6-max Seat #1 is the button
Seat 1: 97dacd30 ($11.83 in chips)
Seat 2: 36f1561e ($25 in chips)
Seat 3: 37d48404 ($55.11 in chips)
Seat 4: Hero ($33.72 in chips)
Seat 5: 2611a367 ($26.81 in chips)
Seat 6: a36379d9 ($25.67 in chips)
36f1561e: posts small blind $0.1
37d48404: posts big blind $0.25
*** HOLE CARDS ***
Dealt to 97dacd30 
Dealt to 36f1561e 
Dealt to 37d48404 
Dealt to Hero [Ad 7s]
Dealt to 2611a367 
Dealt to a36379d9 
Hero: folds
2611a367: folds
a36379d9: raises $0.38 to $0.63
97dacd30: folds
36f1561e: folds
37d48404: calls $0.38
*** FLOP *** [9h 7d As]
37d48404: checks
a36379d9: bets $0.9
37d48404: raises $1.6 to $2.5
a36379d9: calls $1.6
*** TURN *** [9h 7d As] [Kh]
37d48404: bets $6.3
a36379d9: calls $6.3
*** RIVER *** [9h 7d As Kh] [4d]
37d48404: bets $16.4
a36379d9: folds
Uncalled bet ($16.4) returned to 37d48404
*** SHOWDOWN ***
37d48404 collected $18.96 from pot
*** SUMMARY ***
Total pot $18.96
Board [9h 7d As Kh 4d]
Seat 1: 97dacd30 (button) folded before Flop (didn't bet)
Seat 2: 36f1561e (small blind) folded before Flop
Seat 3: 37d48404 (big blind) won ($18.96)
Seat 4: Hero folded before Flop (didn't bet)
Seat 5: 2611a367 folded before Flop (didn't bet)
Seat 6: a36379d9 folded on the River


Poker Hand #RC92812505: Hold'em No Limit ($0.1/$0.25) - 2020/04/02 23:59:37
Table 'RushAndCash47735' 6-max Seat #1 is the button
Seat 1: 40123cec ($12.97 in chips)
Seat 2: Hero ($33.72 in chips)
Seat 3: 9333dd47 ($26.03 in chips)
Seat 4: 833dc1e7 ($87.12 in chips)
Seat 5: 2611a367 ($26.81 in chips)
Seat 6: 5136ebb4 ($49.4 in chips)
Hero: posts small blind $0.1
9333dd47: posts big blind $0.25
*** HOLE CARDS ***
Dealt to 40123cec 
Dealt to Hero [8s 2d]
Dealt to 9333dd47 
Dealt to 833dc1e7 
Dealt to 2611a367 
Dealt to 5136ebb4 
833dc1e7: folds
2611a367: folds
5136ebb4: folds
40123cec: raises $0.5 to $0.75
Hero: folds
9333dd47: folds
Uncalled bet ($0.5) returned to 40123cec
*** SHOWDOWN ***
40123cec collected $0.6 from pot
*** SUMMARY ***
Total pot $0.6
Seat 1: 40123cec (button) collected ($0.6)
Seat 2: Hero (small blind) folded before Flop
Seat 3: 9333dd47 (big blind) folded before Flop
Seat 4: 833dc1e7 folded before Flop (didn't bet)
Seat 5: 2611a367 folded before Flop (didn't bet)
Seat 6: 5136ebb4 folded before Flop (didn't bet)


Poker Hand #RC92812525: Hold'em No Limit ($0.1/$0.25) - 2020/04/02 23:59:41
Table 'RushAndCash47737' 6-max Seat #1 is the button
Seat 1: 9333dd47 ($25.78 in chips)
Seat 2: 455d2a69 ($25.65 in chips)
Seat 3: 64268d2a ($30.67 in chips)
Seat 4: 2611a367 ($26.81 in chips)
Seat 5: 97dacd30 ($11.83 in chips)
Seat 6: Hero ($33.62 in chips)
455d2a69: posts small blind $0.1
64268d2a: posts big blind $0.25
*** HOLE CARDS ***
Dealt to 9333dd47 
Dealt to 455d2a69 
Dealt to 64268d2a 
Dealt to 2611a367 
Dealt to 97dacd30 
Dealt to Hero [9s 9h]
2611a367: folds
97dacd30: folds
Hero: raises $0.38 to $0.63
9333dd47: folds
455d2a69: folds
64268d2a: folds
Uncalled bet ($0.38) returned to Hero
*** SHOWDOWN ***
Hero collected $0.6 from pot
*** SUMMARY ***
Total pot $0.6
Seat 1: 9333dd47 (button) folded before Flop (didn't bet)
Seat 2: 455d2a69 (small blind) folded before Flop
Seat 3: 64268d2a (big blind) folded before Flop
Seat 4: 2611a367 folded before Flop (didn't bet)
Seat 5: 97dacd30 folded before Flop (didn't bet)
Seat 6: Hero collected ($0.6)


Poker Hand #RC92812591: Hold'em No Limit ($0.1/$0.25) - 2020/04/02 23:59:54
Table 'RushAndCash47745' 6-max Seat #1 is the button
Seat 1: 64268d2a ($30.42 in chips)
Seat 2: c204bed8 ($26.79 in chips)
Seat 3: Hero ($33.97 in chips)
Seat 4: 9333dd47 ($25.78 in chips)
Seat 5: 469ba291 ($25 in chips)
Seat 6: 4ceb6642 ($11.02 in chips)
c204bed8: posts small blind $0.1
Hero: posts big blind $0.25
*** HOLE CARDS ***
Dealt to 64268d2a 
Dealt to c204bed8 
Dealt to Hero [7c 3d]
Dealt to 9333dd47 
Dealt to 469ba291 
Dealt to 4ceb6642 
9333dd47: folds
469ba291: folds
4ceb6642: folds
64268d2a: raises $0.35 to $0.6
c204bed8: folds
Hero: folds
Uncalled bet ($0.35) returned to 64268d2a
*** SHOWDOWN ***
64268d2a collected $0.6 from pot
*** SUMMARY ***
Total pot $0.6
Seat 1: 64268d2a (button) collected ($0.6)
Seat 2: c204bed8 (small blind) folded before Flop
Seat 3: Hero (big blind) folded before Flop
Seat 4: 9333dd47 folded before Flop (didn't bet)
Seat 5: 469ba291 folded before Flop (didn't bet)
Seat 6: 4ceb6642 folded before Flop (didn't bet)


Poker Hand #RC92812641: Hold'em No Limit ($0.1/$0.25) - 2020/04/03 00:00:04
Table 'RushAndCash47752' 6-max Seat #1 is the button
Seat 1: 9333dd47 ($25.68 in chips)
Seat 2: f43af171 ($23.52 in chips)
Seat 3: 2117df3e ($18.09 in chips)
Seat 4: d8ff3732 ($29.21 in chips)
Seat 5: Hero ($33.72 in chips)
Seat 6: c27aaa40 ($75.41 in chips)
f43af171: posts small blind $0.1
2117df3e: posts big blind $0.25
*** HOLE CARDS ***
Dealt to 9333dd47 
Dealt to f43af171 
Dealt to 2117df3e 
Dealt to d8ff3732 
Dealt to Hero [6h 3c]
Dealt to c27aaa40 
d8ff3732: folds
Hero: folds
c27aaa40: folds
9333dd47: raises $0.38 to $0.63
f43af171: folds
2117df3e: folds
Uncalled bet ($0.38) returned to 9333dd47
*** SHOWDOWN ***
9333dd47 collected $0.6 from pot
*** SUMMARY ***
Total pot $0.6
Seat 1: 9333dd47 (button) collected ($0.6)
Seat 2: f43af171 (small blind) folded before Flop
Seat 3: 2117df3e (big blind) folded before Flop
Seat 4: d8ff3732 folded before Flop (didn't bet)
Seat 5: Hero folded before Flop (didn't bet)
Seat 6: c27aaa40 folded before Flop (didn't bet)


Poker Hand #RC92812704: Hold'em No Limit ($0.1/$0.25) - 2020/04/03 00:00:15
Table 'RushAndCash47760' 6-max Seat #1 is the button
Seat 1: d8ff3732 ($29.21 in chips)
Seat 2: Hero ($33.72 in chips)
Seat 3: 4ceb6642 ($11.02 in chips)
Seat 4: 40d3b492 ($28.27 in chips)
Seat 5: 40123cec ($12.97 in chips)
Seat 6: 8d45281f ($25.85 in chips)
Hero: posts small blind $0.1
4ceb6642: posts big blind $0.25
*** HOLE CARDS ***
Dealt to d8ff3732 
Dealt to Hero [Qd 8d]
Dealt to 4ceb6642 
Dealt to 40d3b492 
Dealt to 40123cec 
Dealt to 8d45281f 
40d3b492: raises $0.38 to $0.63
40123cec: raises $1.67 to $2.3
8d45281f: folds
d8ff3732: folds
Hero: folds
4ceb6642: folds
40d3b492: folds
Uncalled bet ($1.67) returned to 40123cec
*** SHOWDOWN ***
40123cec collected $1.61 from pot
*** SUMMARY ***
Total pot $1.61
Seat 1: d8ff3732 (button) folded before Flop (didn't bet)
Seat 2: Hero (small blind) folded before Flop
Seat 3: 4ceb6642 (big blind) folded before Flop
Seat 4: 40d3b492 folded before Flop
Seat 5: 40123cec collected ($1.61)
Seat 6: 8d45281f folded before Flop (didn't bet)


Poker Hand #RC92812727: Hold'em No Limit ($0.1/$0.25) - 2020/04/03 00:00:18
Table 'RushAndCash47763' 6-max Seat #1 is the button
Seat 1: Hero ($33.62 in chips)
Seat 2: 7eb96805 ($7.07 in chips)
Seat 3: d8ff3732 ($29.21 in chips)
Seat 4: 8d45281f ($25.85 in chips)
Seat 5: 73e63459 ($39.3 in chips)
Seat 6: 6d33a0cb ($68.63 in chips)
7eb96805: posts small blind $0.1
d8ff3732: posts big blind $0.25
*** HOLE CARDS ***
Dealt to Hero [Ad 7h]
Dealt to 7eb96805 
Dealt to d8ff3732 
Dealt to 8d45281f 
Dealt to 73e63459 
Dealt to 6d33a0cb 
8d45281f: folds
73e63459: folds
6d33a0cb: folds
Hero: folds
7eb96805: calls $0.15
d8ff3732: raises $0.45 to $0.7
7eb96805: calls $0.45
*** FLOP *** [6c 9c Kh]
7eb96805: checks
d8ff3732: checks
*** TURN *** [6c 9c Kh] [6d]
7eb96805: checks
d8ff3732: bets $1.2
7eb96805: folds
Uncalled bet ($1.2) returned to d8ff3732
*** SHOWDOWN ***
d8ff3732 collected $1.4 from pot
*** SUMMARY ***
Total pot $1.4
Board [6c 9c Kh 6d]
Seat 1: Hero (button) folded before Flop (didn't bet)
Seat 2: 7eb96805 (small blind) folded on the Turn
Seat 3: d8ff3732 (big blind) won ($1.4)
Seat 4: 8d45281f folded before Flop (didn't bet)
Seat 5: 73e63459 folded before Flop (didn't bet)
Seat 6: 6d33a0cb folded before Flop (didn't bet)


Poker Hand #RC92812758: Hold'em No Limit ($0.1/$0.25) - 2020/04/03 00:00:24
Table 'RushAndCash47767' 6-max Seat #1 is the button
Seat 1: c27aaa40 ($75.16 in chips)
Seat 2: b912752f ($18.04 in chips)
Seat 3: Hero ($33.62 in chips)
Seat 4: 833dc1e7 ($86.87 in chips)
Seat 5: 33dc6448 ($26.22 in chips)
Seat 6: a9b011a7 ($25.09 in chips)
b912752f: posts small blind $0.1
Hero: posts big blind $0.25
*** HOLE CARDS ***
Dealt to c27aaa40 
Dealt to b912752f 
Dealt to Hero [Kh 6c]
Dealt to 833dc1e7 
Dealt to 33dc6448 
Dealt to a9b011a7 
833dc1e7: raises $0.38 to $0.63
33dc6448: folds
a9b011a7: folds
c27aaa40: calls $0.63
b912752f: folds
Hero: folds
*** FLOP *** [8h 2h Ah]
833dc1e7: bets $0.6
c27aaa40: raises $1.8 to $2.4
833dc1e7: folds
Uncalled bet ($1.8) returned to c27aaa40
*** SHOWDOWN ***
c27aaa40 collected $2.81 from pot
*** SUMMARY ***
Total pot $2.81
Board [8h 2h Ah]
Seat 1: c27aaa40 (button) won ($2.81)
Seat 2: b912752f (small blind) folded before Flop
Seat 3: Hero (big blind) folded before Flop
Seat 4: 833dc1e7 folded on the Flop
Seat 5: 33dc6448 folded before Flop (didn't bet)
Seat 6: a9b011a7 folded before Flop (didn't bet)


Poker Hand #RC92812781: Hold'em No Limit ($0.1/$0.25) - 2020/04/03 00:00:28
Table 'RushAndCash47769' 6-max Seat #1 is the button
Seat 1: 2117df3e ($17.84 in chips)
Seat 2: 5b73fbfa ($79.82 in chips)
Seat 3: 2611a367 ($27.56 in chips)
Seat 4: 64268d2a ($30.77 in chips)
Seat 5: Hero ($33.37 in chips)
Seat 6: e3fa4802 ($42.65 in chips)
5b73fbfa: posts small blind $0.1
2611a367: posts big blind $0.25
*** HOLE CARDS ***
Dealt to 2117df3e 
Dealt to 5b73fbfa 
Dealt to 2611a367 
Dealt to 64268d2a 
Dealt to Hero [6s 5s]
Dealt to e3fa4802 
64268d2a: folds
Hero: folds
e3fa4802: folds
2117df3e: folds
5b73fbfa: folds
Uncalled bet ($0.15) returned to 2611a367
*** SHOWDOWN ***
2611a367 collected $0.2 from pot
*** SUMMARY ***
Total pot $0.2
Seat 1: 2117df3e (button) folded before Flop (didn't bet)
Seat 2: 5b73fbfa (small blind) folded before Flop
Seat 3: 2611a367 (big blind) collected ($0.2)
Seat 4: 64268d2a folded before Flop (didn't bet)
Seat 5: Hero folded before Flop (didn't bet)
Seat 6: e3fa4802 folded before Flop (didn't bet)


Poker Hand #RC92812807: Hold'em No Limit ($0.1/$0.25) - 2020/04/03 00:00:32
Table 'RushAndCash47773' 6-max Seat #1 is the button
Seat 1: bb9a5aea ($14.09 in chips)
Seat 2: e3fa4802 ($42.65 in chips)
Seat 3: 44db54de ($43.21 in chips)
Seat 4: e35929c8 ($18.6 in chips)
Seat 5: Hero ($33.37 in chips)
Seat 6: 40123cec ($13.87 in chips)
e3fa4802: posts small blind $0.1
44db54de: posts big blind $0.25
*** HOLE CARDS ***
Dealt to bb9a5aea 
Dealt to e3fa4802 
Dealt to 44db54de 
Dealt to e35929c8 
Dealt to Hero [Ad 5d]
Dealt to 40123cec 
e35929c8: folds
Hero: raises $0.38 to $0.63
40123cec: folds
bb9a5aea: folds
e3fa4802: folds
44db54de: raises $2.07 to $2.7
Hero: raises $3.22 to $5.92
44db54de: calls $3.22
*** FLOP *** [7h Ks Ah]
44db54de: checks
Hero: bets $6.42
44db54de: calls $6.42
*** TURN *** [7h Ks Ah] [Tc]
44db54de: checks
Hero: bets $21.03 and is all-in
44db54de: calls $21.03
Hero: shows [5d Ad] (Pair of Aces)
44db54de: shows [Kc Kd] (Three Kings)
*** RIVER *** [7h Ks Ah Tc] [8d]
*** SHOWDOWN ***
44db54de collected $66.84 from pot
*** SUMMARY ***
Total pot $66.84
Board [7h Ks Ah Tc 8d]
Seat 1: bb9a5aea (button) folded before Flop (didn't bet)
Seat 2: e3fa4802 (small blind) folded before Flop
Seat 3: 44db54de (big blind) showed [Kd Kc] and won ($66.84) with Three Kings
Seat 4: e35929c8 folded before Flop (didn't bet)
Seat 5: Hero showed [Ad 5d] and lost with Pair of Aces
Seat 6: 40123cec folded before Flop (didn't bet)


Poker Hand #RC92813189: Hold'em No Limit ($0.1/$0.25) - 2020/04/03 00:01:47
Table 'RushAndCash47802' 6-max Seat #1 is the button
Seat 1: 5136ebb4 ($48.9 in chips)
Seat 2: a1320bd6 ($93.26 in chips)
Seat 3: c9779842 ($33.08 in chips)
Seat 4: f19292be ($66.06 in chips)
Seat 5: Hero ($25 in chips)
Seat 6: ca320935 ($109.07 in chips)
a1320bd6: posts small blind $0.1
c9779842: posts big blind $0.25
*** HOLE CARDS ***
Dealt to 5136ebb4 
Dealt to a1320bd6 
Dealt to c9779842 
Dealt to f19292be 
Dealt to Hero [Ks Tc]
Dealt to ca320935 
f19292be: folds
Hero: folds
ca320935: folds
5136ebb4: folds
a1320bd6: folds
Uncalled bet ($0.15) returned to c9779842
*** SHOWDOWN ***
c9779842 collected $0.2 from pot
*** SUMMARY ***
Total pot $0.2
Seat 1: 5136ebb4 (button) folded before Flop (didn't bet)
Seat 2: a1320bd6 (small blind) folded before Flop
Seat 3: c9779842 (big blind) collected ($0.2)
Seat 4: f19292be folded before Flop (didn't bet)
Seat 5: Hero folded before Flop (didn't bet)
Seat 6: ca320935 folded before Flop (didn't bet)


Poker Hand #RC92813213: Hold'em No Limit ($0.1/$0.25) - 2020/04/03 00:01:52
Table 'RushAndCash47804' 6-max Seat #1 is the button
Seat 1: f43af171 ($23.82 in chips)
Seat 2: Hero ($25 in chips)
Seat 3: c204bed8 ($25.25 in chips)
Seat 4: f19292be ($66.06 in chips)
Seat 5: d8ff3732 ($28.86 in chips)
Seat 6: 7eb96805 ($12.5 in chips)
Hero: posts small blind $0.1
c204bed8: posts big blind $0.25
*** HOLE CARDS ***
Dealt to f43af171 
Dealt to Hero [8s 4c]
Dealt to c204bed8 
Dealt to f19292be 
Dealt to d8ff3732 
Dealt to 7eb96805 
f19292be: folds
d8ff3732: folds
7eb96805: folds
f43af171: folds
Hero: folds
Uncalled bet ($0.15) returned to c204bed8
*** SHOWDOWN ***
c204bed8 collected $0.2 from pot
*** SUMMARY ***
Total pot $0.2
Seat 1: f43af171 (button) folded before Flop (didn't bet)
Seat 2: Hero (small blind) folded before Flop
Seat 3: c204bed8 (big blind) collected ($0.2)
Seat 4: f19292be folded before Flop (didn't bet)
Seat 5: d8ff3732 folded before Flop (didn't bet)
Seat 6: 7eb96805 folded before Flop (didn't bet)


Poker Hand #RC92813239: Hold'em No Limit ($0.1/$0.25) - 2020/04/03 00:01:57
Table 'RushAndCash47806' 6-max Seat #1 is the button
Seat 1: c204bed8 ($25 in chips)
Seat 2: 89a3eced ($223.35 in chips)
Seat 3: 1345d179 ($12.5 in chips)
Seat 4: f19292be ($66.06 in chips)
Seat 5: Hero ($25 in chips)
Seat 6: 5610efa8 ($22.18 in chips)
89a3eced: posts small blind $0.1
1345d179: posts big blind $0.25
*** HOLE CARDS ***
Dealt to c204bed8 
Dealt to 89a3eced 
Dealt to 1345d179 
Dealt to f19292be 
Dealt to Hero [Jc 4s]
Dealt to 5610efa8 
f19292be: folds
Hero: folds
5610efa8: folds
c204bed8: folds
89a3eced: folds
Uncalled bet ($0.15) returned to 1345d179
*** SHOWDOWN ***
1345d179 collected $0.2 from pot
*** SUMMARY ***
Total pot $0.2
Seat 1: c204bed8 (button) folded before Flop (didn't bet)
Seat 2: 89a3eced (small blind) folded before Flop
Seat 3: 1345d179 (big blind) collected ($0.2)
Seat 4: f19292be folded before Flop (didn't bet)
Seat 5: Hero folded before Flop (didn't bet)
Seat 6: 5610efa8 folded before Flop (didn't bet)


Poker Hand #RC92813265: Hold'em No Limit ($0.1/$0.25) - 2020/04/03 00:02:03
Table 'RushAndCash47809' 6-max Seat #1 is the button
Seat 1: 89a3eced ($223.25 in chips)
Seat 2: a9b011a7 ($25 in chips)
Seat 3: Hero ($25 in chips)
Seat 4: a957a98a ($17.04 in chips)
Seat 5: 6d33a0cb ($57.61 in chips)
Seat 6: c204bed8 ($25 in chips)
a9b011a7: posts small blind $0.1
Hero: posts big blind $0.25
*** HOLE CARDS ***
Dealt to 89a3eced 
Dealt to a9b011a7 
Dealt to Hero [Ac 5c]
Dealt to a957a98a 
Dealt to 6d33a0cb 
Dealt to c204bed8 
a957a98a: folds
6d33a0cb: folds
c204bed8: folds
89a3eced: folds
a9b011a7: raises $0.5 to $0.75
Hero: raises $1.75 to $2.5
a9b011a7: calls $1.75
*** FLOP *** [8d 9s 7d]
a9b011a7: checks
Hero: bets $3.4
a9b011a7: folds
Uncalled bet ($3.4) returned to Hero
*** SHOWDOWN ***
Hero collected $5 from pot
*** SUMMARY ***
Total pot $5
Board [8d 9s 7d]
Seat 1: 89a3eced (button) folded before Flop (didn't bet)
Seat 2: a9b011a7 (small blind) folded on the Flop
Seat 3: Hero (big blind) won ($5)
Seat 4: a957a98a folded before Flop (didn't bet)
Seat 5: 6d33a0cb folded before Flop (didn't bet)
Seat 6: c204bed8 folded before Flop (didn't bet)


Poker Hand #RC92813641: Hold'em No Limit ($0.1/$0.25) - 2020/04/03 00:03:15
Table 'RushAndCash47846' 6-max Seat #1 is the button
Seat 1: Hero ($27.25 in chips)
Seat 2: f19292be ($67.6 in chips)
Seat 3: b912752f ($18.48 in chips)
Seat 4: c204bed8 ($25 in chips)
Seat 5: a6687bdc ($25.22 in chips)
Seat 6: 2117df3e ($18.85 in chips)
f19292be: posts small blind $0.1
b912752f: posts big blind $0.25
*** HOLE CARDS ***
Dealt to Hero [9s 5d]
Dealt to f19292be 
Dealt to b912752f 
Dealt to c204bed8 
Dealt to a6687bdc 
Dealt to 2117df3e 
c204bed8: folds
a6687bdc: raises $0.5 to $0.75
2117df3e: folds
Hero: folds
f19292be: folds
b912752f: folds
Uncalled bet ($0.5) returned to a6687bdc
*** SHOWDOWN ***
a6687bdc collected $0.6 from pot
*** SUMMARY ***
Total pot $0.6
Seat 1: Hero (button) folded before Flop (didn't bet)
Seat 2: f19292be (small blind) folded before Flop
Seat 3: b912752f (big blind) folded before Flop
Seat 4: c204bed8 folded before Flop (didn't bet)
Seat 5: a6687bdc collected ($0.6)
Seat 6: 2117df3e folded before Flop (didn't bet)


Poker Hand #RC92813666: Hold'em No Limit ($0.1/$0.25) - 2020/04/03 00:03:19
Table 'RushAndCash47848' 6-max Seat #1 is the button
Seat 1: e35929c8 ($18.79 in chips)
Seat 2: 469ba291 ($25 in chips)
Seat 3: a36379d9 ($25 in chips)
Seat 4: ad3d6d15 ($27.68 in chips)
Seat 5: 833dc1e7 ($98.21 in chips)
Seat 6: Hero ($27.25 in chips)
469ba291: posts small blind $0.1
a36379d9: posts big blind $0.25
*** HOLE CARDS ***
Dealt to e35929c8 
Dealt to 469ba291 
Dealt to a36379d9 
Dealt to ad3d6d15 
Dealt to 833dc1e7 
Dealt to Hero [Qd Td]
ad3d6d15: folds
833dc1e7: folds
Hero: raises $0.38 to $0.63
e35929c8: folds
469ba291: folds
a36379d9: folds
Uncalled bet ($0.38) returned to Hero
*** SHOWDOWN ***
Hero collected $0.6 from pot
*** SUMMARY ***
Total pot $0.6
Seat 1: e35929c8 (button) folded before Flop (didn't bet)
Seat 2: 469ba291 (small blind) folded before Flop
Seat 3: a36379d9 (big blind) folded before Flop
Seat 4: ad3d6d15 folded before Flop (didn't bet)
Seat 5: 833dc1e7 folded before Flop (didn't bet)
Seat 6: Hero collected ($0.6)


Poker Hand #RC92813772: Hold'em No Limit ($0.1/$0.25) - 2020/04/03 00:03:40
Table 'RushAndCash47859' 6-max Seat #1 is the button
Seat 1: d8ff3732 ($29.43 in chips)
Seat 2: e3fa4802 ($51.06 in chips)
Seat 3: 33dc6448 ($28.49 in chips)
Seat 4: ca320935 ($107.44 in chips)
Seat 5: Hero ($27.6 in chips)
Seat 6: 73e63459 ($23.07 in chips)
e3fa4802: posts small blind $0.1
33dc6448: posts big blind $0.25
*** HOLE CARDS ***
Dealt to d8ff3732 
Dealt to e3fa4802 
Dealt to 33dc6448 
Dealt to ca320935 
Dealt to Hero [Ad Jh]
Dealt to 73e63459 
ca320935: folds
Hero: raises $0.38 to $0.63
73e63459: folds
d8ff3732: folds
e3fa4802: calls $0.53
33dc6448: folds
*** FLOP *** [4d 8h Ks]
e3fa4802: checks
Hero: checks
*** TURN *** [4d 8h Ks] [8s]
e3fa4802: checks
Hero: checks
*** RIVER *** [4d 8h Ks 8s] [Ah]
e3fa4802: checks
Hero: bets $1.2
e3fa4802: folds
Uncalled bet ($1.2) returned to Hero
*** SHOWDOWN ***
Hero collected $1.51 from pot
*** SUMMARY ***
Total pot $1.51
Board [4d 8h Ks 8s Ah]
Seat 1: d8ff3732 (button) folded before Flop (didn't bet)
Seat 2: e3fa4802 (small blind) folded on the River
Seat 3: 33dc6448 (big blind) folded before Flop
Seat 4: ca320935 folded before Flop (didn't bet)
Seat 5: Hero won ($1.51)
Seat 6: 73e63459 folded before Flop (didn't bet)


Poker Hand #RC92814038: Hold'em No Limit ($0.1/$0.25) - 2020/04/03 00:04:30
Table 'RushAndCash47882' 6-max Seat #1 is the button
Seat 1: b912752f ($19.15 in chips)
Seat 2: 13078def ($25 in chips)
Seat 3: 6d33a0cb ($58.99 in chips)
Seat 4: a36379d9 ($25 in chips)
Seat 5: Hero ($28.41 in chips)
Seat 6: 40d3b492 ($25.51 in chips)
13078def: posts small blind $0.1
6d33a0cb: posts big blind $0.25
*** HOLE CARDS ***
Dealt to b912752f 
Dealt to 13078def 
Dealt to 6d33a0cb 
Dealt to a36379d9 
Dealt to Hero [Tc 6s]
Dealt to 40d3b492 
a36379d9: raises $0.38 to $0.63
Hero: folds
40d3b492: folds
b912752f: folds
13078def: calls $0.53
6d33a0cb: folds
*** FLOP *** [3d 6c 5h]
13078def: checks
a36379d9: checks
*** TURN *** [3d 6c 5h] [8d]
13078def: bets $0.25
a36379d9: folds
Uncalled bet ($0.25) returned to 13078def
*** SHOWDOWN ***
13078def collected $1.51 from pot
*** SUMMARY ***
Total pot $1.51
Board [3d 6c 5h 8d]
Seat 1: b912752f (button) folded before Flop (didn't bet)
Seat 2: 13078def (small blind) won ($1.51)
Seat 3: 6d33a0cb (big blind) folded before Flop
Seat 4: a36379d9 folded on the Turn
Seat 5: Hero folded before Flop (didn't bet)
Seat 6: 40d3b492 folded before Flop (didn't bet)


Poker Hand #RC92814062: Hold'em No Limit ($0.1/$0.25) - 2020/04/03 00:04:34
Table 'RushAndCash47884' 6-max Seat #1 is the button
Seat 1: e3fa4802 ($50.43 in chips)
Seat 2: dc9aea4f ($23.71 in chips)
Seat 3: Hero ($28.41 in chips)
Seat 4: 2117df3e ($17.97 in chips)
Seat 5: 44db54de ($74.25 in chips)
Seat 6: 89a3eced ($226.77 in chips)
dc9aea4f: posts small blind $0.1
Hero: posts big blind $0.25
*** HOLE CARDS ***
Dealt to e3fa4802 
Dealt to dc9aea4f 
Dealt to Hero [Jc 5s]
Dealt to 2117df3e 
Dealt to 44db54de 
Dealt to 89a3eced 
2117df3e: folds
44db54de: raises $0.38 to $0.63
89a3eced: calls $0.63
e3fa4802: folds
dc9aea4f: folds
Hero: folds
*** FLOP *** [Js 2c 8d]
44db54de: checks
89a3eced: bets $1
44db54de: folds
Uncalled bet ($1) returned to 89a3eced
*** SHOWDOWN ***
89a3eced collected $1.61 from pot
*** SUMMARY ***
Total pot $1.61
Board [Js 2c 8d]
Seat 1: e3fa4802 (button) folded before Flop (didn't bet)
Seat 2: dc9aea4f (small blind) folded before Flop
Seat 3: Hero (big blind) folded before Flop
Seat 4: 2117df3e folded before Flop (didn't bet)
Seat 5: 44db54de folded on the Flop
Seat 6: 89a3eced won ($1.61)


Poker Hand #RC92814094: Hold'em No Limit ($0.1/$0.25) - 2020/04/03 00:04:40
Table 'RushAndCash47886' 6-max Seat #1 is the button
Seat 1: 833dc1e7 ($99.42 in chips)
Seat 2: Hero ($28.16 in chips)
Seat 3: 5610efa8 ($21.1 in chips)
Seat 4: a44aa940 ($33.23 in chips)
Seat 5: fd2fdc90 ($25.88 in chips)
Seat 6: 52bba349 ($25 in chips)
Hero: posts small blind $0.1
5610efa8: posts big blind $0.25
*** HOLE CARDS ***
Dealt to 833dc1e7 
Dealt to Hero [7s 3s]
Dealt to 5610efa8 
Dealt to a44aa940 
Dealt to fd2fdc90 
Dealt to 52bba349 
a44aa940: folds
fd2fdc90: folds
52bba349: raises $0.38 to $0.63
833dc1e7: folds
Hero: folds
5610efa8: folds
Uncalled bet ($0.38) returned to 52bba349
*** SHOWDOWN ***
52bba349 collected $0.6 from pot
*** SUMMARY ***
Total pot $0.6
Seat 1: 833dc1e7 (button) folded before Flop (didn't bet)
Seat 2: Hero (small blind) folded before Flop
Seat 3: 5610efa8 (big blind) folded before Flop
Seat 4: a44aa940 folded before Flop (didn't bet)
Seat 5: fd2fdc90 folded before Flop (didn't bet)
Seat 6: 52bba349 collected ($0.6)


Poker Hand #RC92814173: Hold'em No Limit ($0.1/$0.25) - 2020/04/03 00:04:55
Table 'RushAndCash47890' 6-max Seat #1 is the button
Seat 1: e35929c8 ($19.04 in chips)
Seat 2: 33dc6448 ($27.89 in chips)
Seat 3: 833dc1e7 ($99.42 in chips)
Seat 4: 7eb96805 ($12.15 in chips)
Seat 5: deb72131 ($14.77 in chips)
Seat 6: Hero ($28.06 in chips)
33dc6448: posts small blind $0.1
833dc1e7: posts big blind $0.25
*** HOLE CARDS ***
Dealt to e35929c8 
Dealt to 33dc6448 
Dealt to 833dc1e7 
Dealt to 7eb96805 
Dealt to deb72131 
Dealt to Hero [4s 3s]
7eb96805: folds
deb72131: folds
Hero: folds
e35929c8: raises $0.38 to $0.63
33dc6448: raises $1.87 to $2.5
833dc1e7: folds
e35929c8: calls $1.87
*** FLOP *** [7h 2c Qs]
33dc6448: bets $1.8
e35929c8: folds
Uncalled bet ($1.8) returned to 33dc6448
*** SHOWDOWN ***
33dc6448 collected $5.25 from pot
*** SUMMARY ***
Total pot $5.25
Board [7h 2c Qs]
Seat 1: e35929c8 (button) folded on the Flop
Seat 2: 33dc6448 (small blind) won ($5.25)
Seat 3: 833dc1e7 (big blind) folded before Flop
Seat 4: 7eb96805 folded before Flop (didn't bet)
Seat 5: deb72131 folded before Flop (didn't bet)
Seat 6: Hero folded before Flop (didn't bet)


Poker Hand #RC92814195: Hold'em No Limit ($0.1/$0.25) - 2020/04/03 00:04:59
Table 'RushAndCash47892' 6-max Seat #1 is the button
Seat 1: Hero ($28.06 in chips)
Seat 2: b912752f ($19.15 in chips)
Seat 3: cbf0ae65 ($14.05 in chips)
Seat 4: 2117df3e ($17.97 in chips)
Seat 5: 37d48404 ($64.82 in chips)
Seat 6: 833dc1e7 ($99.17 in chips)
b912752f: posts small blind $0.1
cbf0ae65: posts big blind $0.25
*** HOLE CARDS ***
Dealt to Hero [7h 2h]
Dealt to b912752f 
Dealt to cbf0ae65 
Dealt to 2117df3e 
Dealt to 37d48404 
Dealt to 833dc1e7 
2117df3e: folds
37d48404: folds
833dc1e7: raises $0.5 to $0.75
Hero: folds
b912752f: folds
cbf0ae65: folds
Uncalled bet ($0.5) returned to 833dc1e7
*** SHOWDOWN ***
833dc1e7 collected $0.6 from pot
*** SUMMARY ***
Total pot $0.6
Seat 1: Hero (button) folded before Flop (didn't bet)
Seat 2: b912752f (small blind) folded before Flop
Seat 3: cbf0ae65 (big blind) folded before Flop
Seat 4: 2117df3e folded before Flop (didn't bet)
Seat 5: 37d48404 folded before Flop (didn't bet)
Seat 6: 833dc1e7 collected ($0.6)


Poker Hand #RC92814281: Hold'em No Limit ($0.1/$0.25) - 2020/04/03 00:05:16
Table 'RushAndCash47898' 6-max Seat #1 is the button
Seat 1: Hero ($28.06 in chips)
Seat 2: 44db54de ($73.62 in chips)
Seat 3: a6687bdc ($48.09 in chips)
Seat 4: 469ba291 ($34.35 in chips)
Seat 5: 2458c9bb ($30.24 in chips)
Seat 6: 30b9401d ($15.56 in chips)
44db54de: posts small blind $0.1
a6687bdc: posts big blind $0.25
*** HOLE CARDS ***
Dealt to Hero [9c 8c]
Dealt to 44db54de 
Dealt to a6687bdc 
Dealt to 469ba291 
Dealt to 2458c9bb 
Dealt to 30b9401d 
469ba291: folds
2458c9bb: folds
30b9401d: folds
Hero: raises $0.38 to $0.63
44db54de: folds
a6687bdc: folds
Uncalled bet ($0.38) returned to Hero
*** SHOWDOWN ***
Hero collected $0.6 from pot
*** SUMMARY ***
Total pot $0.6
Seat 1: Hero (button) collected ($0.6)
Seat 2: 44db54de (small blind) folded before Flop
Seat 3: a6687bdc (big blind) folded before Flop
Seat 4: 469ba291 folded before Flop (didn't bet)
Seat 5: 2458c9bb folded before Flop (didn't bet)
Seat 6: 30b9401d folded before Flop (didn't bet)


Poker Hand #RC92814363: Hold'em No Limit ($0.1/$0.25) - 2020/04/03 00:05:33
Table 'RushAndCash47908' 6-max Seat #1 is the button
Seat 1: 33dc6448 ($30.38 in chips)
Seat 2: 40123cec ($14.22 in chips)
Seat 3: 6d33a0cb ($56.59 in chips)
Seat 4: cbf0ae65 ($13.8 in chips)
Seat 5: 5136ebb4 ($49.9 in chips)
Seat 6: Hero ($28.41 in chips)
40123cec: posts small blind $0.1
6d33a0cb: posts big blind $0.25
*** HOLE CARDS ***
Dealt to 33dc6448 
Dealt to 40123cec 
Dealt to 6d33a0cb 
Dealt to cbf0ae65 
Dealt to 5136ebb4 
Dealt to Hero [Jc Ts]
cbf0ae65: folds
5136ebb4: folds
Hero: folds
33dc6448: folds
40123cec: folds
Uncalled bet ($0.15) returned to 6d33a0cb
*** SHOWDOWN ***
6d33a0cb collected $0.2 from pot
*** SUMMARY ***
Total pot $0.2
Seat 1: 33dc6448 (button) folded before Flop (didn't bet)
Seat 2: 40123cec (small blind) folded before Flop
Seat 3: 6d33a0cb (big blind) collected ($0.2)
Seat 4: cbf0ae65 folded before Flop (didn't bet)
Seat 5: 5136ebb4 folded before Flop (didn't bet)
Seat 6: Hero folded before Flop (didn't bet)


Poker Hand #RC92814397: Hold'em No Limit ($0.1/$0.25) - 2020/04/03 00:05:40
Table 'RushAndCash47911' 6-max Seat #1 is the button
Seat 1: a36379d9 ($25 in chips)
Seat 2: 40d3b492 ($25.51 in chips)
Seat 3: 1345d179 ($11.95 in chips)
Seat 4: ad3d6d15 ($26.3 in chips)
Seat 5: 13078def ($26.94 in chips)
Seat 6: Hero ($28.41 in chips)
40d3b492: posts small blind $0.1
1345d179: posts big blind $0.25
*** HOLE CARDS ***
Dealt to a36379d9 
Dealt to 40d3b492 
Dealt to 1345d179 
Dealt to ad3d6d15 
Dealt to 13078def 
Dealt to Hero [5d 3d]
ad3d6d15: folds
13078def: folds
Hero: folds
a36379d9: folds
40d3b492: raises $0.5 to $0.75
1345d179: folds
Uncalled bet ($0.5) returned to 40d3b492
*** SHOWDOWN ***
40d3b492 collected $0.5 from pot
*** SUMMARY ***
Total pot $0.5
Seat 1: a36379d9 (button) folded before Flop (didn't bet)
Seat 2: 40d3b492 (small blind) collected ($0.5)
Seat 3: 1345d179 (big blind) folded before Flop
Seat 4: ad3d6d15 folded before Flop (didn't bet)
Seat 5: 13078def folded before Flop (didn't bet)
Seat 6: Hero folded before Flop (didn't bet)


Poker Hand #RC92814448: Hold'em No Limit ($0.1/$0.25) - 2020/04/03 00:05:49
Table 'RushAndCash47916' 6-max Seat #1 is the button
Seat 1: 30b9401d ($15.31 in chips)
Seat 2: 469ba291 ($34.1 in chips)
Seat 3: a36379d9 ($25 in chips)
Seat 4: 5610efa8 ($20.5 in chips)
Seat 5: 5136ebb4 ($49.55 in chips)
Seat 6: Hero ($28.41 in chips)
469ba291: posts small blind $0.1
a36379d9: posts big blind $0.25
*** HOLE CARDS ***
Dealt to 30b9401d 
Dealt to 469ba291 
Dealt to a36379d9 
Dealt to 5610efa8 
Dealt to 5136ebb4 
Dealt to Hero [Jc 4h]
5610efa8: folds
5136ebb4: folds
Hero: folds
30b9401d: folds
469ba291: raises $0.75 to $1
a36379d9: folds
Uncalled bet ($0.75) returned to 469ba291
*** SHOWDOWN ***
469ba291 collected $0.5 from pot
*** SUMMARY ***
Total pot $0.5
Seat 1: 30b9401d (button) folded before Flop (didn't bet)
Seat 2: 469ba291 (small blind) collected ($0.5)
Seat 3: a36379d9 (big blind) folded before Flop
Seat 4: 5610efa8 folded before Flop (didn't bet)
Seat 5: 5136ebb4 folded before Flop (didn't bet)
Seat 6: Hero folded before Flop (didn't bet)


Poker Hand #RC92814476: Hold'em No Limit ($0.1/$0.25) - 2020/04/03 00:05:55
Table 'RushAndCash47919' 6-max Seat #1 is the button
Seat 1: 6d33a0cb ($56.59 in chips)
Seat 2: Hero ($28.41 in chips)
Seat 3: d8ff3732 ($57.51 in chips)
Seat 4: b912752f ($18.7 in chips)
Seat 5: 2117df3e ($18.98 in chips)
Seat 6: 33dc6448 ($30.28 in chips)
Hero: posts small blind $0.1
d8ff3732: posts big blind $0.25
*** HOLE CARDS ***
Dealt to 6d33a0cb 
Dealt to Hero [Kh 7s]
Dealt to d8ff3732 
Dealt to b912752f 
Dealt to 2117df3e 
Dealt to 33dc6448 
b912752f: folds
2117df3e: folds
33dc6448: folds
6d33a0cb: folds
Hero: folds
Uncalled bet ($0.15) returned to d8ff3732
*** SHOWDOWN ***
d8ff3732 collected $0.2 from pot
*** SUMMARY ***
Total pot $0.2
Seat 1: 6d33a0cb (button) folded before Flop (didn't bet)
Seat 2: Hero (small blind) folded before Flop
Seat 3: d8ff3732 (big blind) collected ($0.2)
Seat 4: b912752f folded before Flop (didn't bet)
Seat 5: 2117df3e folded before Flop (didn't bet)
Seat 6: 33dc6448 folded before Flop (didn't bet)


Poker Hand #RC92814498: Hold'em No Limit ($0.1/$0.25) - 2020/04/03 00:05:59
Table 'RushAndCash47922' 6-max Seat #1 is the button
Seat 1: 6d33a0cb ($56.59 in chips)
Seat 2: 25bc93df ($12.5 in chips)
Seat 3: Hero ($28.31 in chips)
Seat 4: 33dc6448 ($30.28 in chips)
Seat 5: 3f0546a3 ($24.65 in chips)
Seat 6: a1320bd6 ($64.88 in chips)
25bc93df: posts small blind $0.1
Hero: posts big blind $0.25
*** HOLE CARDS ***
Dealt to 6d33a0cb 
Dealt to 25bc93df 
Dealt to Hero [5h 4s]
Dealt to 33dc6448 
Dealt to 3f0546a3 
Dealt to a1320bd6 
33dc6448: folds
3f0546a3: raises $0.38 to $0.63
a1320bd6: folds
6d33a0cb: folds
25bc93df: folds
Hero: folds
Uncalled bet ($0.38) returned to 3f0546a3
*** SHOWDOWN ***
3f0546a3 collected $0.6 from pot
*** SUMMARY ***
Total pot $0.6
Seat 1: 6d33a0cb (button) folded before Flop (didn't bet)
Seat 2: 25bc93df (small blind) folded before Flop
Seat 3: Hero (big blind) folded before Flop
Seat 4: 33dc6448 folded before Flop (didn't bet)
Seat 5: 3f0546a3 collected ($0.6)
Seat 6: a1320bd6 folded before Flop (didn't bet)


Poker Hand #RC92814516: Hold'em No Limit ($0.1/$0.25) - 2020/04/03 00:06:03
Table 'RushAndCash47924' 6-max Seat #1 is the button
Seat 1: a44aa940 ($33.8 in chips)
Seat 2: 5610efa8 ($20.25 in chips)
Seat 3: b912752f ($18.7 in chips)
Seat 4: 6d33a0cb ($56.59 in chips)
Seat 5: 97dacd30 ($10.48 in chips)
Seat 6: Hero ($28.06 in chips)
5610efa8: posts small blind $0.1
b912752f: posts big blind $0.25
*** HOLE CARDS ***
Dealt to a44aa940 
Dealt to 5610efa8 
Dealt to b912752f 
Dealt to 6d33a0cb 
Dealt to 97dacd30 
Dealt to Hero [Th 4d]
6d33a0cb: raises $0.38 to $0.63
97dacd30: folds
Hero: folds
a44aa940: folds
5610efa8: folds
b912752f: calls $0.38
*** FLOP *** [4c Ad 2d]
b912752f: checks
6d33a0cb: bets $0.9
b912752f: folds
Uncalled bet ($0.9) returned to 6d33a0cb
*** SHOWDOWN ***
6d33a0cb collected $1.36 from pot
*** SUMMARY ***
Total pot $1.36
Board [4c Ad 2d]
Seat 1: a44aa940 (button) folded before Flop (didn't bet)
Seat 2: 5610efa8 (small blind) folded before Flop
Seat 3: b912752f (big blind) folded on the Flop
Seat 4: 6d33a0cb won ($1.36)
Seat 5: 97dacd30 folded before Flop (didn't bet)
Seat 6: Hero folded before Flop (didn't bet)


Poker Hand #RC92814530: Hold'em No Limit ($0.1/$0.25) - 2020/04/03 00:06:06
Table 'RushAndCash47926' 6-max Seat #1 is the button
Seat 1: deb72131 ($14.37 in chips)
Seat 2: d8ff3732 ($57.61 in chips)
Seat 3: 33dc6448 ($30.28 in chips)
Seat 4: e3fa4802 ($51.46 in chips)
Seat 5: Hero ($28.06 in chips)
Seat 6: a6687bdc ($46.59 in chips)
d8ff3732: posts small blind $0.1
33dc6448: posts big blind $0.25
*** HOLE CARDS ***
Dealt to deb72131 
Dealt to d8ff3732 
Dealt to 33dc6448 
Dealt to e3fa4802 
Dealt to Hero [Qd Jh]
Dealt to a6687bdc 
e3fa4802: folds
Hero: folds
a6687bdc: folds
deb72131: folds
d8ff3732: folds
Uncalled bet ($0.15) returned to 33dc6448
*** SHOWDOWN ***
33dc6448 collected $0.2 from pot
*** SUMMARY ***
Total pot $0.2
Seat 1: deb72131 (button) folded before Flop (didn't bet)
Seat 2: d8ff3732 (small blind) folded before Flop
Seat 3: 33dc6448 (big blind) collected ($0.2)
Seat 4: e3fa4802 folded before Flop (didn't bet)
Seat 5: Hero folded before Flop (didn't bet)
Seat 6: a6687bdc folded before Flop (didn't bet)


Poker Hand #RC92814559: Hold'em No Limit ($0.1/$0.25) - 2020/04/03 00:06:11
Table 'RushAndCash47930' 6-max Seat #1 is the button
Seat 1: d8ff3732 ($57.51 in chips)
Seat 2: Hero ($28.06 in chips)
Seat 3: 7eb96805 ($12.05 in chips)
Seat 4: a6687bdc ($46.59 in chips)
Seat 5: e3fa4802 ($51.46 in chips)
Seat 6: deb72131 ($14.37 in chips)
Hero: posts small blind $0.1
7eb96805: posts big blind $0.25
*** HOLE CARDS ***
Dealt to d8ff3732 
Dealt to Hero [Td 2c]
Dealt to 7eb96805 
Dealt to a6687bdc 
Dealt to e3fa4802 
Dealt to deb72131 
a6687bdc: folds
e3fa4802: calls $0.25
deb72131: folds
d8ff3732: folds
Hero: folds
7eb96805: checks
*** FLOP *** [Jh 9c 8h]
7eb96805: checks
e3fa4802: bets $0.4
7eb96805: folds
Uncalled bet ($0.4) returned to e3fa4802
*** SHOWDOWN ***
e3fa4802 collected $0.6 from pot
*** SUMMARY ***
Total pot $0.6
Board [Jh 9c 8h]
Seat 1: d8ff3732 (button) folded before Flop (didn't bet)
Seat 2: Hero (small blind) folded before Flop
Seat 3: 7eb96805 (big blind) folded on the Flop
Seat 4: a6687bdc folded before Flop (didn't bet)
Seat 5: e3fa4802 won ($0.6)
Seat 6: deb72131 folded before Flop (didn't bet)


Poker Hand #RC92814571: Hold'em No Limit ($0.1/$0.25) - 2020/04/03 00:06:14
Table 'RushAndCash47932' 6-max Seat #1 is the button
Seat 1: 37d48404 ($63.69 in chips)
Seat 2: 36f1561e ($32.27 in chips)
Seat 3: cf7dd2d7 ($24.65 in chips)
Seat 4: Hero ($27.96 in chips)
Seat 5: 1345d179 ($11.6 in chips)
Seat 6: 87518009 ($25.35 in chips)
36f1561e: posts small blind $0.1
cf7dd2d7: posts big blind $0.25
*** HOLE CARDS ***
Dealt to 37d48404 
Dealt to 36f1561e 
Dealt to cf7dd2d7 
Dealt to Hero [8s 6d]
Dealt to 1345d179 
Dealt to 87518009 
Hero: folds
1345d179: folds
87518009: folds
37d48404: folds
36f1561e: folds
Uncalled bet ($0.15) returned to cf7dd2d7
*** SHOWDOWN ***
cf7dd2d7 collected $0.2 from pot
*** SUMMARY ***
Total pot $0.2
Seat 1: 37d48404 (button) folded before Flop (didn't bet)
Seat 2: 36f1561e (small blind) folded before Flop
Seat 3: cf7dd2d7 (big blind) collected ($0.2)
Seat 4: Hero folded before Flop (didn't bet)
Seat 5: 1345d179 folded before Flop (didn't bet)
Seat 6: 87518009 folded before Flop (didn't bet)


Poker Hand #RC92814585: Hold'em No Limit ($0.1/$0.25) - 2020/04/03 00:06:16
Table 'RushAndCash47934' 6-max Seat #1 is the button
Seat 1: Hero ($27.96 in chips)
Seat 2: 44db54de ($73.62 in chips)
Seat 3: b20a2692 ($25 in chips)
Seat 4: 469ba291 ($34.35 in chips)
Seat 5: d666e396 ($25.13 in chips)
Seat 6: 5610efa8 ($20.15 in chips)
44db54de: posts small blind $0.1
b20a2692: posts big blind $0.25
*** HOLE CARDS ***
Dealt to Hero [Ad Js]
Dealt to 44db54de 
Dealt to b20a2692 
Dealt to 469ba291 
Dealt to d666e396 
Dealt to 5610efa8 
469ba291: folds
d666e396: folds
5610efa8: folds
Hero: raises $0.38 to $0.63
44db54de: folds
b20a2692: calls $0.38
*** FLOP *** [6c 9c 5d]
b20a2692: checks
Hero: checks
*** TURN *** [6c 9c 5d] [5h]
b20a2692: bets $0.7
Hero: folds
Uncalled bet ($0.7) returned to b20a2692
*** SHOWDOWN ***
b20a2692 collected $1.36 from pot
*** SUMMARY ***
Total pot $1.36
Board [6c 9c 5d 5h]
Seat 1: Hero (button) folded on the Turn
Seat 2: 44db54de (small blind) folded before Flop
Seat 3: b20a2692 (big blind) won ($1.36)
Seat 4: 469ba291 folded before Flop (didn't bet)
Seat 5: d666e396 folded before Flop (didn't bet)
Seat 6: 5610efa8 folded before Flop (didn't bet)


Poker Hand #RC92814724: Hold'em No Limit ($0.1/$0.25) - 2020/04/03 00:06:45
Table 'RushAndCash47949' 6-max Seat #1 is the button
Seat 1: bb9a5aea ($11.94 in chips)
Seat 2: b20a2692 ($25.67 in chips)
Seat 3: Hero ($27.33 in chips)
Seat 4: 40d3b492 ($26.43 in chips)
Seat 5: 87518009 ($25 in chips)
Seat 6: a36379d9 ($25.1 in chips)
b20a2692: posts small blind $0.1
Hero: posts big blind $0.25
*** HOLE CARDS ***
Dealt to bb9a5aea 
Dealt to b20a2692 
Dealt to Hero [Jd 9s]
Dealt to 40d3b492 
Dealt to 87518009 
Dealt to a36379d9 
40d3b492: folds
87518009: folds
a36379d9: folds
bb9a5aea: folds
b20a2692: folds
Uncalled bet ($0.15) returned to Hero
*** SHOWDOWN ***
Hero collected $0.2 from pot
*** SUMMARY ***
Total pot $0.2
Seat 1: bb9a5aea (button) folded before Flop (didn't bet)
Seat 2: b20a2692 (small blind) folded before Flop
Seat 3: Hero (big blind) collected ($0.2)
Seat 4: 40d3b492 folded before Flop (didn't bet)
Seat 5: 87518009 folded before Flop (didn't bet)
Seat 6: a36379d9 folded before Flop (didn't bet)


Poker Hand #RC92814750: Hold'em No Limit ($0.1/$0.25) - 2020/04/03 00:06:49
Table 'RushAndCash47951' 6-max Seat #1 is the button
Seat 1: 48027635 ($24.65 in chips)
Seat 2: 30b9401d ($14.96 in chips)
Seat 3: f19292be ($67.65 in chips)
Seat 4: Hero ($27.08 in chips)
Seat 5: 87518009 ($25 in chips)
Seat 6: 36f1561e ($32.52 in chips)
30b9401d: posts small blind $0.1
f19292be: posts big blind $0.25
*** HOLE CARDS ***
Dealt to 48027635 
Dealt to 30b9401d 
Dealt to f19292be 
Dealt to Hero [Qd 2h]
Dealt to 87518009 
Dealt to 36f1561e 
Hero: folds
87518009: raises $0.38 to $0.63
36f1561e: folds
48027635: raises $1.07 to $1.7
30b9401d: folds
f19292be: folds
87518009: calls $1.07
*** FLOP *** [4d 5s 2c]
87518009: checks
48027635: bets $2.5
87518009: calls $2.5
*** TURN *** [4d 5s 2c] [4h]
87518009: checks
48027635: bets $2.9
87518009: calls $2.9
*** RIVER *** [4d 5s 2c 4h] [7s]
87518009: checks
48027635: checks
87518009: shows [Ad 5d] (Pair of Fives and Pair of Fours)
48027635: shows [Jh Jc] (Pair of Jacks and Pair of Fours)
*** SHOWDOWN ***
48027635 collected $14.55 from pot
*** SUMMARY ***
Total pot $14.55
Board [4d 5s 2c 4h 7s]
Seat 1: 48027635 (button) showed [Jh Jc] and won ($14.55) with Pair of Jacks and Pair of Fours
Seat 2: 30b9401d (small blind) folded before Flop
Seat 3: f19292be (big blind) folded before Flop
Seat 4: Hero folded before Flop (didn't bet)
Seat 5: 87518009 showed [Ad 5d] and lost with Pair of Fives and Pair of Fours
Seat 6: 36f1561e folded before Flop (didn't bet)


Poker Hand #RC92814770: Hold'em No Limit ($0.1/$0.25) - 2020/04/03 00:06:53
Table 'RushAndCash47954' 6-max Seat #1 is the button
Seat 1: b20a2692 ($25.57 in chips)
Seat 2: 5610efa8 ($19.52 in chips)
Seat 3: f032dc5a ($15.79 in chips)
Seat 4: Hero ($27.08 in chips)
Seat 5: b289f27a ($25.53 in chips)
Seat 6: b912752f ($17.97 in chips)
5610efa8: posts small blind $0.1
f032dc5a: posts big blind $0.25
*** HOLE CARDS ***
Dealt to b20a2692 
Dealt to 5610efa8 
Dealt to f032dc5a 
Dealt to Hero [Td 2c]
Dealt to b289f27a 
Dealt to b912752f 
Hero: folds
b289f27a: folds
b912752f: raises $0.5 to $0.75
b20a2692: folds
5610efa8: folds
f032dc5a: folds
Uncalled bet ($0.5) returned to b912752f
*** SHOWDOWN ***
b912752f collected $0.6 from pot
*** SUMMARY ***
Total pot $0.6
Seat 1: b20a2692 (button) folded before Flop (didn't bet)
Seat 2: 5610efa8 (small blind) folded before Flop
Seat 3: f032dc5a (big blind) folded before Flop
Seat 4: Hero folded before Flop (didn't bet)
Seat 5: b289f27a folded before Flop (didn't bet)
Seat 6: b912752f collected ($0.6)


Poker Hand #RC92814803: Hold'em No Limit ($0.1/$0.25) - 2020/04/03 00:06:59
Table 'RushAndCash47956' 6-max Seat #1 is the button
Seat 1: c204bed8 ($36.2 in chips)
Seat 2: f19292be ($67.4 in chips)
Seat 3: 5610efa8 ($19.42 in chips)
Seat 4: 6d33a0cb ($57.01 in chips)
Seat 5: b289f27a ($25.53 in chips)
Seat 6: Hero ($27.43 in chips)
f19292be: posts small blind $0.1
5610efa8: posts big blind $0.25
*** HOLE CARDS ***
Dealt to c204bed8 
Dealt to f19292be 
Dealt to 5610efa8 
Dealt to 6d33a0cb 
Dealt to b289f27a 
Dealt to Hero [Ah 5h]
6d33a0cb: raises $0.38 to $0.63
b289f27a: raises $1.63 to $2.26
Hero: folds
c204bed8: folds
f19292be: folds
5610efa8: raises $17.16 to $19.42 and is all-in
6d33a0cb: folds
b289f27a: calls $17.16
5610efa8: shows [Kh Kc]
b289f27a: shows [Jd Jh]
*** FLOP *** [6h Td Js]
b289f27a: get an all-in insurance (premium ($0/$1.22/$0) for ($0/$19.52/$0) - (Mandatory/Main/Sub))
*** TURN *** [6h Td Js] [4d]
b289f27a: pay premium of all-in insurance ($1.22)
b289f27a: get an all-in insurance (premium ($0/$1.3/$0) for ($0/$20.8/$0) - (Mandatory/Main/Sub))
*** RIVER *** [6h Td Js 4d] [Qc]
b289f27a: pay premium of all-in insurance ($1.3)
*** SHOWDOWN ***
b289f27a collected $39.57 from pot
*** SUMMARY ***
Total pot $39.57
Board [6h Td Js 4d Qc]
Seat 1: c204bed8 (button) folded before Flop (didn't bet)
Seat 2: f19292be (small blind) folded before Flop
Seat 3: 5610efa8 (big blind) showed [Kh Kc] and lost with Pair of Kings
Seat 4: 6d33a0cb folded before Flop
Seat 5: b289f27a showed [Jh Jd] and won ($39.57) with Three Jacks, AII Premium ($2.52)
Seat 6: Hero folded before Flop (didn't bet)


Poker Hand #RC92814880: Hold'em No Limit ($0.1/$0.25) - 2020/04/03 00:07:16
Table 'RushAndCash47961' 6-max Seat #1 is the button
Seat 1: e3fa4802 ($51.78 in chips)
Seat 2: Hero ($27.43 in chips)
Seat 3: 52bba349 ($25.35 in chips)
Seat 4: d8ff3732 ($56.06 in chips)
Seat 5: cbf0ae65 ($13.17 in chips)
Seat 6: f19292be ($67.3 in chips)
Hero: posts small blind $0.1
52bba349: posts big blind $0.25
*** HOLE CARDS ***
Dealt to e3fa4802 
Dealt to Hero [Qd 9h]
Dealt to 52bba349 
Dealt to d8ff3732 
Dealt to cbf0ae65 
Dealt to f19292be 
d8ff3732: folds
cbf0ae65: folds
f19292be: folds
e3fa4802: folds
Hero: folds
Uncalled bet ($0.15) returned to 52bba349
*** SHOWDOWN ***
52bba349 collected $0.2 from pot
*** SUMMARY ***
Total pot $0.2
Seat 1: e3fa4802 (button) folded before Flop (didn't bet)
Seat 2: Hero (small blind) folded before Flop
Seat 3: 52bba349 (big blind) collected ($0.2)
Seat 4: d8ff3732 folded before Flop (didn't bet)
Seat 5: cbf0ae65 folded before Flop (didn't bet)
Seat 6: f19292be folded before Flop (didn't bet)


Poker Hand #RC92814922: Hold'em No Limit ($0.1/$0.25) - 2020/04/03 00:07:24
Table 'RushAndCash47964' 6-max Seat #1 is the button
Seat 1: ad3d6d15 ($26.87 in chips)
Seat 2: e3fa4802 ($51.78 in chips)
Seat 3: Hero ($27.33 in chips)
Seat 4: b20a2692 ($25.57 in chips)
Seat 5: d8ff3732 ($56.06 in chips)
Seat 6: 7eb96805 ($11.8 in chips)
e3fa4802: posts small blind $0.1
Hero: posts big blind $0.25
*** HOLE CARDS ***
Dealt to ad3d6d15 
Dealt to e3fa4802 
Dealt to Hero [5h 4c]
Dealt to b20a2692 
Dealt to d8ff3732 
Dealt to 7eb96805 
b20a2692: folds
d8ff3732: folds
7eb96805: raises $0.38 to $0.63
ad3d6d15: folds
e3fa4802: folds
Hero: folds
Uncalled bet ($0.38) returned to 7eb96805
*** SHOWDOWN ***
7eb96805 collected $0.6 from pot
*** SUMMARY ***
Total pot $0.6
Seat 1: ad3d6d15 (button) folded before Flop (didn't bet)
Seat 2: e3fa4802 (small blind) folded before Flop
Seat 3: Hero (big blind) folded before Flop
Seat 4: b20a2692 folded before Flop (didn't bet)
Seat 5: d8ff3732 folded before Flop (didn't bet)
Seat 6: 7eb96805 collected ($0.6)


Poker Hand #RC92814953: Hold'em No Limit ($0.1/$0.25) - 2020/04/03 00:07:30
Table 'RushAndCash47967' 6-max Seat #1 is the button
Seat 1: Hero ($27.08 in chips)
Seat 2: 1345d179 ($11.1 in chips)
Seat 3: d8ff3732 ($56.06 in chips)
Seat 4: 52bba349 ($25.45 in chips)
Seat 5: 37d48404 ($63.34 in chips)
Seat 6: ad3d6d15 ($26.87 in chips)
1345d179: posts small blind $0.1
d8ff3732: posts big blind $0.25
*** HOLE CARDS ***
Dealt to Hero [Kh 2h]
Dealt to 1345d179 
Dealt to d8ff3732 
Dealt to 52bba349 
Dealt to 37d48404 
Dealt to ad3d6d15 
52bba349: folds
37d48404: folds
ad3d6d15: raises $0.5 to $0.75
Hero: folds
1345d179: folds
d8ff3732: folds
Uncalled bet ($0.5) returned to ad3d6d15
*** SHOWDOWN ***
ad3d6d15 collected $0.6 from pot
*** SUMMARY ***
Total pot $0.6
Seat 1: Hero (button) folded before Flop (didn't bet)
Seat 2: 1345d179 (small blind) folded before Flop
Seat 3: d8ff3732 (big blind) folded before Flop
Seat 4: 52bba349 folded before Flop (didn't bet)
Seat 5: 37d48404 folded before Flop (didn't bet)
Seat 6: ad3d6d15 collected ($0.6)


Poker Hand #RC92814977: Hold'em No Limit ($0.1/$0.25) - 2020/04/03 00:07:34
Table 'RushAndCash47970' 6-max Seat #1 is the button
Seat 1: 2117df3e ($16.43 in chips)
Seat 2: d8ff3732 ($55.81 in chips)
Seat 3: a44aa940 ($35.49 in chips)
Seat 4: 40d3b492 ($27.55 in chips)
Seat 5: Hero ($27.08 in chips)
Seat 6: a36379d9 ($25 in chips)
d8ff3732: posts small blind $0.1
a44aa940: posts big blind $0.25
*** HOLE CARDS ***
Dealt to 2117df3e 
Dealt to d8ff3732 
Dealt to a44aa940 
Dealt to 40d3b492 
Dealt to Hero [Jc 3d]
Dealt to a36379d9 
40d3b492: folds
Hero: folds
a36379d9: raises $0.38 to $0.63
2117df3e: folds
d8ff3732: folds
a44aa940: folds
Uncalled bet ($0.38) returned to a36379d9
*** SHOWDOWN ***
a36379d9 collected $0.6 from pot
*** SUMMARY ***
Total pot $0.6
Seat 1: 2117df3e (button) folded before Flop (didn't bet)
Seat 2: d8ff3732 (small blind) folded before Flop
Seat 3: a44aa940 (big blind) folded before Flop
Seat 4: 40d3b492 folded before Flop (didn't bet)
Seat 5: Hero folded before Flop (didn't bet)
Seat 6: a36379d9 collected ($0.6)


Poker Hand #RC92814997: Hold'em No Limit ($0.1/$0.25) - 2020/04/03 00:07:38
Table 'RushAndCash47973' 6-max Seat #1 is the button
Seat 1: d8ff3732 ($55.71 in chips)
Seat 2: Hero ($27.08 in chips)
Seat 3: f43af171 ($25 in chips)
Seat 4: 3f0546a3 ($26.3 in chips)
Seat 5: 37d48404 ($63.34 in chips)
Seat 6: f032dc5a ($15.44 in chips)
Hero: posts small blind $0.1
f43af171: posts big blind $0.25
*** HOLE CARDS ***
Dealt to d8ff3732 
Dealt to Hero [Ad 6h]
Dealt to f43af171 
Dealt to 3f0546a3 
Dealt to 37d48404 
Dealt to f032dc5a 
3f0546a3: folds
37d48404: raises $0.38 to $0.63
f032dc5a: folds
d8ff3732: folds
Hero: folds
f43af171: calls $0.38
*** FLOP *** [Jh Ac 9s]
f43af171: checks
37d48404: checks
*** TURN *** [Jh Ac 9s] [5h]
f43af171: bets $0.9
37d48404: calls $0.9
*** RIVER *** [Jh Ac 9s 5h] [Th]
f43af171: checks
37d48404: checks
f43af171: shows [9h Js] (Pair of Jacks and Pair of Nines)
37d48404: shows [7h 7s] (Pair of Sevens)
*** SHOWDOWN ***
f43af171 collected $3.16 from pot
*** SUMMARY ***
Total pot $3.16
Board [Jh Ac 9s 5h Th]
Seat 1: d8ff3732 (button) folded before Flop (didn't bet)
Seat 2: Hero (small blind) folded before Flop
Seat 3: f43af171 (big blind) showed [Js 9h] and won ($3.16) with Pair of Jacks and Pair of Nines
Seat 4: 3f0546a3 folded before Flop (didn't bet)
Seat 5: 37d48404 showed [7s 7h] and lost with Pair of Sevens
Seat 6: f032dc5a folded before Flop (didn't bet)


Poker Hand #RC92815018: Hold'em No Limit ($0.1/$0.25) - 2020/04/03 00:07:41
Table 'RushAndCash47976' 6-max Seat #1 is the button
Seat 1: 1345d179 ($11 in chips)
Seat 2: fd2fdc90 ($25 in chips)
Seat 3: Hero ($26.98 in chips)
Seat 4: a957a98a ($24.85 in chips)
Seat 5: 833dc1e7 ($111.87 in chips)
Seat 6: d8ff3732 ($55.71 in chips)
fd2fdc90: posts small blind $0.1
Hero: posts big blind $0.25
*** HOLE CARDS ***
Dealt to 1345d179 
Dealt to fd2fdc90 
Dealt to Hero [Kc Th]
Dealt to a957a98a 
Dealt to 833dc1e7 
Dealt to d8ff3732 
a957a98a: folds
833dc1e7: folds
d8ff3732: raises $0.5 to $0.75
1345d179: folds
fd2fdc90: folds
Hero: folds
Uncalled bet ($0.5) returned to d8ff3732
*** SHOWDOWN ***
d8ff3732 collected $0.6 from pot
*** SUMMARY ***
Total pot $0.6
Seat 1: 1345d179 (button) folded before Flop (didn't bet)
Seat 2: fd2fdc90 (small blind) folded before Flop
Seat 3: Hero (big blind) folded before Flop
Seat 4: a957a98a folded before Flop (didn't bet)
Seat 5: 833dc1e7 folded before Flop (didn't bet)
Seat 6: d8ff3732 collected ($0.6)


Poker Hand #RC92815081: Hold'em No Limit ($0.1/$0.25) - 2020/04/03 00:07:53
Table 'RushAndCash47983' 6-max Seat #1 is the button
Seat 1: Hero ($26.73 in chips)
Seat 2: deb72131 ($15.97 in chips)
Seat 3: b20a2692 ($25.57 in chips)
Seat 4: a36379d9 ($25.35 in chips)
Seat 5: 36f1561e ($32.17 in chips)
Seat 6: db9c5b71 ($25 in chips)
deb72131: posts small blind $0.1
b20a2692: posts big blind $0.25
*** HOLE CARDS ***
Dealt to Hero [9s 6c]
Dealt to deb72131 
Dealt to b20a2692 
Dealt to a36379d9 
Dealt to 36f1561e 
Dealt to db9c5b71 
a36379d9: folds
36f1561e: folds
db9c5b71: folds
Hero: folds
deb72131: raises $0.5 to $0.75
b20a2692: calls $0.5
*** FLOP *** [Js 4s 5c]
deb72131: bets $1.2
b20a2692: calls $1.2
*** TURN *** [Js 4s 5c] [As]
deb72131: checks
b20a2692: checks
*** RIVER *** [Js 4s 5c As] [Kh]
deb72131: bets $2
b20a2692: calls $2
deb72131: shows [Jc Kd] (Pair of Kings and Pair of Jacks)
b20a2692: shows [4d Ad] (Pair of Aces and Pair of Fours)
*** SHOWDOWN ***
b20a2692 collected $7.9 from pot
*** SUMMARY ***
Total pot $7.9
Board [Js 4s 5c As Kh]
Seat 1: Hero (button) folded before Flop (didn't bet)
Seat 2: deb72131 (small blind) showed [Kd Jc] and lost with Pair of Kings and Pair of Jacks
Seat 3: b20a2692 (big blind) showed [Ad 4d] and won ($7.9) with Pair of Aces and Pair of Fours
Seat 4: a36379d9 folded before Flop (didn't bet)
Seat 5: 36f1561e folded before Flop (didn't bet)
Seat 6: db9c5b71 folded before Flop (didn't bet)


Poker Hand #RC92815145: Hold'em No Limit ($0.1/$0.25) - 2020/04/03 00:08:06
Table 'RushAndCash47991' 6-max Seat #1 is the button
Seat 1: fd2fdc90 ($25 in chips)
Seat 2: d8ff3732 ($56.06 in chips)
Seat 3: cf7dd2d7 ($33.63 in chips)
Seat 4: f032dc5a ($15.44 in chips)
Seat 5: e35929c8 ($15.56 in chips)
Seat 6: Hero ($26.73 in chips)
d8ff3732: posts small blind $0.1
cf7dd2d7: posts big blind $0.25
*** HOLE CARDS ***
Dealt to fd2fdc90 
Dealt to d8ff3732 
Dealt to cf7dd2d7 
Dealt to f032dc5a 
Dealt to e35929c8 
Dealt to Hero [Qc 6d]
f032dc5a: folds
e35929c8: raises $0.38 to $0.63
Hero: folds
fd2fdc90: folds
d8ff3732: folds
cf7dd2d7: folds
Uncalled bet ($0.38) returned to e35929c8
*** SHOWDOWN ***
e35929c8 collected $0.6 from pot
*** SUMMARY ***
Total pot $0.6
Seat 1: fd2fdc90 (button) folded before Flop (didn't bet)
Seat 2: d8ff3732 (small blind) folded before Flop
Seat 3: cf7dd2d7 (big blind) folded before Flop
Seat 4: f032dc5a folded before Flop (didn't bet)
Seat 5: e35929c8 collected ($0.6)
Seat 6: Hero folded before Flop (didn't bet)


Poker Hand #RC92815176: Hold'em No Limit ($0.1/$0.25) - 2020/04/03 00:08:12
Table 'RushAndCash47994' 6-max Seat #1 is the button
Seat 1: a44aa940 ($35.47 in chips)
Seat 2: 87518009 ($25.1 in chips)
Seat 3: 3f0546a3 ($26.3 in chips)
Seat 4: 33dc6448 ($25 in chips)
Seat 5: 2117df3e ($16.33 in chips)
Seat 6: Hero ($26.73 in chips)
87518009: posts small blind $0.1
3f0546a3: posts big blind $0.25
*** HOLE CARDS ***
Dealt to a44aa940 
Dealt to 87518009 
Dealt to 3f0546a3 
Dealt to 33dc6448 
Dealt to 2117df3e 
Dealt to Hero [Td 3d]
33dc6448: folds
2117df3e: folds
Hero: folds
a44aa940: folds
87518009: folds
Uncalled bet ($0.15) returned to 3f0546a3
*** SHOWDOWN ***
3f0546a3 collected $0.2 from pot
*** SUMMARY ***
Total pot $0.2
Seat 1: a44aa940 (button) folded before Flop (didn't bet)
Seat 2: 87518009 (small blind) folded before Flop
Seat 3: 3f0546a3 (big blind) collected ($0.2)
Seat 4: 33dc6448 folded before Flop (didn't bet)
Seat 5: 2117df3e folded before Flop (didn't bet)
Seat 6: Hero folded before Flop (didn't bet)


Poker Hand #RC92815216: Hold'em No Limit ($0.1/$0.25) - 2020/04/03 00:08:21
Table 'RushAndCash47997' 6-max Seat #1 is the button
Seat 1: 25bc93df ($13.05 in chips)
Seat 2: cf7dd2d7 ($33.38 in chips)
Seat 3: 30b9401d ($14.61 in chips)
Seat 4: 13078def ($25.55 in chips)
Seat 5: Hero ($26.73 in chips)
Seat 6: a36379d9 ($25 in chips)
cf7dd2d7: posts small blind $0.1
30b9401d: posts big blind $0.25
*** HOLE CARDS ***
Dealt to 25bc93df 
Dealt to cf7dd2d7 
Dealt to 30b9401d 
Dealt to 13078def 
Dealt to Hero [7d 2s]
Dealt to a36379d9 
13078def: folds
Hero: folds
a36379d9: folds
25bc93df: folds
cf7dd2d7: folds
Uncalled bet ($0.15) returned to 30b9401d
*** SHOWDOWN ***
30b9401d collected $0.2 from pot
*** SUMMARY ***
Total pot $0.2
Seat 1: 25bc93df (button) folded before Flop (didn't bet)
Seat 2: cf7dd2d7 (small blind) folded before Flop
Seat 3: 30b9401d (big blind) collected ($0.2)
Seat 4: 13078def folded before Flop (didn't bet)
Seat 5: Hero folded before Flop (didn't bet)
Seat 6: a36379d9 folded before Flop (didn't bet)


Poker Hand #RC92815259: Hold'em No Limit ($0.1/$0.25) - 2020/04/03 00:08:29
Table 'RushAndCash48001' 6-max Seat #1 is the button
Seat 1: e35929c8 ($15.56 in chips)
Seat 2: Hero ($26.73 in chips)
Seat 3: c204bed8 ($40.88 in chips)
Seat 4: 44db54de ($69.72 in chips)
Seat 5: a44aa940 ($35.47 in chips)
Seat 6: 1345d179 ($10.37 in chips)
Hero: posts small blind $0.1
c204bed8: posts big blind $0.25
*** HOLE CARDS ***
Dealt to e35929c8 
Dealt to Hero [Tc 3s]
Dealt to c204bed8 
Dealt to 44db54de 
Dealt to a44aa940 
Dealt to 1345d179 
44db54de: folds
a44aa940: calls $0.25
1345d179: calls $0.25
e35929c8: folds
Hero: folds
c204bed8: checks
*** FLOP *** [7d Qs Ad]
c204bed8: checks
a44aa940: bets $0.7
1345d179: calls $0.7
c204bed8: folds
*** TURN *** [7d Qs Ad] [8h]
a44aa940: bets $1.2
1345d179: calls $1.2
*** RIVER *** [7d Qs Ad 8h] [3d]
a44aa940: checks
1345d179: bets $3.5
a44aa940: calls $3.5
1345d179: shows [Kd 8d] (Ace High Flush)
a44aa940: shows [Ac 6s] (Pair of Aces)
*** SHOWDOWN ***
1345d179 collected $11.65 from pot
*** SUMMARY ***
Total pot $11.65
Board [7d Qs Ad 8h 3d]
Seat 1: e35929c8 (button) folded before Flop (didn't bet)
Seat 2: Hero (small blind) folded before Flop
Seat 3: c204bed8 (big blind) folded on the Flop
Seat 4: 44db54de folded before Flop (didn't bet)
Seat 5: a44aa940 showed [Ac 6s] and lost with Pair of Aces
Seat 6: 1345d179 showed [Kd 8d] and won ($11.65) with Ace High Flush


Poker Hand #RC92815304: Hold'em No Limit ($0.1/$0.25) - 2020/04/03 00:08:38
Table 'RushAndCash48006' 6-max Seat #1 is the button
Seat 1: 30b9401d ($14.71 in chips)
Seat 2: e3fa4802 ($51.62 in chips)
Seat 3: Hero ($26.63 in chips)
Seat 4: 25bc93df ($13.05 in chips)
Seat 5: ad3d6d15 ($26.59 in chips)
Seat 6: 40d3b492 ($26.82 in chips)
e3fa4802: posts small blind $0.1
Hero: posts big blind $0.25
*** HOLE CARDS ***
Dealt to 30b9401d 
Dealt to e3fa4802 
Dealt to Hero [4h 4d]
Dealt to 25bc93df 
Dealt to ad3d6d15 
Dealt to 40d3b492 
25bc93df: raises $0.5 to $0.75
ad3d6d15: folds
40d3b492: folds
30b9401d: folds
e3fa4802: folds
Hero: calls $0.5
*** FLOP *** [Kh 5c 5s]
Hero: checks
25bc93df: checks
*** TURN *** [Kh 5c 5s] [Ts]
Hero: checks
25bc93df: bets $1.05
Hero: calls $1.05
*** RIVER *** [Kh 5c 5s Ts] [Qd]
Hero: checks
25bc93df: checks
Hero: shows [4h 4d] (Pair of Fives and Pair of Fours)
25bc93df: shows [6s As] (Pair of Fives)
*** SHOWDOWN ***
Hero collected $3.7 from pot
*** SUMMARY ***
Total pot $3.7
Board [Kh 5c 5s Ts Qd]
Seat 1: 30b9401d (button) folded before Flop (didn't bet)
Seat 2: e3fa4802 (small blind) folded before Flop
Seat 3: Hero (big blind) showed [4h 4d] and won ($3.7) with Pair of Fives and Pair of Fours
Seat 4: 25bc93df showed [As 6s] and lost with Pair of Fives
Seat 5: ad3d6d15 folded before Flop (didn't bet)
Seat 6: 40d3b492 folded before Flop (didn't bet)


Poker Hand #RC92815576: Hold'em No Limit ($0.1/$0.25) - 2020/04/03 00:09:30
Table 'RushAndCash48035' 6-max Seat #1 is the button
Seat 1: a8727b90 ($34.61 in chips)
Seat 2: 30b9401d ($14.46 in chips)
Seat 3: 25bc93df ($12.5 in chips)
Seat 4: 64268d2a ($26.8 in chips)
Seat 5: e35929c8 ($15.21 in chips)
Seat 6: Hero ($28.35 in chips)
30b9401d: posts small blind $0.1
25bc93df: posts big blind $0.25
*** HOLE CARDS ***
Dealt to a8727b90 
Dealt to 30b9401d 
Dealt to 25bc93df 
Dealt to 64268d2a 
Dealt to e35929c8 
Dealt to Hero [Js 8d]
64268d2a: folds
e35929c8: raises $0.38 to $0.63
Hero: folds
a8727b90: folds
30b9401d: folds
25bc93df: raises $1.37 to $2
e35929c8: calls $1.37
*** FLOP *** [2s 3c 3d]
25bc93df: checks
e35929c8: checks
*** TURN *** [2s 3c 3d] [8c]
25bc93df: bets $3.1
e35929c8: folds
Uncalled bet ($3.1) returned to 25bc93df
*** SHOWDOWN ***
25bc93df collected $4.1 from pot
*** SUMMARY ***
Total pot $4.1
Board [2s 3c 3d 8c]
Seat 1: a8727b90 (button) folded before Flop (didn't bet)
Seat 2: 30b9401d (small blind) folded before Flop
Seat 3: 25bc93df (big blind) won ($4.1)
Seat 4: 64268d2a folded before Flop (didn't bet)
Seat 5: e35929c8 folded on the Turn
Seat 6: Hero folded before Flop (didn't bet)


Poker Hand #RC92815598: Hold'em No Limit ($0.1/$0.25) - 2020/04/03 00:09:35
Table 'RushAndCash48038' 6-max Seat #1 is the button
Seat 1: cf7dd2d7 ($33.28 in chips)
Seat 2: a44aa940 ($29.89 in chips)
Seat 3: 8b4eb2e ($25 in chips)
Seat 4: 6d33a0cb ($57.74 in chips)
Seat 5: a957a98a ($27.61 in chips)
Seat 6: Hero ($28.35 in chips)
a44aa940: posts small blind $0.1
8b4eb2e: posts big blind $0.25
*** HOLE CARDS ***
Dealt to cf7dd2d7 
Dealt to a44aa940 
Dealt to 8b4eb2e 
Dealt to 6d33a0cb 
Dealt to a957a98a 
Dealt to Hero [Ts 2s]
6d33a0cb: raises $0.5 to $0.75
a957a98a: folds
Hero: folds
cf7dd2d7: folds
a44aa940: folds
8b4eb2e: calls $0.5
*** FLOP *** [7h 4d 8h]
8b4eb2e: checks
6d33a0cb: bets $1.1
8b4eb2e: calls $1.1
*** TURN *** [7h 4d 8h] [Ac]
8b4eb2e: checks
6d33a0cb: checks
*** RIVER *** [7h 4d 8h Ac] [Kh]
8b4eb2e: bets $2.6
6d33a0cb: folds
Uncalled bet ($2.6) returned to 8b4eb2e
*** SHOWDOWN ***
8b4eb2e collected $3.8 from pot
*** SUMMARY ***
Total pot $3.8
Board [7h 4d 8h Ac Kh]
Seat 1: cf7dd2d7 (button) folded before Flop (didn't bet)
Seat 2: a44aa940 (small blind) folded before Flop
Seat 3: 8b4eb2e (big blind) won ($3.8)
Seat 4: 6d33a0cb folded on the River
Seat 5: a957a98a folded before Flop (didn't bet)
Seat 6: Hero folded before Flop (didn't bet)


Poker Hand #RC92815643: Hold'em No Limit ($0.1/$0.25) - 2020/04/03 00:09:43
Table 'RushAndCash48042' 6-max Seat #1 is the button
Seat 1: Hero ($28.35 in chips)
Seat 2: a36379d9 ($25 in chips)
Seat 3: 64268d2a ($26.7 in chips)
Seat 4: 7eb96805 ($12.13 in chips)
Seat 5: d8ff3732 ($58.53 in chips)
Seat 6: 833dc1e7 ($111.17 in chips)
a36379d9: posts small blind $0.1
64268d2a: posts big blind $0.25
*** HOLE CARDS ***
Dealt to Hero [Ad 6s]
Dealt to a36379d9 
Dealt to 64268d2a 
Dealt to 7eb96805 
Dealt to d8ff3732 
Dealt to 833dc1e7 
7eb96805: folds
d8ff3732: folds
833dc1e7: raises $0.5 to $0.75
Hero: folds
a36379d9: folds
64268d2a: raises $2.05 to $2.8
833dc1e7: calls $2.05
*** FLOP *** [3s 7h 3d]
64268d2a: bets $1.9
833dc1e7: calls $1.9
*** TURN *** [3s 7h 3d] [Ac]
64268d2a: bets $4.5
833dc1e7: folds
Uncalled bet ($4.5) returned to 64268d2a
*** SHOWDOWN ***
64268d2a collected $9.5 from pot
*** SUMMARY ***
Total pot $9.5
Board [3s 7h 3d Ac]
Seat 1: Hero (button) folded before Flop (didn't bet)
Seat 2: a36379d9 (small blind) folded before Flop
Seat 3: 64268d2a (big blind) won ($9.5)
Seat 4: 7eb96805 folded before Flop (didn't bet)
Seat 5: d8ff3732 folded before Flop (didn't bet)
Seat 6: 833dc1e7 folded on the Turn


Poker Hand #RC92815673: Hold'em No Limit ($0.1/$0.25) - 2020/04/03 00:09:50
Table 'RushAndCash48045' 6-max Seat #1 is the button
Seat 1: bb9a5aea ($10.49 in chips)
Seat 2: cf7dd2d7 ($33.28 in chips)
Seat 3: db9c5b71 ($25.42 in chips)
Seat 4: Hero ($28.35 in chips)
Seat 5: 52bba349 ($25.35 in chips)
Seat 6: 40d3b492 ($27.26 in chips)
cf7dd2d7: posts small blind $0.1
db9c5b71: posts big blind $0.25
*** HOLE CARDS ***
Dealt to bb9a5aea 
Dealt to cf7dd2d7 
Dealt to db9c5b71 
Dealt to Hero [Qc 4s]
Dealt to 52bba349 
Dealt to 40d3b492 
Hero: folds
52bba349: folds
40d3b492: folds
bb9a5aea: folds
cf7dd2d7: folds
Uncalled bet ($0.15) returned to db9c5b71
*** SHOWDOWN ***
db9c5b71 collected $0.2 from pot
*** SUMMARY ***
Total pot $0.2
Seat 1: bb9a5aea (button) folded before Flop (didn't bet)
Seat 2: cf7dd2d7 (small blind) folded before Flop
Seat 3: db9c5b71 (big blind) collected ($0.2)
Seat 4: Hero folded before Flop (didn't bet)
Seat 5: 52bba349 folded before Flop (didn't bet)
Seat 6: 40d3b492 folded before Flop (didn't bet)


Poker Hand #RC92815694: Hold'em No Limit ($0.1/$0.25) - 2020/04/03 00:09:54
Table 'RushAndCash48047' 6-max Seat #1 is the button
Seat 1: Hero ($28.35 in chips)
Seat 2: 37d48404 ($62.49 in chips)
Seat 3: b912752f ($18.47 in chips)
Seat 4: cbf0ae65 ($15.06 in chips)
Seat 5: 3f0546a3 ($26.3 in chips)
Seat 6: 469ba291 ($33 in chips)
37d48404: posts small blind $0.1
b912752f: posts big blind $0.25
*** HOLE CARDS ***
Dealt to Hero [6d 4c]
Dealt to 37d48404 
Dealt to b912752f 
Dealt to cbf0ae65 
Dealt to 3f0546a3 
Dealt to 469ba291 
cbf0ae65: folds
3f0546a3: folds
469ba291: folds
Hero: folds
37d48404: raises $0.5 to $0.75
b912752f: calls $0.5
*** FLOP *** [Qh 8d 5h]
37d48404: bets $0.5
b912752f: raises $1.9 to $2.4
37d48404: folds
Uncalled bet ($1.9) returned to b912752f
*** SHOWDOWN ***
b912752f collected $2.5 from pot
*** SUMMARY ***
Total pot $2.5
Board [Qh 8d 5h]
Seat 1: Hero (button) folded before Flop (didn't bet)
Seat 2: 37d48404 (small blind) folded on the Flop
Seat 3: b912752f (big blind) won ($2.5)
Seat 4: cbf0ae65 folded before Flop (didn't bet)
Seat 5: 3f0546a3 folded before Flop (didn't bet)
Seat 6: 469ba291 folded before Flop (didn't bet)


Poker Hand #RC92815722: Hold'em No Limit ($0.1/$0.25) - 2020/04/03 00:10:00
Table 'RushAndCash48050' 6-max Seat #1 is the button
Seat 1: 44db54de ($70.52 in chips)
Seat 2: f43af171 ($27.06 in chips)
Seat 3: bb9a5aea ($10.49 in chips)
Seat 4: 40d3b492 ($27.26 in chips)
Seat 5: f032dc5a ($14.44 in chips)
Seat 6: Hero ($28.35 in chips)
f43af171: posts small blind $0.1
bb9a5aea: posts big blind $0.25
*** HOLE CARDS ***
Dealt to 44db54de 
Dealt to f43af171 
Dealt to bb9a5aea 
Dealt to 40d3b492 
Dealt to f032dc5a 
Dealt to Hero [Ah 7s]
40d3b492: folds
f032dc5a: raises $0.5 to $0.75
Hero: folds
44db54de: folds
f43af171: folds
bb9a5aea: folds
Uncalled bet ($0.5) returned to f032dc5a
*** SHOWDOWN ***
f032dc5a collected $0.6 from pot
*** SUMMARY ***
Total pot $0.6
Seat 1: 44db54de (button) folded before Flop (didn't bet)
Seat 2: f43af171 (small blind) folded before Flop
Seat 3: bb9a5aea (big blind) folded before Flop
Seat 4: 40d3b492 folded before Flop (didn't bet)
Seat 5: f032dc5a collected ($0.6)
Seat 6: Hero folded before Flop (didn't bet)


Poker Hand #RC92815740: Hold'em No Limit ($0.1/$0.25) - 2020/04/03 00:10:04
Table 'RushAndCash48051' 6-max Seat #1 is the button
Seat 1: e3fa4802 ($51.94 in chips)
Seat 2: 36f1561e ($36.13 in chips)
Seat 3: a36379d9 ($25 in chips)
Seat 4: b20a2692 ($23.18 in chips)
Seat 5: Hero ($28.35 in chips)
Seat 6: cbf0ae65 ($15.06 in chips)
36f1561e: posts small blind $0.1
a36379d9: posts big blind $0.25
*** HOLE CARDS ***
Dealt to e3fa4802 
Dealt to 36f1561e 
Dealt to a36379d9 
Dealt to b20a2692 
Dealt to Hero [Qh Qd]
Dealt to cbf0ae65 
b20a2692: raises $0.75 to $1
Hero: raises $1.75 to $2.75
cbf0ae65: folds
e3fa4802: folds
36f1561e: folds
a36379d9: folds
b20a2692: calls $1.75
*** FLOP *** [8h 7s Qc]
b20a2692: checks
Hero: bets $1.52
b20a2692: raises $6.68 to $8.2
Hero: calls $6.68
*** TURN *** [8h 7s Qc] [4s]
b20a2692: bets $12.23 and is all-in
Hero: calls $12.23
b20a2692: shows [7h 7d] (Three Sevens)
Hero: shows [Qh Qd] (Three Queens)
*** RIVER *** [8h 7s Qc 4s] [Kd]
*** SHOWDOWN ***
Hero collected $46.71 from pot
*** SUMMARY ***
Total pot $46.71
Board [8h 7s Qc 4s Kd]
Seat 1: e3fa4802 (button) folded before Flop (didn't bet)
Seat 2: 36f1561e (small blind) folded before Flop
Seat 3: a36379d9 (big blind) folded before Flop
Seat 4: b20a2692 showed [7h 7d] and lost with Three Sevens
Seat 5: Hero showed [Qh Qd] and won ($46.71) with Three Queens
Seat 6: cbf0ae65 folded before Flop (didn't bet)


Poker Hand #RC92816069: Hold'em No Limit ($0.1/$0.25) - 2020/04/03 00:11:07
Table 'RushAndCash48084' 6-max Seat #1 is the button
Seat 1: 37d48404 ($61.34 in chips)
Seat 2: deb72131 ($12.5 in chips)
Seat 3: Hero ($50.88 in chips)
Seat 4: 36f1561e ($36.13 in chips)
Seat 5: 5136ebb4 ($51.1 in chips)
Seat 6: bb9a5aea ($10.26 in chips)
deb72131: posts small blind $0.1
Hero: posts big blind $0.25
*** HOLE CARDS ***
Dealt to 37d48404 
Dealt to deb72131 
Dealt to Hero [Qd Tc]
Dealt to 36f1561e 
Dealt to 5136ebb4 
Dealt to bb9a5aea 
36f1561e: folds
5136ebb4: folds
bb9a5aea: folds
37d48404: folds
deb72131: raises $0.5 to $0.75
Hero: folds
Uncalled bet ($0.5) returned to deb72131
*** SHOWDOWN ***
deb72131 collected $0.5 from pot
*** SUMMARY ***
Total pot $0.5
Seat 1: 37d48404 (button) folded before Flop (didn't bet)
Seat 2: deb72131 (small blind) collected ($0.5)
Seat 3: Hero (big blind) folded before Flop
Seat 4: 36f1561e folded before Flop (didn't bet)
Seat 5: 5136ebb4 folded before Flop (didn't bet)
Seat 6: bb9a5aea folded before Flop (didn't bet)


