Poker Hand #RC94778888: Hold'em No Limit ($0.1/$0.25) - 2020/04/06 22:41:30
Table 'RushAndCash316784' 6-max Seat #1 is the button
Seat 1: dede351 ($46.9 in chips)
Seat 2: 655e4ca8 ($12.5 in chips)
Seat 3: Hero ($25 in chips)
Seat 4: 7357eb2f ($42.59 in chips)
Seat 5: 5e03da34 ($32.91 in chips)
Seat 6: 1635b50e ($31.5 in chips)
655e4ca8: posts small blind $0.1
Hero: posts big blind $0.25
*** HOLE CARDS ***
Dealt to dede351 
Dealt to 655e4ca8 
Dealt to Hero [5s 4h]
Dealt to 7357eb2f 
Dealt to 5e03da34 
Dealt to 1635b50e 
7357eb2f: raises $0.38 to $0.63
5e03da34: folds
1635b50e: folds
dede351: folds
655e4ca8: folds
Hero: folds
Uncalled bet ($0.38) returned to 7357eb2f
*** SHOWDOWN ***
7357eb2f collected $0.6 from pot
*** SUMMARY ***
Total pot $0.6
Seat 1: dede351 (button) folded before Flop (didn't bet)
Seat 2: 655e4ca8 (small blind) folded before Flop
Seat 3: Hero (big blind) folded before Flop
Seat 4: 7357eb2f collected ($0.6)
Seat 5: 5e03da34 folded before Flop (didn't bet)
Seat 6: 1635b50e folded before Flop (didn't bet)


Poker Hand #RC94778986: Hold'em No Limit ($0.1/$0.25) - 2020/04/06 22:41:46
Table 'RushAndCash316799' 6-max Seat #1 is the button
Seat 1: 8f2f88a4 ($42.02 in chips)
Seat 2: Hero ($25 in chips)
Seat 3: 3829a169 ($31.94 in chips)
Seat 4: 8a9247b3 ($18.3 in chips)
Seat 5: eb5021b0 ($69.23 in chips)
Seat 6: 5c45646d ($29.14 in chips)
Hero: posts small blind $0.1
3829a169: posts big blind $0.25
*** HOLE CARDS ***
Dealt to 8f2f88a4 
Dealt to Hero [Qs 2h]
Dealt to 3829a169 
Dealt to 8a9247b3 
Dealt to eb5021b0 
Dealt to 5c45646d 
8a9247b3: folds
eb5021b0: folds
5c45646d: folds
8f2f88a4: folds
Hero: folds
Uncalled bet ($0.15) returned to 3829a169
*** SHOWDOWN ***
3829a169 collected $0.2 from pot
*** SUMMARY ***
Total pot $0.2
Seat 1: 8f2f88a4 (button) folded before Flop (didn't bet)
Seat 2: Hero (small blind) folded before Flop
Seat 3: 3829a169 (big blind) collected ($0.2)
Seat 4: 8a9247b3 folded before Flop (didn't bet)
Seat 5: eb5021b0 folded before Flop (didn't bet)
Seat 6: 5c45646d folded before Flop (didn't bet)


Poker Hand #RC94779017: Hold'em No Limit ($0.1/$0.25) - 2020/04/06 22:41:51
Table 'RushAndCash316805' 6-max Seat #1 is the button
Seat 1: Hero ($25 in chips)
Seat 2: 1635b50e ($31.5 in chips)
Seat 3: dede351 ($46.9 in chips)
Seat 4: a6356844 ($8.05 in chips)
Seat 5: 5c45646d ($29.14 in chips)
Seat 6: 578f9607 ($26.05 in chips)
1635b50e: posts small blind $0.1
dede351: posts big blind $0.25
*** HOLE CARDS ***
Dealt to Hero [7h 2d]
Dealt to 1635b50e 
Dealt to dede351 
Dealt to a6356844 
Dealt to 5c45646d 
Dealt to 578f9607 
a6356844: folds
5c45646d: folds
578f9607: folds
Hero: folds
1635b50e: raises $0.5 to $0.75
dede351: folds
Uncalled bet ($0.5) returned to 1635b50e
*** SHOWDOWN ***
1635b50e collected $0.5 from pot
*** SUMMARY ***
Total pot $0.5
Seat 1: Hero (button) folded before Flop (didn't bet)
Seat 2: 1635b50e (small blind) collected ($0.5)
Seat 3: dede351 (big blind) folded before Flop
Seat 4: a6356844 folded before Flop (didn't bet)
Seat 5: 5c45646d folded before Flop (didn't bet)
Seat 6: 578f9607 folded before Flop (didn't bet)


Poker Hand #RC94779344: Hold'em No Limit ($0.1/$0.25) - 2020/04/06 22:42:46
Table 'RushAndCash316856' 6-max Seat #1 is the button
Seat 1: 1b328820 ($11.66 in chips)
Seat 2: 93b71bcb ($80.24 in chips)
Seat 3: 2258ad9f ($35.82 in chips)
Seat 4: 41cf19d5 ($37.77 in chips)
Seat 5: Hero ($25 in chips)
Seat 6: 9607e809 ($28.16 in chips)
93b71bcb: posts small blind $0.1
2258ad9f: posts big blind $0.25
*** HOLE CARDS ***
Dealt to 1b328820 
Dealt to 93b71bcb 
Dealt to 2258ad9f 
Dealt to 41cf19d5 
Dealt to Hero [5h 4s]
Dealt to 9607e809 
41cf19d5: folds
Hero: folds
9607e809: folds
1b328820: folds
93b71bcb: folds
Uncalled bet ($0.15) returned to 2258ad9f
*** SHOWDOWN ***
2258ad9f collected $0.2 from pot
*** SUMMARY ***
Total pot $0.2
Seat 1: 1b328820 (button) folded before Flop (didn't bet)
Seat 2: 93b71bcb (small blind) folded before Flop
Seat 3: 2258ad9f (big blind) collected ($0.2)
Seat 4: 41cf19d5 folded before Flop (didn't bet)
Seat 5: Hero folded before Flop (didn't bet)
Seat 6: 9607e809 folded before Flop (didn't bet)


Poker Hand #RC94779362: Hold'em No Limit ($0.1/$0.25) - 2020/04/06 22:42:49
Table 'RushAndCash316860' 6-max Seat #1 is the button
Seat 1: 94efc628 ($32.29 in chips)
Seat 2: 49f9635f ($12.69 in chips)
Seat 3: 3829a169 ($32.75 in chips)
Seat 4: fbdd6126 ($11.69 in chips)
Seat 5: 7aead3c7 ($24.23 in chips)
Seat 6: Hero ($25 in chips)
49f9635f: posts small blind $0.1
3829a169: posts big blind $0.25
*** HOLE CARDS ***
Dealt to 94efc628 
Dealt to 49f9635f 
Dealt to 3829a169 
Dealt to fbdd6126 
Dealt to 7aead3c7 
Dealt to Hero [Qd Tc]
fbdd6126: folds
7aead3c7: folds
Hero: raises $0.38 to $0.63
94efc628: folds
49f9635f: folds
3829a169: folds
Uncalled bet ($0.38) returned to Hero
*** SHOWDOWN ***
Hero collected $0.6 from pot
*** SUMMARY ***
Total pot $0.6
Seat 1: 94efc628 (button) folded before Flop (didn't bet)
Seat 2: 49f9635f (small blind) folded before Flop
Seat 3: 3829a169 (big blind) folded before Flop
Seat 4: fbdd6126 folded before Flop (didn't bet)
Seat 5: 7aead3c7 folded before Flop (didn't bet)
Seat 6: Hero collected ($0.6)


Poker Hand #RC94779473: Hold'em No Limit ($0.1/$0.25) - 2020/04/06 22:43:07
Table 'RushAndCash316886' 6-max Seat #1 is the button
Seat 1: 2aa6d89 ($29.53 in chips)
Seat 2: 2467bb49 ($54.02 in chips)
Seat 3: beec3332 ($28.43 in chips)
Seat 4: 8cda51b0 ($26.86 in chips)
Seat 5: 2cdd0cc9 ($20.33 in chips)
Seat 6: Hero ($25.35 in chips)
2467bb49: posts small blind $0.1
beec3332: posts big blind $0.25
*** HOLE CARDS ***
Dealt to 2aa6d89 
Dealt to 2467bb49 
Dealt to beec3332 
Dealt to 8cda51b0 
Dealt to 2cdd0cc9 
Dealt to Hero [Qh 7h]
8cda51b0: folds
2cdd0cc9: raises $0.38 to $0.63
Hero: folds
2aa6d89: folds
2467bb49: calls $0.53
beec3332: folds
*** FLOP *** [Td 3h Jd]
2467bb49: checks
2cdd0cc9: checks
*** TURN *** [Td 3h Jd] [9h]
2467bb49: bets $1.2
2cdd0cc9: folds
Uncalled bet ($1.2) returned to 2467bb49
*** SHOWDOWN ***
2467bb49 collected $1.51 from pot
*** SUMMARY ***
Total pot $1.51
Board [Td 3h Jd 9h]
Seat 1: 2aa6d89 (button) folded before Flop (didn't bet)
Seat 2: 2467bb49 (small blind) won ($1.51)
Seat 3: beec3332 (big blind) folded before Flop
Seat 4: 8cda51b0 folded before Flop (didn't bet)
Seat 5: 2cdd0cc9 folded on the Turn
Seat 6: Hero folded before Flop (didn't bet)


Poker Hand #RC94779536: Hold'em No Limit ($0.1/$0.25) - 2020/04/06 22:43:17
Table 'RushAndCash316901' 6-max Seat #1 is the button
Seat 1: e2e66d9b ($121.59 in chips)
Seat 2: ce86c7bd ($29.42 in chips)
Seat 3: 1b328820 ($11.66 in chips)
Seat 4: Hero ($25.35 in chips)
Seat 5: eb5021b0 ($71.56 in chips)
Seat 6: dede351 ($45.85 in chips)
ce86c7bd: posts small blind $0.1
1b328820: posts big blind $0.25
*** HOLE CARDS ***
Dealt to e2e66d9b 
Dealt to ce86c7bd 
Dealt to 1b328820 
Dealt to Hero [Qc 6s]
Dealt to eb5021b0 
Dealt to dede351 
Hero: folds
eb5021b0: raises $0.38 to $0.63
dede351: folds
e2e66d9b: raises $1.77 to $2.4
ce86c7bd: folds
1b328820: folds
eb5021b0: folds
Uncalled bet ($1.77) returned to e2e66d9b
*** SHOWDOWN ***
e2e66d9b collected $1.61 from pot
*** SUMMARY ***
Total pot $1.61
Seat 1: e2e66d9b (button) collected ($1.61)
Seat 2: ce86c7bd (small blind) folded before Flop
Seat 3: 1b328820 (big blind) folded before Flop
Seat 4: Hero folded before Flop (didn't bet)
Seat 5: eb5021b0 folded before Flop
Seat 6: dede351 folded before Flop (didn't bet)


Poker Hand #RC94779569: Hold'em No Limit ($0.1/$0.25) - 2020/04/06 22:43:22
Table 'RushAndCash316907' 6-max Seat #1 is the button
Seat 1: 6cdb516f ($46.91 in chips)
Seat 2: Hero ($25.35 in chips)
Seat 3: e34666c6 ($13.36 in chips)
Seat 4: f8b1513e ($37.26 in chips)
Seat 5: 67ff4adc ($24.65 in chips)
Seat 6: 8a9247b3 ($18.62 in chips)
Hero: posts small blind $0.1
e34666c6: posts big blind $0.25
*** HOLE CARDS ***
Dealt to 6cdb516f 
Dealt to Hero [Th 9s]
Dealt to e34666c6 
Dealt to f8b1513e 
Dealt to 67ff4adc 
Dealt to 8a9247b3 
f8b1513e: folds
67ff4adc: folds
8a9247b3: folds
6cdb516f: folds
Hero: folds
Uncalled bet ($0.15) returned to e34666c6
*** SHOWDOWN ***
e34666c6 collected $0.2 from pot
*** SUMMARY ***
Total pot $0.2
Seat 1: 6cdb516f (button) folded before Flop (didn't bet)
Seat 2: Hero (small blind) folded before Flop
Seat 3: e34666c6 (big blind) collected ($0.2)
Seat 4: f8b1513e folded before Flop (didn't bet)
Seat 5: 67ff4adc folded before Flop (didn't bet)
Seat 6: 8a9247b3 folded before Flop (didn't bet)


Poker Hand #RC94779605: Hold'em No Limit ($0.1/$0.25) - 2020/04/06 22:43:29
Table 'RushAndCash316913' 6-max Seat #1 is the button
Seat 1: 94efc628 ($32.64 in chips)
Seat 2: fc644cfe ($27.14 in chips)
Seat 3: Hero ($25.25 in chips)
Seat 4: c6b0bd37 ($12.77 in chips)
Seat 5: 483b0968 ($14.02 in chips)
Seat 6: 55e409c ($40.37 in chips)
fc644cfe: posts small blind $0.1
Hero: posts big blind $0.25
*** HOLE CARDS ***
Dealt to 94efc628 
Dealt to fc644cfe 
Dealt to Hero [6h 5d]
Dealt to c6b0bd37 
Dealt to 483b0968 
Dealt to 55e409c 
c6b0bd37: folds
483b0968: raises $0.5 to $0.75
55e409c: folds
94efc628: raises $1.45 to $2.2
fc644cfe: folds
Hero: folds
483b0968: calls $1.45
*** FLOP *** [4c 3s 7c]
483b0968: bets $2.4
94efc628: folds
Uncalled bet ($2.4) returned to 483b0968
*** SHOWDOWN ***
483b0968 collected $4.75 from pot
*** SUMMARY ***
Total pot $4.75
Board [4c 3s 7c]
Seat 1: 94efc628 (button) folded on the Flop
Seat 2: fc644cfe (small blind) folded before Flop
Seat 3: Hero (big blind) folded before Flop
Seat 4: c6b0bd37 folded before Flop (didn't bet)
Seat 5: 483b0968 won ($4.75)
Seat 6: 55e409c folded before Flop (didn't bet)


Poker Hand #RC94779634: Hold'em No Limit ($0.1/$0.25) - 2020/04/06 22:43:34
Table 'RushAndCash316918' 6-max Seat #1 is the button
Seat 1: Hero ($25 in chips)
Seat 2: e34666c6 ($13.46 in chips)
Seat 3: 93b71bcb ($81.93 in chips)
Seat 4: bd6eeaf3 ($49.3 in chips)
Seat 5: fd957725 ($24.35 in chips)
Seat 6: 1de57a80 ($25.45 in chips)
e34666c6: posts small blind $0.1
93b71bcb: posts big blind $0.25
*** HOLE CARDS ***
Dealt to Hero [Qd 4c]
Dealt to e34666c6 
Dealt to 93b71bcb 
Dealt to bd6eeaf3 
Dealt to fd957725 
Dealt to 1de57a80 
bd6eeaf3: folds
fd957725: folds
1de57a80: folds
Hero: folds
e34666c6: raises $0.25 to $0.5
93b71bcb: folds
Uncalled bet ($0.25) returned to e34666c6
*** SHOWDOWN ***
e34666c6 collected $0.5 from pot
*** SUMMARY ***
Total pot $0.5
Seat 1: Hero (button) folded before Flop (didn't bet)
Seat 2: e34666c6 (small blind) collected ($0.5)
Seat 3: 93b71bcb (big blind) folded before Flop
Seat 4: bd6eeaf3 folded before Flop (didn't bet)
Seat 5: fd957725 folded before Flop (didn't bet)
Seat 6: 1de57a80 folded before Flop (didn't bet)


Poker Hand #RC94779662: Hold'em No Limit ($0.1/$0.25) - 2020/04/06 22:43:38
Table 'RushAndCash316924' 6-max Seat #1 is the button
Seat 1: 578f9607 ($25 in chips)
Seat 2: 2cdd0cc9 ($19.7 in chips)
Seat 3: 49f9635f ($12.84 in chips)
Seat 4: 7ed50f46 ($90.11 in chips)
Seat 5: Hero ($25 in chips)
Seat 6: 93b71bcb ($81.68 in chips)
2cdd0cc9: posts small blind $0.1
49f9635f: posts big blind $0.25
*** HOLE CARDS ***
Dealt to 578f9607 
Dealt to 2cdd0cc9 
Dealt to 49f9635f 
Dealt to 7ed50f46 
Dealt to Hero [Th 4d]
Dealt to 93b71bcb 
7ed50f46: folds
Hero: folds
93b71bcb: raises $0.25 to $0.5
578f9607: folds
2cdd0cc9: folds
49f9635f: folds
Uncalled bet ($0.25) returned to 93b71bcb
*** SHOWDOWN ***
93b71bcb collected $0.6 from pot
*** SUMMARY ***
Total pot $0.6
Seat 1: 578f9607 (button) folded before Flop (didn't bet)
Seat 2: 2cdd0cc9 (small blind) folded before Flop
Seat 3: 49f9635f (big blind) folded before Flop
Seat 4: 7ed50f46 folded before Flop (didn't bet)
Seat 5: Hero folded before Flop (didn't bet)
Seat 6: 93b71bcb collected ($0.6)


Poker Hand #RC94779690: Hold'em No Limit ($0.1/$0.25) - 2020/04/06 22:43:42
Table 'RushAndCash316928' 6-max Seat #1 is the button
Seat 1: 9607e809 ($27.43 in chips)
Seat 2: e2e66d9b ($122.39 in chips)
Seat 3: 7ed50f46 ($90.11 in chips)
Seat 4: 2088a691 ($28.03 in chips)
Seat 5: Hero ($25 in chips)
Seat 6: 655e4ca8 ($12.5 in chips)
e2e66d9b: posts small blind $0.1
7ed50f46: posts big blind $0.25
*** HOLE CARDS ***
Dealt to 9607e809 
Dealt to e2e66d9b 
Dealt to 7ed50f46 
Dealt to 2088a691 
Dealt to Hero [Ad Jh]
Dealt to 655e4ca8 
2088a691: folds
Hero: raises $0.38 to $0.63
655e4ca8: folds
9607e809: folds
e2e66d9b: folds
7ed50f46: calls $0.38
*** FLOP *** [6c Ks Qs]
7ed50f46: checks
Hero: bets $0.75
7ed50f46: calls $0.75
*** TURN *** [6c Ks Qs] [8d]
7ed50f46: checks
Hero: checks
*** RIVER *** [6c Ks Qs 8d] [Ts]
7ed50f46: bets $4.2
Hero: calls $4.2
7ed50f46: shows [4c As] (Ace-High)
Hero: shows [Jh Ad] (Aces-High Straight)
*** SHOWDOWN ***
Hero collected $11.26 from pot
*** SUMMARY ***
Total pot $11.26
Board [6c Ks Qs 8d Ts]
Seat 1: 9607e809 (button) folded before Flop (didn't bet)
Seat 2: e2e66d9b (small blind) folded before Flop
Seat 3: 7ed50f46 (big blind) showed [As 4c] and lost with Ace-High
Seat 4: 2088a691 folded before Flop (didn't bet)
Seat 5: Hero showed [Ad Jh] and won ($11.26) with Aces-High Straight
Seat 6: 655e4ca8 folded before Flop (didn't bet)


Poker Hand #RC94779975: Hold'em No Limit ($0.1/$0.25) - 2020/04/06 22:44:31
Table 'RushAndCash316974' 6-max Seat #1 is the button
Seat 1: 84ec2b3a ($25 in chips)
Seat 2: 8a9247b3 ($24.75 in chips)
Seat 3: e100d89f ($26.54 in chips)
Seat 4: Hero ($29.87 in chips)
Seat 5: 49f9635f ($12.94 in chips)
Seat 6: 7357eb2f ($44.8 in chips)
8a9247b3: posts small blind $0.1
e100d89f: posts big blind $0.25
*** HOLE CARDS ***
Dealt to 84ec2b3a 
Dealt to 8a9247b3 
Dealt to e100d89f 
Dealt to Hero [Qs Jd]
Dealt to 49f9635f 
Dealt to 7357eb2f 
Hero: folds
49f9635f: folds
7357eb2f: folds
84ec2b3a: folds
8a9247b3: folds
Uncalled bet ($0.15) returned to e100d89f
*** SHOWDOWN ***
e100d89f collected $0.2 from pot
*** SUMMARY ***
Total pot $0.2
Seat 1: 84ec2b3a (button) folded before Flop (didn't bet)
Seat 2: 8a9247b3 (small blind) folded before Flop
Seat 3: e100d89f (big blind) collected ($0.2)
Seat 4: Hero folded before Flop (didn't bet)
Seat 5: 49f9635f folded before Flop (didn't bet)
Seat 6: 7357eb2f folded before Flop (didn't bet)


Poker Hand #RC94780003: Hold'em No Limit ($0.1/$0.25) - 2020/04/06 22:44:36
Table 'RushAndCash316979' 6-max Seat #1 is the button
Seat 1: d13258d2 ($7.96 in chips)
Seat 2: 7357eb2f ($44.8 in chips)
Seat 3: Hero ($29.87 in chips)
Seat 4: bd6eeaf3 ($49.2 in chips)
Seat 5: 8a9247b3 ($24.65 in chips)
Seat 6: 84ec2b3a ($25 in chips)
7357eb2f: posts small blind $0.1
Hero: posts big blind $0.25
*** HOLE CARDS ***
Dealt to d13258d2 
Dealt to 7357eb2f 
Dealt to Hero [Qd Tc]
Dealt to bd6eeaf3 
Dealt to 8a9247b3 
Dealt to 84ec2b3a 
bd6eeaf3: folds
8a9247b3: folds
84ec2b3a: folds
d13258d2: raises $0.25 to $0.5
7357eb2f: raises $1.4 to $1.9
Hero: calls $1.65
d13258d2: folds
*** FLOP *** [Ah Kh 6s]
7357eb2f: bets $1.5
Hero: calls $1.5
*** TURN *** [Ah Kh 6s] [Ac]
7357eb2f: checks
Hero: checks
*** RIVER *** [Ah Kh 6s Ac] [Kc]
7357eb2f: bets $2.5
Hero: calls $2.5
7357eb2f: shows [7d 6d] (Pair of Aces and Pair of Kings)
Hero: shows [Tc Qd] (Pair of Aces and Pair of Kings)
*** SHOWDOWN ***
Hero collected $12.3 from pot
*** SUMMARY ***
Total pot $12.3
Board [Ah Kh 6s Ac Kc]
Seat 1: d13258d2 (button) folded before Flop
Seat 2: 7357eb2f (small blind) showed [7d 6d] and lost with Pair of Aces and Pair of Kings
Seat 3: Hero (big blind) showed [Qd Tc] and won ($12.3) with Pair of Aces and Pair of Kings
Seat 4: bd6eeaf3 folded before Flop (didn't bet)
Seat 5: 8a9247b3 folded before Flop (didn't bet)
Seat 6: 84ec2b3a folded before Flop (didn't bet)


Poker Hand #RC94780419: Hold'em No Limit ($0.1/$0.25) - 2020/04/06 22:45:52
Table 'RushAndCash317044' 6-max Seat #1 is the button
Seat 1: 17480666 ($59.71 in chips)
Seat 2: Hero ($35.41 in chips)
Seat 3: 8f2f88a4 ($41.28 in chips)
Seat 4: 28a99893 ($19.45 in chips)
Seat 5: afc178f9 ($28.67 in chips)
Seat 6: 94efc628 ($30.69 in chips)
Hero: posts small blind $0.1
8f2f88a4: posts big blind $0.25
*** HOLE CARDS ***
Dealt to 17480666 
Dealt to Hero [6s 6h]
Dealt to 8f2f88a4 
Dealt to 28a99893 
Dealt to afc178f9 
Dealt to 94efc628 
28a99893: folds
afc178f9: folds
94efc628: folds
17480666: raises $0.5 to $0.75
Hero: calls $0.65
8f2f88a4: calls $0.5
*** FLOP *** [7d Qd Jh]
Hero: checks
8f2f88a4: checks
17480666: bets $0.8
Hero: folds
8f2f88a4: folds
Uncalled bet ($0.8) returned to 17480666
*** SHOWDOWN ***
17480666 collected $2.25 from pot
*** SUMMARY ***
Total pot $2.25
Board [7d Qd Jh]
Seat 1: 17480666 (button) won ($2.25)
Seat 2: Hero (small blind) folded on the Flop
Seat 3: 8f2f88a4 (big blind) folded on the Flop
Seat 4: 28a99893 folded before Flop (didn't bet)
Seat 5: afc178f9 folded before Flop (didn't bet)
Seat 6: 94efc628 folded before Flop (didn't bet)


Poker Hand #RC94780606: Hold'em No Limit ($0.1/$0.25) - 2020/04/06 22:46:27
Table 'RushAndCash317078' 6-max Seat #1 is the button
Seat 1: Hero ($34.66 in chips)
Seat 2: e3e3827d ($29.85 in chips)
Seat 3: 3829a169 ($33.43 in chips)
Seat 4: 591642a3 ($11.65 in chips)
Seat 5: 578f9607 ($25 in chips)
Seat 6: 6ae24a16 ($26.47 in chips)
e3e3827d: posts small blind $0.1
3829a169: posts big blind $0.25
*** HOLE CARDS ***
Dealt to Hero [Js Ts]
Dealt to e3e3827d 
Dealt to 3829a169 
Dealt to 591642a3 
Dealt to 578f9607 
Dealt to 6ae24a16 
591642a3: folds
578f9607: folds
6ae24a16: folds
Hero: raises $0.38 to $0.63
e3e3827d: folds
3829a169: folds
Uncalled bet ($0.38) returned to Hero
*** SHOWDOWN ***
Hero collected $0.6 from pot
*** SUMMARY ***
Total pot $0.6
Seat 1: Hero (button) collected ($0.6)
Seat 2: e3e3827d (small blind) folded before Flop
Seat 3: 3829a169 (big blind) folded before Flop
Seat 4: 591642a3 folded before Flop (didn't bet)
Seat 5: 578f9607 folded before Flop (didn't bet)
Seat 6: 6ae24a16 folded before Flop (didn't bet)


Poker Hand #RC94780706: Hold'em No Limit ($0.1/$0.25) - 2020/04/06 22:46:43
Table 'RushAndCash317095' 6-max Seat #1 is the button
Seat 1: 67ff4adc ($22.9 in chips)
Seat 2: e100d89f ($25.99 in chips)
Seat 3: d13258d2 ($4.86 in chips)
Seat 4: Hero ($35.01 in chips)
Seat 5: 6cdb516f ($44.98 in chips)
Seat 6: b9bbf733 ($37.84 in chips)
e100d89f: posts small blind $0.1
d13258d2: posts big blind $0.25
*** HOLE CARDS ***
Dealt to 67ff4adc 
Dealt to e100d89f 
Dealt to d13258d2 
Dealt to Hero [Ac 4d]
Dealt to 6cdb516f 
Dealt to b9bbf733 
Hero: folds
6cdb516f: folds
b9bbf733: folds
67ff4adc: folds
e100d89f: folds
Uncalled bet ($0.15) returned to d13258d2
*** SHOWDOWN ***
d13258d2 collected $0.2 from pot
*** SUMMARY ***
Total pot $0.2
Seat 1: 67ff4adc (button) folded before Flop (didn't bet)
Seat 2: e100d89f (small blind) folded before Flop
Seat 3: d13258d2 (big blind) collected ($0.2)
Seat 4: Hero folded before Flop (didn't bet)
Seat 5: 6cdb516f folded before Flop (didn't bet)
Seat 6: b9bbf733 folded before Flop (didn't bet)


Poker Hand #RC94780748: Hold'em No Limit ($0.1/$0.25) - 2020/04/06 22:46:51
Table 'RushAndCash317102' 6-max Seat #1 is the button
Seat 1: ce86c7bd ($27.56 in chips)
Seat 2: 6ae24a16 ($26.22 in chips)
Seat 3: 94efc628 ($29.99 in chips)
Seat 4: bd6eeaf3 ($52.02 in chips)
Seat 5: Hero ($35.01 in chips)
Seat 6: 1635b50e ($31.2 in chips)
6ae24a16: posts small blind $0.1
94efc628: posts big blind $0.25
*** HOLE CARDS ***
Dealt to ce86c7bd 
Dealt to 6ae24a16 
Dealt to 94efc628 
Dealt to bd6eeaf3 
Dealt to Hero [Kh Jc]
Dealt to 1635b50e 
bd6eeaf3: folds
Hero: raises $0.38 to $0.63
1635b50e: folds
ce86c7bd: folds
6ae24a16: folds
94efc628: folds
Uncalled bet ($0.38) returned to Hero
*** SHOWDOWN ***
Hero collected $0.6 from pot
*** SUMMARY ***
Total pot $0.6
Seat 1: ce86c7bd (button) folded before Flop (didn't bet)
Seat 2: 6ae24a16 (small blind) folded before Flop
Seat 3: 94efc628 (big blind) folded before Flop
Seat 4: bd6eeaf3 folded before Flop (didn't bet)
Seat 5: Hero collected ($0.6)
Seat 6: 1635b50e folded before Flop (didn't bet)


Poker Hand #RC94780944: Hold'em No Limit ($0.1/$0.25) - 2020/04/06 22:47:25
Table 'RushAndCash317132' 6-max Seat #1 is the button
Seat 1: d13258d2 ($4.86 in chips)
Seat 2: Hero ($35.36 in chips)
Seat 3: 2b4254fb ($43.23 in chips)
Seat 4: 604f36f0 ($31.74 in chips)
Seat 5: 6d2a6ab4 ($27.41 in chips)
Seat 6: a96ed6d7 ($12.5 in chips)
Hero: posts small blind $0.1
2b4254fb: posts big blind $0.25
*** HOLE CARDS ***
Dealt to d13258d2 
Dealt to Hero [Ah 6d]
Dealt to 2b4254fb 
Dealt to 604f36f0 
Dealt to 6d2a6ab4 
Dealt to a96ed6d7 
604f36f0: folds
6d2a6ab4: folds
a96ed6d7: folds
d13258d2: raises $0.25 to $0.5
Hero: folds
2b4254fb: folds
Uncalled bet ($0.25) returned to d13258d2
*** SHOWDOWN ***
d13258d2 collected $0.6 from pot
*** SUMMARY ***
Total pot $0.6
Seat 1: d13258d2 (button) collected ($0.6)
Seat 2: Hero (small blind) folded before Flop
Seat 3: 2b4254fb (big blind) folded before Flop
Seat 4: 604f36f0 folded before Flop (didn't bet)
Seat 5: 6d2a6ab4 folded before Flop (didn't bet)
Seat 6: a96ed6d7 folded before Flop (didn't bet)


Poker Hand #RC94780967: Hold'em No Limit ($0.1/$0.25) - 2020/04/06 22:47:29
Table 'RushAndCash317136' 6-max Seat #1 is the button
Seat 1: b5d45d73 ($32.97 in chips)
Seat 2: 991e0a0c ($12 in chips)
Seat 3: Hero ($35.26 in chips)
Seat 4: 373b37af ($70.71 in chips)
Seat 5: ea5eba95 ($60.72 in chips)
Seat 6: ca69da65 ($38.59 in chips)
991e0a0c: posts small blind $0.1
Hero: posts big blind $0.25
*** HOLE CARDS ***
Dealt to b5d45d73 
Dealt to 991e0a0c 
Dealt to Hero [Ac 9c]
Dealt to 373b37af 
Dealt to ea5eba95 
Dealt to ca69da65 
373b37af: folds
ea5eba95: folds
ca69da65: folds
b5d45d73: raises $0.38 to $0.63
991e0a0c: raises $1.57 to $2.2
Hero: folds
b5d45d73: folds
Uncalled bet ($1.57) returned to 991e0a0c
*** SHOWDOWN ***
991e0a0c collected $1.51 from pot
*** SUMMARY ***
Total pot $1.51
Seat 1: b5d45d73 (button) folded before Flop
Seat 2: 991e0a0c (small blind) collected ($1.51)
Seat 3: Hero (big blind) folded before Flop
Seat 4: 373b37af folded before Flop (didn't bet)
Seat 5: ea5eba95 folded before Flop (didn't bet)
Seat 6: ca69da65 folded before Flop (didn't bet)


Poker Hand #RC94781052: Hold'em No Limit ($0.1/$0.25) - 2020/04/06 22:47:43
Table 'RushAndCash317148' 6-max Seat #1 is the button
Seat 1: Hero ($35.01 in chips)
Seat 2: 6cdb516f ($44.53 in chips)
Seat 3: 1b328820 ($11.3 in chips)
Seat 4: 8e9cefe9 ($35.71 in chips)
Seat 5: 856c1d9b ($25 in chips)
Seat 6: 2258ad9f ($40.96 in chips)
6cdb516f: posts small blind $0.1
1b328820: posts big blind $0.25
*** HOLE CARDS ***
Dealt to Hero [6h 4d]
Dealt to 6cdb516f 
Dealt to 1b328820 
Dealt to 8e9cefe9 
Dealt to 856c1d9b 
Dealt to 2258ad9f 
8e9cefe9: folds
856c1d9b: folds
2258ad9f: raises $0.38 to $0.63
Hero: folds
6cdb516f: folds
1b328820: folds
Uncalled bet ($0.38) returned to 2258ad9f
*** SHOWDOWN ***
2258ad9f collected $0.6 from pot
*** SUMMARY ***
Total pot $0.6
Seat 1: Hero (button) folded before Flop (didn't bet)
Seat 2: 6cdb516f (small blind) folded before Flop
Seat 3: 1b328820 (big blind) folded before Flop
Seat 4: 8e9cefe9 folded before Flop (didn't bet)
Seat 5: 856c1d9b folded before Flop (didn't bet)
Seat 6: 2258ad9f collected ($0.6)


Poker Hand #RC94781089: Hold'em No Limit ($0.1/$0.25) - 2020/04/06 22:47:49
Table 'RushAndCash317157' 6-max Seat #1 is the button
Seat 1: 7357eb2f ($36.24 in chips)
Seat 2: 6d2a6ab4 ($27.41 in chips)
Seat 3: 55e409c ($37.24 in chips)
Seat 4: Hero ($35.01 in chips)
Seat 5: 5c45646d ($33.23 in chips)
Seat 6: b5d45d73 ($32.34 in chips)
6d2a6ab4: posts small blind $0.1
55e409c: posts big blind $0.25
*** HOLE CARDS ***
Dealt to 7357eb2f 
Dealt to 6d2a6ab4 
Dealt to 55e409c 
Dealt to Hero [Kh 4h]
Dealt to 5c45646d 
Dealt to b5d45d73 
Hero: folds
5c45646d: folds
b5d45d73: folds
7357eb2f: raises $0.38 to $0.63
6d2a6ab4: folds
55e409c: folds
Uncalled bet ($0.38) returned to 7357eb2f
*** SHOWDOWN ***
7357eb2f collected $0.6 from pot
*** SUMMARY ***
Total pot $0.6
Seat 1: 7357eb2f (button) collected ($0.6)
Seat 2: 6d2a6ab4 (small blind) folded before Flop
Seat 3: 55e409c (big blind) folded before Flop
Seat 4: Hero folded before Flop (didn't bet)
Seat 5: 5c45646d folded before Flop (didn't bet)
Seat 6: b5d45d73 folded before Flop (didn't bet)


Poker Hand #RC94781113: Hold'em No Limit ($0.1/$0.25) - 2020/04/06 22:47:54
Table 'RushAndCash317162' 6-max Seat #1 is the button
Seat 1: 1b328820 ($11.05 in chips)
Seat 2: 8a31aea7 ($47.14 in chips)
Seat 3: b981f72b ($25.05 in chips)
Seat 4: 9d598a03 ($27.4 in chips)
Seat 5: ec5f84c3 ($30.25 in chips)
Seat 6: Hero ($35.01 in chips)
8a31aea7: posts small blind $0.1
b981f72b: posts big blind $0.25
*** HOLE CARDS ***
Dealt to 1b328820 
Dealt to 8a31aea7 
Dealt to b981f72b 
Dealt to 9d598a03 
Dealt to ec5f84c3 
Dealt to Hero [9d 4d]
9d598a03: folds
ec5f84c3: folds
Hero: folds
1b328820: folds
8a31aea7: raises $0.5 to $0.75
b981f72b: folds
Uncalled bet ($0.5) returned to 8a31aea7
*** SHOWDOWN ***
8a31aea7 collected $0.5 from pot
*** SUMMARY ***
Total pot $0.5
Seat 1: 1b328820 (button) folded before Flop (didn't bet)
Seat 2: 8a31aea7 (small blind) collected ($0.5)
Seat 3: b981f72b (big blind) folded before Flop
Seat 4: 9d598a03 folded before Flop (didn't bet)
Seat 5: ec5f84c3 folded before Flop (didn't bet)
Seat 6: Hero folded before Flop (didn't bet)


Poker Hand #RC94781132: Hold'em No Limit ($0.1/$0.25) - 2020/04/06 22:47:57
Table 'RushAndCash317167' 6-max Seat #1 is the button
Seat 1: fd957725 ($24.96 in chips)
Seat 2: 55e409c ($36.99 in chips)
Seat 3: 8f2f88a4 ($40.68 in chips)
Seat 4: 2088a691 ($29.46 in chips)
Seat 5: 2258ad9f ($41.31 in chips)
Seat 6: Hero ($35.01 in chips)
55e409c: posts small blind $0.1
8f2f88a4: posts big blind $0.25
*** HOLE CARDS ***
Dealt to fd957725 
Dealt to 55e409c 
Dealt to 8f2f88a4 
Dealt to 2088a691 
Dealt to 2258ad9f 
Dealt to Hero [Js Jh]
2088a691: folds
2258ad9f: folds
Hero: raises $0.38 to $0.63
fd957725: folds
55e409c: folds
8f2f88a4: folds
Uncalled bet ($0.38) returned to Hero
*** SHOWDOWN ***
Hero collected $0.6 from pot
*** SUMMARY ***
Total pot $0.6
Seat 1: fd957725 (button) folded before Flop (didn't bet)
Seat 2: 55e409c (small blind) folded before Flop
Seat 3: 8f2f88a4 (big blind) folded before Flop
Seat 4: 2088a691 folded before Flop (didn't bet)
Seat 5: 2258ad9f folded before Flop (didn't bet)
Seat 6: Hero collected ($0.6)


Poker Hand #RC94781209: Hold'em No Limit ($0.1/$0.25) - 2020/04/06 22:48:11
Table 'RushAndCash317187' 6-max Seat #1 is the button
Seat 1: 7aead3c7 ($27.59 in chips)
Seat 2: 373b37af ($69.96 in chips)
Seat 3: ca69da65 ($38.69 in chips)
Seat 4: 483b0968 ($33.84 in chips)
Seat 5: Hero ($35.36 in chips)
Seat 6: 1b328820 ($11.05 in chips)
373b37af: posts small blind $0.1
ca69da65: posts big blind $0.25
*** HOLE CARDS ***
Dealt to 7aead3c7 
Dealt to 373b37af 
Dealt to ca69da65 
Dealt to 483b0968 
Dealt to Hero [Tc 9h]
Dealt to 1b328820 
483b0968: folds
Hero: folds
1b328820: folds
7aead3c7: folds
373b37af: raises $0.75 to $1
ca69da65: folds
Uncalled bet ($0.75) returned to 373b37af
*** SHOWDOWN ***
373b37af collected $0.5 from pot
*** SUMMARY ***
Total pot $0.5
Seat 1: 7aead3c7 (button) folded before Flop (didn't bet)
Seat 2: 373b37af (small blind) collected ($0.5)
Seat 3: ca69da65 (big blind) folded before Flop
Seat 4: 483b0968 folded before Flop (didn't bet)
Seat 5: Hero folded before Flop (didn't bet)
Seat 6: 1b328820 folded before Flop (didn't bet)


Poker Hand #RC94781234: Hold'em No Limit ($0.1/$0.25) - 2020/04/06 22:48:15
Table 'RushAndCash317192' 6-max Seat #1 is the button
Seat 1: 8a31aea7 ($47.39 in chips)
Seat 2: 95e15d0d ($80.29 in chips)
Seat 3: Hero ($35.36 in chips)
Seat 4: 8f2f88a4 ($40.43 in chips)
Seat 5: b981f72b ($25 in chips)
Seat 6: 483b0968 ($33.84 in chips)
95e15d0d: posts small blind $0.1
Hero: posts big blind $0.25
*** HOLE CARDS ***
Dealt to 8a31aea7 
Dealt to 95e15d0d 
Dealt to Hero [7d 3d]
Dealt to 8f2f88a4 
Dealt to b981f72b 
Dealt to 483b0968 
8f2f88a4: raises $0.3 to $0.55
b981f72b: folds
483b0968: folds
8a31aea7: folds
95e15d0d: folds
Hero: folds
Uncalled bet ($0.3) returned to 8f2f88a4
*** SHOWDOWN ***
8f2f88a4 collected $0.6 from pot
*** SUMMARY ***
Total pot $0.6
Seat 1: 8a31aea7 (button) folded before Flop (didn't bet)
Seat 2: 95e15d0d (small blind) folded before Flop
Seat 3: Hero (big blind) folded before Flop
Seat 4: 8f2f88a4 collected ($0.6)
Seat 5: b981f72b folded before Flop (didn't bet)
Seat 6: 483b0968 folded before Flop (didn't bet)


Poker Hand #RC94781257: Hold'em No Limit ($0.1/$0.25) - 2020/04/06 22:48:19
Table 'RushAndCash317197' 6-max Seat #1 is the button
Seat 1: 94efc628 ($31.17 in chips)
Seat 2: Hero ($35.11 in chips)
Seat 3: 10f87a4a ($43.45 in chips)
Seat 4: 41cf19d5 ($46.78 in chips)
Seat 5: 2b4254fb ($43.89 in chips)
Seat 6: 7aead3c7 ($27.59 in chips)
Hero: posts small blind $0.1
10f87a4a: posts big blind $0.25
*** HOLE CARDS ***
Dealt to 94efc628 
Dealt to Hero [Jc 2d]
Dealt to 10f87a4a 
Dealt to 41cf19d5 
Dealt to 2b4254fb 
Dealt to 7aead3c7 
41cf19d5: folds
2b4254fb: folds
7aead3c7: folds
94efc628: folds
Hero: folds
Uncalled bet ($0.15) returned to 10f87a4a
*** SHOWDOWN ***
10f87a4a collected $0.2 from pot
*** SUMMARY ***
Total pot $0.2
Seat 1: 94efc628 (button) folded before Flop (didn't bet)
Seat 2: Hero (small blind) folded before Flop
Seat 3: 10f87a4a (big blind) collected ($0.2)
Seat 4: 41cf19d5 folded before Flop (didn't bet)
Seat 5: 2b4254fb folded before Flop (didn't bet)
Seat 6: 7aead3c7 folded before Flop (didn't bet)


Poker Hand #RC94781272: Hold'em No Limit ($0.1/$0.25) - 2020/04/06 22:48:23
Table 'RushAndCash317202' 6-max Seat #1 is the button
Seat 1: Hero ($35.01 in chips)
Seat 2: a96ed6d7 ($12.5 in chips)
Seat 3: 67ff4adc ($25 in chips)
Seat 4: dfab8c76 ($27.52 in chips)
Seat 5: 856c1d9b ($25.1 in chips)
Seat 6: beec3332 ($28.37 in chips)
a96ed6d7: posts small blind $0.1
67ff4adc: posts big blind $0.25
*** HOLE CARDS ***
Dealt to Hero [Ad 7h]
Dealt to a96ed6d7 
Dealt to 67ff4adc 
Dealt to dfab8c76 
Dealt to 856c1d9b 
Dealt to beec3332 
dfab8c76: folds
856c1d9b: folds
beec3332: raises $0.5 to $0.75
Hero: folds
a96ed6d7: folds
67ff4adc: folds
Uncalled bet ($0.5) returned to beec3332
*** SHOWDOWN ***
beec3332 collected $0.6 from pot
*** SUMMARY ***
Total pot $0.6
Seat 1: Hero (button) folded before Flop (didn't bet)
Seat 2: a96ed6d7 (small blind) folded before Flop
Seat 3: 67ff4adc (big blind) folded before Flop
Seat 4: dfab8c76 folded before Flop (didn't bet)
Seat 5: 856c1d9b folded before Flop (didn't bet)
Seat 6: beec3332 collected ($0.6)


Poker Hand #RC94781294: Hold'em No Limit ($0.1/$0.25) - 2020/04/06 22:48:26
Table 'RushAndCash317206' 6-max Seat #1 is the button
Seat 1: d1700444 ($36.89 in chips)
Seat 2: 604f36f0 ($31.49 in chips)
Seat 3: eb5021b0 ($44.28 in chips)
Seat 4: Hero ($35.01 in chips)
Seat 5: 6d8f8e0f ($12.5 in chips)
Seat 6: dfab8c76 ($27.52 in chips)
604f36f0: posts small blind $0.1
eb5021b0: posts big blind $0.25
*** HOLE CARDS ***
Dealt to d1700444 
Dealt to 604f36f0 
Dealt to eb5021b0 
Dealt to Hero [Ks Kd]
Dealt to 6d8f8e0f 
Dealt to dfab8c76 
Hero: raises $0.38 to $0.63
6d8f8e0f: calls $0.63
dfab8c76: folds
d1700444: folds
604f36f0: folds
eb5021b0: folds
*** FLOP *** [3d 2h 9d]
Hero: bets $0.87
6d8f8e0f: calls $0.87
*** TURN *** [3d 2h 9d] [Qh]
Hero: bets $2.6
6d8f8e0f: raises $8.4 to $11 and is all-in
Hero: calls $8.4
6d8f8e0f: shows [3s 3c] (Three Treys)
Hero: shows [Ks Kd] (Pair of Kings)
6d8f8e0f: get an all-in insurance (premium ($0/$0.79/$0) for ($0/$12.64/$0) - (Mandatory/Main/Sub))
*** RIVER *** [3d 2h 9d Qh] [8h]
6d8f8e0f: pay premium of all-in insurance ($0.79)
*** SHOWDOWN ***
6d8f8e0f collected $25.35 from pot
*** SUMMARY ***
Total pot $25.35
Board [3d 2h 9d Qh 8h]
Seat 1: d1700444 (button) folded before Flop (didn't bet)
Seat 2: 604f36f0 (small blind) folded before Flop
Seat 3: eb5021b0 (big blind) folded before Flop
Seat 4: Hero showed [Ks Kd] and lost with Pair of Kings
Seat 5: 6d8f8e0f showed [3s 3c] and won ($25.35) with Three Treys, AII Premium ($0.79)
Seat 6: dfab8c76 folded before Flop (didn't bet)


Poker Hand #RC94781578: Hold'em No Limit ($0.1/$0.25) - 2020/04/06 22:49:21
Table 'RushAndCash317265' 6-max Seat #1 is the button
Seat 1: 1b4ad4ae ($25 in chips)
Seat 2: 373b37af ($70.31 in chips)
Seat 3: fe60ae31 ($12.57 in chips)
Seat 4: Hero ($25 in chips)
Seat 5: 604f36f0 ($31.39 in chips)
Seat 6: 6d2a6ab4 ($27.16 in chips)
373b37af: posts small blind $0.1
fe60ae31: posts big blind $0.25
*** HOLE CARDS ***
Dealt to 1b4ad4ae 
Dealt to 373b37af 
Dealt to fe60ae31 
Dealt to Hero [4d 4c]
Dealt to 604f36f0 
Dealt to 6d2a6ab4 
Hero: folds
604f36f0: folds
6d2a6ab4: folds
1b4ad4ae: folds
373b37af: raises $0.75 to $1
fe60ae31: folds
Uncalled bet ($0.75) returned to 373b37af
*** SHOWDOWN ***
373b37af collected $0.5 from pot
*** SUMMARY ***
Total pot $0.5
Seat 1: 1b4ad4ae (button) folded before Flop (didn't bet)
Seat 2: 373b37af (small blind) collected ($0.5)
Seat 3: fe60ae31 (big blind) folded before Flop
Seat 4: Hero folded before Flop (didn't bet)
Seat 5: 604f36f0 folded before Flop (didn't bet)
Seat 6: 6d2a6ab4 folded before Flop (didn't bet)


Poker Hand #RC94781608: Hold'em No Limit ($0.1/$0.25) - 2020/04/06 22:49:28
Table 'RushAndCash317272' 6-max Seat #1 is the button
Seat 1: dfab8c76 ($26.67 in chips)
Seat 2: f229719b ($12.1 in chips)
Seat 3: 2b4254fb ($43.49 in chips)
Seat 4: 856c1d9b ($25.68 in chips)
Seat 5: Hero ($25 in chips)
Seat 6: c9cb3e58 ($104.66 in chips)
f229719b: posts small blind $0.1
2b4254fb: posts big blind $0.25
*** HOLE CARDS ***
Dealt to dfab8c76 
Dealt to f229719b 
Dealt to 2b4254fb 
Dealt to 856c1d9b 
Dealt to Hero [8d 3d]
Dealt to c9cb3e58 
856c1d9b: folds
Hero: folds
c9cb3e58: folds
dfab8c76: folds
f229719b: folds
Uncalled bet ($0.15) returned to 2b4254fb
*** SHOWDOWN ***
2b4254fb collected $0.2 from pot
*** SUMMARY ***
Total pot $0.2
Seat 1: dfab8c76 (button) folded before Flop (didn't bet)
Seat 2: f229719b (small blind) folded before Flop
Seat 3: 2b4254fb (big blind) collected ($0.2)
Seat 4: 856c1d9b folded before Flop (didn't bet)
Seat 5: Hero folded before Flop (didn't bet)
Seat 6: c9cb3e58 folded before Flop (didn't bet)


Poker Hand #RC94781631: Hold'em No Limit ($0.1/$0.25) - 2020/04/06 22:49:32
Table 'RushAndCash317279' 6-max Seat #1 is the button
Seat 1: 28a99893 ($25.68 in chips)
Seat 2: e974fe83 ($35.59 in chips)
Seat 3: Hero ($25 in chips)
Seat 4: 9876d8db ($85.8 in chips)
Seat 5: ce86c7bd ($25.86 in chips)
Seat 6: 604f36f0 ($31.39 in chips)
e974fe83: posts small blind $0.1
Hero: posts big blind $0.25
*** HOLE CARDS ***
Dealt to 28a99893 
Dealt to e974fe83 
Dealt to Hero [Jd 8d]
Dealt to 9876d8db 
Dealt to ce86c7bd 
Dealt to 604f36f0 
9876d8db: raises $0.38 to $0.63
ce86c7bd: folds
604f36f0: folds
28a99893: folds
e974fe83: folds
Hero: folds
Uncalled bet ($0.38) returned to 9876d8db
*** SHOWDOWN ***
9876d8db collected $0.6 from pot
*** SUMMARY ***
Total pot $0.6
Seat 1: 28a99893 (button) folded before Flop (didn't bet)
Seat 2: e974fe83 (small blind) folded before Flop
Seat 3: Hero (big blind) folded before Flop
Seat 4: 9876d8db collected ($0.6)
Seat 5: ce86c7bd folded before Flop (didn't bet)
Seat 6: 604f36f0 folded before Flop (didn't bet)


Poker Hand #RC94781660: Hold'em No Limit ($0.1/$0.25) - 2020/04/06 22:49:36
Table 'RushAndCash317285' 6-max Seat #1 is the button
Seat 1: fe60ae31 ($12.32 in chips)
Seat 2: Hero ($25 in chips)
Seat 3: c259ad40 ($19.35 in chips)
Seat 4: 8a9247b3 ($30.66 in chips)
Seat 5: 2904eaa2 ($25.45 in chips)
Seat 6: f99bdf7f ($18.23 in chips)
Hero: posts small blind $0.1
c259ad40: posts big blind $0.25
*** HOLE CARDS ***
Dealt to fe60ae31 
Dealt to Hero [7d 2h]
Dealt to c259ad40 
Dealt to 8a9247b3 
Dealt to 2904eaa2 
Dealt to f99bdf7f 
8a9247b3: folds
2904eaa2: folds
f99bdf7f: raises $0.25 to $0.5
fe60ae31: folds
Hero: folds
c259ad40: raises $1.1 to $1.6
f99bdf7f: folds
Uncalled bet ($1.1) returned to c259ad40
*** SHOWDOWN ***
c259ad40 collected $1.1 from pot
*** SUMMARY ***
Total pot $1.1
Seat 1: fe60ae31 (button) folded before Flop (didn't bet)
Seat 2: Hero (small blind) folded before Flop
Seat 3: c259ad40 (big blind) collected ($1.1)
Seat 4: 8a9247b3 folded before Flop (didn't bet)
Seat 5: 2904eaa2 folded before Flop (didn't bet)
Seat 6: f99bdf7f folded before Flop


Poker Hand #RC94781685: Hold'em No Limit ($0.1/$0.25) - 2020/04/06 22:49:41
Table 'RushAndCash317290' 6-max Seat #1 is the button
Seat 1: Hero ($25 in chips)
Seat 2: b00dbb18 ($32.71 in chips)
Seat 3: 5c45646d ($33.17 in chips)
Seat 4: eb5021b0 ($52.13 in chips)
Seat 5: 8a9247b3 ($30.66 in chips)
Seat 6: 6ae24a16 ($30.39 in chips)
b00dbb18: posts small blind $0.1
5c45646d: posts big blind $0.25
*** HOLE CARDS ***
Dealt to Hero [Ks 9s]
Dealt to b00dbb18 
Dealt to 5c45646d 
Dealt to eb5021b0 
Dealt to 8a9247b3 
Dealt to 6ae24a16 
eb5021b0: folds
8a9247b3: raises $0.38 to $0.63
6ae24a16: raises $1.63 to $2.26
Hero: folds
b00dbb18: folds
5c45646d: folds
8a9247b3: calls $1.63
*** FLOP *** [7d 9h 4s]
8a9247b3: checks
6ae24a16: bets $1.7
8a9247b3: folds
Uncalled bet ($1.7) returned to 6ae24a16
*** SHOWDOWN ***
6ae24a16 collected $4.87 from pot
*** SUMMARY ***
Total pot $4.87
Board [7d 9h 4s]
Seat 1: Hero (button) folded before Flop (didn't bet)
Seat 2: b00dbb18 (small blind) folded before Flop
Seat 3: 5c45646d (big blind) folded before Flop
Seat 4: eb5021b0 folded before Flop (didn't bet)
Seat 5: 8a9247b3 folded on the Flop
Seat 6: 6ae24a16 won ($4.87)


Poker Hand #RC94781720: Hold'em No Limit ($0.1/$0.25) - 2020/04/06 22:49:48
Table 'RushAndCash317296' 6-max Seat #1 is the button
Seat 1: 9d598a03 ($32.72 in chips)
Seat 2: 1b328820 ($11.15 in chips)
Seat 3: c9cb3e58 ($104.56 in chips)
Seat 4: Hero ($25 in chips)
Seat 5: beec3332 ($29.42 in chips)
Seat 6: 41cf19d5 ($45.45 in chips)
1b328820: posts small blind $0.1
c9cb3e58: posts big blind $0.25
*** HOLE CARDS ***
Dealt to 9d598a03 
Dealt to 1b328820 
Dealt to c9cb3e58 
Dealt to Hero [Ac 9d]
Dealt to beec3332 
Dealt to 41cf19d5 
Hero: folds
beec3332: folds
41cf19d5: folds
9d598a03: folds
1b328820: raises $0.38 to $0.63
c9cb3e58: calls $0.38
*** FLOP *** [5c 2s 9h]
1b328820: checks
c9cb3e58: bets $0.5
1b328820: calls $0.5
*** TURN *** [5c 2s 9h] [6s]
1b328820: checks
c9cb3e58: bets $2.25
1b328820: folds
Uncalled bet ($2.25) returned to c9cb3e58
*** SHOWDOWN ***
c9cb3e58 collected $2.26 from pot
*** SUMMARY ***
Total pot $2.26
Board [5c 2s 9h 6s]
Seat 1: 9d598a03 (button) folded before Flop (didn't bet)
Seat 2: 1b328820 (small blind) folded on the Turn
Seat 3: c9cb3e58 (big blind) won ($2.26)
Seat 4: Hero folded before Flop (didn't bet)
Seat 5: beec3332 folded before Flop (didn't bet)
Seat 6: 41cf19d5 folded before Flop (didn't bet)


Poker Hand #RC94781740: Hold'em No Limit ($0.1/$0.25) - 2020/04/06 22:49:52
Table 'RushAndCash317299' 6-max Seat #1 is the button
Seat 1: e974fe83 ($35.49 in chips)
Seat 2: f1eff963 ($12.5 in chips)
Seat 3: 9645b49f ($25 in chips)
Seat 4: ea5eba95 ($65.47 in chips)
Seat 5: Hero ($25 in chips)
Seat 6: 84ec2b3a ($30.01 in chips)
f1eff963: posts small blind $0.1
9645b49f: posts big blind $0.25
*** HOLE CARDS ***
Dealt to e974fe83 
Dealt to f1eff963 
Dealt to 9645b49f 
Dealt to ea5eba95 
Dealt to Hero [Kd 9s]
Dealt to 84ec2b3a 
ea5eba95: raises $0.38 to $0.63
Hero: folds
84ec2b3a: folds
e974fe83: folds
f1eff963: folds
9645b49f: calls $0.38
*** FLOP *** [Th 3s 5d]
9645b49f: checks
ea5eba95: checks
*** TURN *** [Th 3s 5d] [Ts]
9645b49f: checks
ea5eba95: bets $0.7
9645b49f: folds
Uncalled bet ($0.7) returned to ea5eba95
*** SHOWDOWN ***
ea5eba95 collected $1.36 from pot
*** SUMMARY ***
Total pot $1.36
Board [Th 3s 5d Ts]
Seat 1: e974fe83 (button) folded before Flop (didn't bet)
Seat 2: f1eff963 (small blind) folded before Flop
Seat 3: 9645b49f (big blind) folded on the Turn
Seat 4: ea5eba95 won ($1.36)
Seat 5: Hero folded before Flop (didn't bet)
Seat 6: 84ec2b3a folded before Flop (didn't bet)


Poker Hand #RC94781763: Hold'em No Limit ($0.1/$0.25) - 2020/04/06 22:49:56
Table 'RushAndCash317304' 6-max Seat #1 is the button
Seat 1: 5c45646d ($32.92 in chips)
Seat 2: c259ad40 ($19.9 in chips)
Seat 3: 2467bb49 ($52.46 in chips)
Seat 4: 373b37af ($70.31 in chips)
Seat 5: beec3332 ($29.42 in chips)
Seat 6: Hero ($25 in chips)
c259ad40: posts small blind $0.1
2467bb49: posts big blind $0.25
*** HOLE CARDS ***
Dealt to 5c45646d 
Dealt to c259ad40 
Dealt to 2467bb49 
Dealt to 373b37af 
Dealt to beec3332 
Dealt to Hero [4d 2s]
373b37af: folds
beec3332: folds
Hero: folds
5c45646d: folds
c259ad40: folds
Uncalled bet ($0.15) returned to 2467bb49
*** SHOWDOWN ***
2467bb49 collected $0.2 from pot
*** SUMMARY ***
Total pot $0.2
Seat 1: 5c45646d (button) folded before Flop (didn't bet)
Seat 2: c259ad40 (small blind) folded before Flop
Seat 3: 2467bb49 (big blind) collected ($0.2)
Seat 4: 373b37af folded before Flop (didn't bet)
Seat 5: beec3332 folded before Flop (didn't bet)
Seat 6: Hero folded before Flop (didn't bet)


Poker Hand #RC94781791: Hold'em No Limit ($0.1/$0.25) - 2020/04/06 22:50:01
Table 'RushAndCash317310' 6-max Seat #1 is the button
Seat 1: c259ad40 ($19.8 in chips)
Seat 2: e3e3827d ($32.8 in chips)
Seat 3: Hero ($25 in chips)
Seat 4: dfab8c76 ($26.57 in chips)
Seat 5: f1eff963 ($12.85 in chips)
Seat 6: fecc1b7e ($34.68 in chips)
e3e3827d: posts small blind $0.1
Hero: posts big blind $0.25
*** HOLE CARDS ***
Dealt to c259ad40 
Dealt to e3e3827d 
Dealt to Hero [Th 5h]
Dealt to dfab8c76 
Dealt to f1eff963 
Dealt to fecc1b7e 
dfab8c76: folds
f1eff963: folds
fecc1b7e: raises $0.38 to $0.63
c259ad40: folds
e3e3827d: raises $2.07 to $2.7
Hero: folds
fecc1b7e: calls $2.07
*** FLOP *** [Kc Kd Ah]
e3e3827d: bets $1.9
fecc1b7e: calls $1.9
*** TURN *** [Kc Kd Ah] [4s]
e3e3827d: checks
fecc1b7e: checks
*** RIVER *** [Kc Kd Ah 4s] [7h]
e3e3827d: checks
fecc1b7e: checks
e3e3827d: shows [8d 8s] (Pair of Kings and Pair of Eights)
fecc1b7e: shows [8c Ac] (Pair of Aces and Pair of Kings)
*** SHOWDOWN ***
fecc1b7e collected $9.45 from pot
*** SUMMARY ***
Total pot $9.45
Board [Kc Kd Ah 4s 7h]
Seat 1: c259ad40 (button) folded before Flop (didn't bet)
Seat 2: e3e3827d (small blind) showed [8s 8d] and lost with Pair of Kings and Pair of Eights
Seat 3: Hero (big blind) folded before Flop
Seat 4: dfab8c76 folded before Flop (didn't bet)
Seat 5: f1eff963 folded before Flop (didn't bet)
Seat 6: fecc1b7e showed [Ac 8c] and won ($9.45) with Pair of Aces and Pair of Kings


Poker Hand #RC94781817: Hold'em No Limit ($0.1/$0.25) - 2020/04/06 22:50:05
Table 'RushAndCash317315' 6-max Seat #1 is the button
Seat 1: beec3332 ($29.42 in chips)
Seat 2: Hero ($25 in chips)
Seat 3: fd369e31 ($63.37 in chips)
Seat 4: 991e0a0c ($14.17 in chips)
Seat 5: f1eff963 ($12.85 in chips)
Seat 6: c259ad40 ($19.8 in chips)
Hero: posts small blind $0.1
fd369e31: posts big blind $0.25
*** HOLE CARDS ***
Dealt to beec3332 
Dealt to Hero [8c 4d]
Dealt to fd369e31 
Dealt to 991e0a0c 
Dealt to f1eff963 
Dealt to c259ad40 
991e0a0c: folds
f1eff963: folds
c259ad40: raises $0.5 to $0.75
beec3332: folds
Hero: folds
fd369e31: calls $0.5
*** FLOP *** [Jh 6h Ks]
fd369e31: checks
c259ad40: bets $1.2
fd369e31: folds
Uncalled bet ($1.2) returned to c259ad40
*** SHOWDOWN ***
c259ad40 collected $1.6 from pot
*** SUMMARY ***
Total pot $1.6
Board [Jh 6h Ks]
Seat 1: beec3332 (button) folded before Flop (didn't bet)
Seat 2: Hero (small blind) folded before Flop
Seat 3: fd369e31 (big blind) folded on the Flop
Seat 4: 991e0a0c folded before Flop (didn't bet)
Seat 5: f1eff963 folded before Flop (didn't bet)
Seat 6: c259ad40 won ($1.6)


Poker Hand #RC94781849: Hold'em No Limit ($0.1/$0.25) - 2020/04/06 22:50:11
Table 'RushAndCash317321' 6-max Seat #1 is the button
Seat 1: Hero ($25 in chips)
Seat 2: f229719b ($11.75 in chips)
Seat 3: 483b0968 ($34.61 in chips)
Seat 4: fd957725 ($22.31 in chips)
Seat 5: f8b1513e ($35.34 in chips)
Seat 6: 6c4de438 ($12.81 in chips)
f229719b: posts small blind $0.1
483b0968: posts big blind $0.25
*** HOLE CARDS ***
Dealt to Hero [Ks 7h]
Dealt to f229719b 
Dealt to 483b0968 
Dealt to fd957725 
Dealt to f8b1513e 
Dealt to 6c4de438 
fd957725: folds
f8b1513e: folds
6c4de438: folds
Hero: folds
f229719b: raises $0.25 to $0.5
483b0968: folds
Uncalled bet ($0.25) returned to f229719b
*** SHOWDOWN ***
f229719b collected $0.5 from pot
*** SUMMARY ***
Total pot $0.5
Seat 1: Hero (button) folded before Flop (didn't bet)
Seat 2: f229719b (small blind) collected ($0.5)
Seat 3: 483b0968 (big blind) folded before Flop
Seat 4: fd957725 folded before Flop (didn't bet)
Seat 5: f8b1513e folded before Flop (didn't bet)
Seat 6: 6c4de438 folded before Flop (didn't bet)


Poker Hand #RC94781869: Hold'em No Limit ($0.1/$0.25) - 2020/04/06 22:50:15
Table 'RushAndCash317325' 6-max Seat #1 is the button
Seat 1: 856c1d9b ($25.93 in chips)
Seat 2: 8a9247b3 ($28.15 in chips)
Seat 3: ec5f84c3 ($30.08 in chips)
Seat 4: fbdd6126 ($13.85 in chips)
Seat 5: 1635b50e ($25 in chips)
Seat 6: Hero ($25 in chips)
8a9247b3: posts small blind $0.1
ec5f84c3: posts big blind $0.25
*** HOLE CARDS ***
Dealt to 856c1d9b 
Dealt to 8a9247b3 
Dealt to ec5f84c3 
Dealt to fbdd6126 
Dealt to 1635b50e 
Dealt to Hero [Ts Tc]
fbdd6126: folds
1635b50e: calls $0.25
Hero: raises $0.65 to $0.9
856c1d9b: folds
8a9247b3: folds
ec5f84c3: folds
1635b50e: calls $0.65
*** FLOP *** [8h 8d Qh]
1635b50e: checks
Hero: checks
*** TURN *** [8h 8d Qh] [Ac]
1635b50e: checks
Hero: checks
*** RIVER *** [8h 8d Qh Ac] [7c]
1635b50e: bets $0.8
Hero: calls $0.8
1635b50e: shows [5h Ah] (Pair of Aces and Pair of Eights)
Hero: shows [Ts Tc] (Pair of Tens and Pair of Eights)
*** SHOWDOWN ***
1635b50e collected $3.75 from pot
*** SUMMARY ***
Total pot $3.75
Board [8h 8d Qh Ac 7c]
Seat 1: 856c1d9b (button) folded before Flop (didn't bet)
Seat 2: 8a9247b3 (small blind) folded before Flop
Seat 3: ec5f84c3 (big blind) folded before Flop
Seat 4: fbdd6126 folded before Flop (didn't bet)
Seat 5: 1635b50e showed [Ah 5h] and won ($3.75) with Pair of Aces and Pair of Eights
Seat 6: Hero showed [Ts Tc] and lost with Pair of Tens and Pair of Eights


Poker Hand #RC94782217: Hold'em No Limit ($0.1/$0.25) - 2020/04/06 22:51:17
Table 'RushAndCash317397' 6-max Seat #1 is the button
Seat 1: 62d4309c ($31.5 in chips)
Seat 2: 95e15d0d ($79.14 in chips)
Seat 3: ba032eea ($33.31 in chips)
Seat 4: 94efc628 ($36.58 in chips)
Seat 5: 11dda850 ($25 in chips)
Seat 6: Hero ($25 in chips)
95e15d0d: posts small blind $0.1
ba032eea: posts big blind $0.25
*** HOLE CARDS ***
Dealt to 62d4309c 
Dealt to 95e15d0d 
Dealt to ba032eea 
Dealt to 94efc628 
Dealt to 11dda850 
Dealt to Hero [Qc 2d]
94efc628: folds
11dda850: folds
Hero: folds
62d4309c: raises $0.38 to $0.63
95e15d0d: folds
ba032eea: folds
Uncalled bet ($0.38) returned to 62d4309c
*** SHOWDOWN ***
62d4309c collected $0.6 from pot
*** SUMMARY ***
Total pot $0.6
Seat 1: 62d4309c (button) collected ($0.6)
Seat 2: 95e15d0d (small blind) folded before Flop
Seat 3: ba032eea (big blind) folded before Flop
Seat 4: 94efc628 folded before Flop (didn't bet)
Seat 5: 11dda850 folded before Flop (didn't bet)
Seat 6: Hero folded before Flop (didn't bet)


Poker Hand #RC94782238: Hold'em No Limit ($0.1/$0.25) - 2020/04/06 22:51:21
Table 'RushAndCash317400' 6-max Seat #1 is the button
Seat 1: 6d2a6ab4 ($26.53 in chips)
Seat 2: dfab8c76 ($26.07 in chips)
Seat 3: 2aa6d89 ($21.44 in chips)
Seat 4: Hero ($25 in chips)
Seat 5: 55e409c ($47.73 in chips)
Seat 6: beec3332 ($29.77 in chips)
dfab8c76: posts small blind $0.1
2aa6d89: posts big blind $0.25
*** HOLE CARDS ***
Dealt to 6d2a6ab4 
Dealt to dfab8c76 
Dealt to 2aa6d89 
Dealt to Hero [Ac 9c]
Dealt to 55e409c 
Dealt to beec3332 
Hero: raises $0.38 to $0.63
55e409c: folds
beec3332: folds
6d2a6ab4: folds
dfab8c76: folds
2aa6d89: folds
Uncalled bet ($0.38) returned to Hero
*** SHOWDOWN ***
Hero collected $0.6 from pot
*** SUMMARY ***
Total pot $0.6
Seat 1: 6d2a6ab4 (button) folded before Flop (didn't bet)
Seat 2: dfab8c76 (small blind) folded before Flop
Seat 3: 2aa6d89 (big blind) folded before Flop
Seat 4: Hero collected ($0.6)
Seat 5: 55e409c folded before Flop (didn't bet)
Seat 6: beec3332 folded before Flop (didn't bet)


Poker Hand #RC94782324: Hold'em No Limit ($0.1/$0.25) - 2020/04/06 22:51:36
Table 'RushAndCash317414' 6-max Seat #1 is the button
Seat 1: 739b1a3d ($33.94 in chips)
Seat 2: 62d4309c ($31.85 in chips)
Seat 3: Hero ($25.35 in chips)
Seat 4: e3e3827d ($27.95 in chips)
Seat 5: f8b1513e ($34.89 in chips)
Seat 6: 2258ad9f ($42.7 in chips)
62d4309c: posts small blind $0.1
Hero: posts big blind $0.25
*** HOLE CARDS ***
Dealt to 739b1a3d 
Dealt to 62d4309c 
Dealt to Hero [8s 4c]
Dealt to e3e3827d 
Dealt to f8b1513e 
Dealt to 2258ad9f 
e3e3827d: folds
f8b1513e: folds
2258ad9f: folds
739b1a3d: folds
62d4309c: folds
Uncalled bet ($0.15) returned to Hero
*** SHOWDOWN ***
Hero collected $0.2 from pot
*** SUMMARY ***
Total pot $0.2
Seat 1: 739b1a3d (button) folded before Flop (didn't bet)
Seat 2: 62d4309c (small blind) folded before Flop
Seat 3: Hero (big blind) collected ($0.2)
Seat 4: e3e3827d folded before Flop (didn't bet)
Seat 5: f8b1513e folded before Flop (didn't bet)
Seat 6: 2258ad9f folded before Flop (didn't bet)


Poker Hand #RC94782344: Hold'em No Limit ($0.1/$0.25) - 2020/04/06 22:51:40
Table 'RushAndCash317418' 6-max Seat #1 is the button
Seat 1: 1de57a80 ($25 in chips)
Seat 2: Hero ($25.1 in chips)
Seat 3: afc178f9 ($30.21 in chips)
Seat 4: fe60ae31 ($12.22 in chips)
Seat 5: 7aead3c7 ($21.36 in chips)
Seat 6: 8cda51b0 ($26.35 in chips)
Hero: posts small blind $0.1
afc178f9: posts big blind $0.25
*** HOLE CARDS ***
Dealt to 1de57a80 
Dealt to Hero [6d 5d]
Dealt to afc178f9 
Dealt to fe60ae31 
Dealt to 7aead3c7 
Dealt to 8cda51b0 
fe60ae31: folds
7aead3c7: folds
8cda51b0: folds
1de57a80: raises $0.38 to $0.63
Hero: folds
afc178f9: folds
Uncalled bet ($0.38) returned to 1de57a80
*** SHOWDOWN ***
1de57a80 collected $0.6 from pot
*** SUMMARY ***
Total pot $0.6
Seat 1: 1de57a80 (button) collected ($0.6)
Seat 2: Hero (small blind) folded before Flop
Seat 3: afc178f9 (big blind) folded before Flop
Seat 4: fe60ae31 folded before Flop (didn't bet)
Seat 5: 7aead3c7 folded before Flop (didn't bet)
Seat 6: 8cda51b0 folded before Flop (didn't bet)


Poker Hand #RC94782358: Hold'em No Limit ($0.1/$0.25) - 2020/04/06 22:51:44
Table 'RushAndCash317420' 6-max Seat #1 is the button
Seat 1: Hero ($25 in chips)
Seat 2: 6c4de438 ($14.4 in chips)
Seat 3: 2aa6d89 ($21.09 in chips)
Seat 4: e3e3827d ($27.95 in chips)
Seat 5: ba032eea ($33.06 in chips)
Seat 6: b00dbb18 ($32.01 in chips)
6c4de438: posts small blind $0.1
2aa6d89: posts big blind $0.25
*** HOLE CARDS ***
Dealt to Hero [Qh Jh]
Dealt to 6c4de438 
Dealt to 2aa6d89 
Dealt to e3e3827d 
Dealt to ba032eea 
Dealt to b00dbb18 
e3e3827d: folds
ba032eea: folds
b00dbb18: folds
Hero: raises $0.38 to $0.63
6c4de438: folds
2aa6d89: folds
Uncalled bet ($0.38) returned to Hero
*** SHOWDOWN ***
Hero collected $0.6 from pot
*** SUMMARY ***
Total pot $0.6
Seat 1: Hero (button) collected ($0.6)
Seat 2: 6c4de438 (small blind) folded before Flop
Seat 3: 2aa6d89 (big blind) folded before Flop
Seat 4: e3e3827d folded before Flop (didn't bet)
Seat 5: ba032eea folded before Flop (didn't bet)
Seat 6: b00dbb18 folded before Flop (didn't bet)


Poker Hand #RC94782478: Hold'em No Limit ($0.1/$0.25) - 2020/04/06 22:52:06
Table 'RushAndCash317445' 6-max Seat #1 is the button
Seat 1: ec5f84c3 ($29 in chips)
Seat 2: fecc1b7e ($39.16 in chips)
Seat 3: 5e03da34 ($36.43 in chips)
Seat 4: 9645b49f ($25.71 in chips)
Seat 5: d1700444 ($45.74 in chips)
Seat 6: Hero ($25.7 in chips)
fecc1b7e: posts small blind $0.1
5e03da34: posts big blind $0.25
*** HOLE CARDS ***
Dealt to ec5f84c3 
Dealt to fecc1b7e 
Dealt to 5e03da34 
Dealt to 9645b49f 
Dealt to d1700444 
Dealt to Hero [8d 4s]
9645b49f: folds
d1700444: raises $0.38 to $0.63
Hero: folds
ec5f84c3: calls $0.63
fecc1b7e: folds
5e03da34: calls $0.38
*** FLOP *** [Ac 8h 6d]
5e03da34: checks
d1700444: bets $1
ec5f84c3: calls $1
5e03da34: folds
*** TURN *** [Ac 8h 6d] [Jc]
d1700444: checks
ec5f84c3: bets $2.7
d1700444: calls $2.7
*** RIVER *** [Ac 8h 6d Jc] [Qd]
d1700444: checks
ec5f84c3: checks
d1700444: shows [Qh Ah] (Pair of Aces and Pair of Queens)
ec5f84c3: shows [5c 7c] (Ace-High)
*** SHOWDOWN ***
d1700444 collected $9.39 from pot
*** SUMMARY ***
Total pot $9.39
Board [Ac 8h 6d Jc Qd]
Seat 1: ec5f84c3 (button) showed [7c 5c] and lost with Ace-High
Seat 2: fecc1b7e (small blind) folded before Flop
Seat 3: 5e03da34 (big blind) folded on the Flop
Seat 4: 9645b49f folded before Flop (didn't bet)
Seat 5: d1700444 showed [Ah Qh] and won ($9.39) with Pair of Aces and Pair of Queens
Seat 6: Hero folded before Flop (didn't bet)


Poker Hand #RC94782502: Hold'em No Limit ($0.1/$0.25) - 2020/04/06 22:52:10
Table 'RushAndCash317450' 6-max Seat #1 is the button
Seat 1: fe60ae31 ($11.87 in chips)
Seat 2: f8b1513e ($33.91 in chips)
Seat 3: 7357eb2f ($36.21 in chips)
Seat 4: Hero ($25.7 in chips)
Seat 5: 1de57a80 ($25 in chips)
Seat 6: beec3332 ($29.42 in chips)
f8b1513e: posts small blind $0.1
7357eb2f: posts big blind $0.25
*** HOLE CARDS ***
Dealt to fe60ae31 
Dealt to f8b1513e 
Dealt to 7357eb2f 
Dealt to Hero [9d 4s]
Dealt to 1de57a80 
Dealt to beec3332 
Hero: folds
1de57a80: folds
beec3332: raises $0.5 to $0.75
fe60ae31: folds
f8b1513e: folds
7357eb2f: calls $0.5
*** FLOP *** [7c 6h 5h]
7357eb2f: checks
beec3332: checks
*** TURN *** [7c 6h 5h] [7d]
7357eb2f: bets $0.8
beec3332: folds
Uncalled bet ($0.8) returned to 7357eb2f
*** SHOWDOWN ***
7357eb2f collected $1.6 from pot
*** SUMMARY ***
Total pot $1.6
Board [7c 6h 5h 7d]
Seat 1: fe60ae31 (button) folded before Flop (didn't bet)
Seat 2: f8b1513e (small blind) folded before Flop
Seat 3: 7357eb2f (big blind) won ($1.6)
Seat 4: Hero folded before Flop (didn't bet)
Seat 5: 1de57a80 folded before Flop (didn't bet)
Seat 6: beec3332 folded on the Turn


Poker Hand #RC94782525: Hold'em No Limit ($0.1/$0.25) - 2020/04/06 22:52:15
Table 'RushAndCash317455' 6-max Seat #1 is the button
Seat 1: 9d598a03 ($38.97 in chips)
Seat 2: 93b71bcb ($45.22 in chips)
Seat 3: 17480666 ($79.41 in chips)
Seat 4: 41cf19d5 ($45.52 in chips)
Seat 5: 2467bb49 ($30.85 in chips)
Seat 6: Hero ($25.7 in chips)
93b71bcb: posts small blind $0.1
17480666: posts big blind $0.25
*** HOLE CARDS ***
Dealt to 9d598a03 
Dealt to 93b71bcb 
Dealt to 17480666 
Dealt to 41cf19d5 
Dealt to 2467bb49 
Dealt to Hero [Jd Td]
41cf19d5: raises $0.38 to $0.63
2467bb49: folds
Hero: folds
9d598a03: folds
93b71bcb: folds
17480666: folds
Uncalled bet ($0.38) returned to 41cf19d5
*** SHOWDOWN ***
41cf19d5 collected $0.6 from pot
*** SUMMARY ***
Total pot $0.6
Seat 1: 9d598a03 (button) folded before Flop (didn't bet)
Seat 2: 93b71bcb (small blind) folded before Flop
Seat 3: 17480666 (big blind) folded before Flop
Seat 4: 41cf19d5 collected ($0.6)
Seat 5: 2467bb49 folded before Flop (didn't bet)
Seat 6: Hero folded before Flop (didn't bet)


Poker Hand #RC94782572: Hold'em No Limit ($0.1/$0.25) - 2020/04/06 22:52:23
Table 'RushAndCash317462' 6-max Seat #1 is the button
Seat 1: 6b202021 ($10.92 in chips)
Seat 2: bd6eeaf3 ($45.19 in chips)
Seat 3: Hero ($25.7 in chips)
Seat 4: b981f72b ($25 in chips)
Seat 5: e2e66d9b ($110.8 in chips)
Seat 6: 6c4de438 ($14.05 in chips)
bd6eeaf3: posts small blind $0.1
Hero: posts big blind $0.25
*** HOLE CARDS ***
Dealt to 6b202021 
Dealt to bd6eeaf3 
Dealt to Hero [Qc 3d]
Dealt to b981f72b 
Dealt to e2e66d9b 
Dealt to 6c4de438 
b981f72b: folds
e2e66d9b: folds
6c4de438: raises $0.5 to $0.75
6b202021: folds
bd6eeaf3: folds
Hero: folds
Uncalled bet ($0.5) returned to 6c4de438
*** SHOWDOWN ***
6c4de438 collected $0.6 from pot
*** SUMMARY ***
Total pot $0.6
Seat 1: 6b202021 (button) folded before Flop (didn't bet)
Seat 2: bd6eeaf3 (small blind) folded before Flop
Seat 3: Hero (big blind) folded before Flop
Seat 4: b981f72b folded before Flop (didn't bet)
Seat 5: e2e66d9b folded before Flop (didn't bet)
Seat 6: 6c4de438 collected ($0.6)


Poker Hand #RC94782617: Hold'em No Limit ($0.1/$0.25) - 2020/04/06 22:52:33
Table 'RushAndCash317471' 6-max Seat #1 is the button
Seat 1: 9876d8db ($88.98 in chips)
Seat 2: Hero ($25.45 in chips)
Seat 3: d13258d2 ($5.32 in chips)
Seat 4: dfab8c76 ($25.97 in chips)
Seat 5: 2904eaa2 ($25.53 in chips)
Seat 6: 6ae24a16 ($33.19 in chips)
Hero: posts small blind $0.1
d13258d2: posts big blind $0.25
*** HOLE CARDS ***
Dealt to 9876d8db 
Dealt to Hero [6h 4h]
Dealt to d13258d2 
Dealt to dfab8c76 
Dealt to 2904eaa2 
Dealt to 6ae24a16 
dfab8c76: folds
2904eaa2: folds
6ae24a16: raises $0.38 to $0.63
9876d8db: folds
Hero: folds
d13258d2: raises $4.69 to $5.32 and is all-in
6ae24a16: calls $4.69
d13258d2: shows [As 9s]
6ae24a16: shows [Qc Ad]
*** FLOP *** [2c 7d Kc]
*** TURN *** [2c 7d Kc] [2s]
*** RIVER *** [2c 7d Kc 2s] [Kh]
*** SHOWDOWN ***
d13258d2 collected $5.37 from pot
6ae24a16 collected $5.37 from pot
*** SUMMARY ***
Total pot $10.74
Board [2c 7d Kc 2s Kh]
Seat 1: 9876d8db (button) folded before Flop (didn't bet)
Seat 2: Hero (small blind) folded before Flop
Seat 3: d13258d2 (big blind) showed [As 9s] and won ($5.37) with Pair of Kings and Pair of Twos
Seat 4: dfab8c76 folded before Flop (didn't bet)
Seat 5: 2904eaa2 folded before Flop (didn't bet)
Seat 6: 6ae24a16 showed [Ad Qc] and won ($5.37) with Pair of Kings and Pair of Twos


Poker Hand #RC94782655: Hold'em No Limit ($0.1/$0.25) - 2020/04/06 22:52:40
Table 'RushAndCash317478' 6-max Seat #1 is the button
Seat 1: Hero ($25.35 in chips)
Seat 2: b00dbb18 ($31.76 in chips)
Seat 3: f99bdf7f ($16.78 in chips)
Seat 4: 41cf19d5 ($45.52 in chips)
Seat 5: ea5eba95 ($56.42 in chips)
Seat 6: 83e38e49 ($54.87 in chips)
b00dbb18: posts small blind $0.1
f99bdf7f: posts big blind $0.25
*** HOLE CARDS ***
Dealt to Hero [As 4d]
Dealt to b00dbb18 
Dealt to f99bdf7f 
Dealt to 41cf19d5 
Dealt to ea5eba95 
Dealt to 83e38e49 
41cf19d5: folds
ea5eba95: folds
83e38e49: folds
Hero: folds
b00dbb18: raises $0.5 to $0.75
f99bdf7f: folds
Uncalled bet ($0.5) returned to b00dbb18
*** SHOWDOWN ***
b00dbb18 collected $0.5 from pot
*** SUMMARY ***
Total pot $0.5
Seat 1: Hero (button) folded before Flop (didn't bet)
Seat 2: b00dbb18 (small blind) collected ($0.5)
Seat 3: f99bdf7f (big blind) folded before Flop
Seat 4: 41cf19d5 folded before Flop (didn't bet)
Seat 5: ea5eba95 folded before Flop (didn't bet)
Seat 6: 83e38e49 folded before Flop (didn't bet)


Poker Hand #RC94782680: Hold'em No Limit ($0.1/$0.25) - 2020/04/06 22:52:45
Table 'RushAndCash317483' 6-max Seat #1 is the button
Seat 1: 41cf19d5 ($45.52 in chips)
Seat 2: 83e38e49 ($54.87 in chips)
Seat 3: 92aca4e8 ($26.14 in chips)
Seat 4: ea5eba95 ($56.42 in chips)
Seat 5: Hero ($25.35 in chips)
Seat 6: f1eff963 ($12.5 in chips)
83e38e49: posts small blind $0.1
92aca4e8: posts big blind $0.25
*** HOLE CARDS ***
Dealt to 41cf19d5 
Dealt to 83e38e49 
Dealt to 92aca4e8 
Dealt to ea5eba95 
Dealt to Hero [9h 7h]
Dealt to f1eff963 
ea5eba95: raises $0.38 to $0.63
Hero: folds
f1eff963: folds
41cf19d5: folds
83e38e49: folds
92aca4e8: calls $0.38
*** FLOP *** [Jh 6d 5c]
92aca4e8: checks
ea5eba95: checks
*** TURN *** [Jh 6d 5c] [Td]
92aca4e8: bets $1.1
ea5eba95: calls $1.1
*** RIVER *** [Jh 6d 5c Td] [Th]
92aca4e8: checks
ea5eba95: checks
92aca4e8: shows [Ah Jc] (Pair of Jacks and Pair of Tens)
ea5eba95: shows [As Ks] (Pair of Tens)
*** SHOWDOWN ***
92aca4e8 collected $3.56 from pot
*** SUMMARY ***
Total pot $3.56
Board [Jh 6d 5c Td Th]
Seat 1: 41cf19d5 (button) folded before Flop (didn't bet)
Seat 2: 83e38e49 (small blind) folded before Flop
Seat 3: 92aca4e8 (big blind) showed [Ah Jc] and won ($3.56) with Pair of Jacks and Pair of Tens
Seat 4: ea5eba95 showed [As Ks] and lost with Pair of Tens
Seat 5: Hero folded before Flop (didn't bet)
Seat 6: f1eff963 folded before Flop (didn't bet)


Poker Hand #RC94782709: Hold'em No Limit ($0.1/$0.25) - 2020/04/06 22:52:51
Table 'RushAndCash317489' 6-max Seat #1 is the button
Seat 1: 991e0a0c ($14.41 in chips)
Seat 2: 10f87a4a ($44.81 in chips)
Seat 3: 83e38e49 ($54.77 in chips)
Seat 4: 578f9607 ($25.1 in chips)
Seat 5: Hero ($25.35 in chips)
Seat 6: bd6eeaf3 ($45.09 in chips)
10f87a4a: posts small blind $0.1
83e38e49: posts big blind $0.25
*** HOLE CARDS ***
Dealt to 991e0a0c 
Dealt to 10f87a4a 
Dealt to 83e38e49 
Dealt to 578f9607 
Dealt to Hero [6d 3s]
Dealt to bd6eeaf3 
578f9607: folds
Hero: folds
bd6eeaf3: folds
991e0a0c: raises $0.25 to $0.5
10f87a4a: folds
83e38e49: folds
Uncalled bet ($0.25) returned to 991e0a0c
*** SHOWDOWN ***
991e0a0c collected $0.6 from pot
*** SUMMARY ***
Total pot $0.6
Seat 1: 991e0a0c (button) collected ($0.6)
Seat 2: 10f87a4a (small blind) folded before Flop
Seat 3: 83e38e49 (big blind) folded before Flop
Seat 4: 578f9607 folded before Flop (didn't bet)
Seat 5: Hero folded before Flop (didn't bet)
Seat 6: bd6eeaf3 folded before Flop (didn't bet)


Poker Hand #RC94782726: Hold'em No Limit ($0.1/$0.25) - 2020/04/06 22:52:54
Table 'RushAndCash317492' 6-max Seat #1 is the button
Seat 1: 8a31aea7 ($48.38 in chips)
Seat 2: 9d598a03 ($38.72 in chips)
Seat 3: ca69da65 ($37.65 in chips)
Seat 4: f4ce525 ($25.29 in chips)
Seat 5: Hero ($25.35 in chips)
Seat 6: f8b1513e ($34.48 in chips)
9d598a03: posts small blind $0.1
ca69da65: posts big blind $0.25
*** HOLE CARDS ***
Dealt to 8a31aea7 
Dealt to 9d598a03 
Dealt to ca69da65 
Dealt to f4ce525 
Dealt to Hero [As 6s]
Dealt to f8b1513e 
f4ce525: folds
Hero: raises $0.38 to $0.63
f8b1513e: folds
8a31aea7: raises $1.38 to $2.01
9d598a03: folds
ca69da65: folds
Hero: calls $1.38
*** FLOP *** [2c Ac 6d]
Hero: checks
8a31aea7: bets $1.5
Hero: raises $4.1 to $5.6
8a31aea7: folds
Uncalled bet ($4.1) returned to Hero
*** SHOWDOWN ***
Hero collected $7.37 from pot
*** SUMMARY ***
Total pot $7.37
Board [2c Ac 6d]
Seat 1: 8a31aea7 (button) folded on the Flop
Seat 2: 9d598a03 (small blind) folded before Flop
Seat 3: ca69da65 (big blind) folded before Flop
Seat 4: f4ce525 folded before Flop (didn't bet)
Seat 5: Hero won ($7.37)
Seat 6: f8b1513e folded before Flop (didn't bet)


Poker Hand #RC94782920: Hold'em No Limit ($0.1/$0.25) - 2020/04/06 22:53:30
Table 'RushAndCash317525' 6-max Seat #1 is the button
Seat 1: f26b2d0d ($25 in chips)
Seat 2: 991e0a0c ($14.51 in chips)
Seat 3: cce649b7 ($25 in chips)
Seat 4: 8a31aea7 ($44.87 in chips)
Seat 5: Hero ($28.85 in chips)
Seat 6: eb5021b0 ($50.29 in chips)
991e0a0c: posts small blind $0.1
cce649b7: posts big blind $0.25
*** HOLE CARDS ***
Dealt to f26b2d0d 
Dealt to 991e0a0c 
Dealt to cce649b7 
Dealt to 8a31aea7 
Dealt to Hero [8c 5h]
Dealt to eb5021b0 
8a31aea7: folds
Hero: folds
eb5021b0: raises $0.5 to $0.75
f26b2d0d: folds
991e0a0c: folds
cce649b7: raises $1.7 to $2.45
eb5021b0: folds
Uncalled bet ($1.7) returned to cce649b7
*** SHOWDOWN ***
cce649b7 collected $1.6 from pot
*** SUMMARY ***
Total pot $1.6
Seat 1: f26b2d0d (button) folded before Flop (didn't bet)
Seat 2: 991e0a0c (small blind) folded before Flop
Seat 3: cce649b7 (big blind) collected ($1.6)
Seat 4: 8a31aea7 folded before Flop (didn't bet)
Seat 5: Hero folded before Flop (didn't bet)
Seat 6: eb5021b0 folded before Flop


Poker Hand #RC94782953: Hold'em No Limit ($0.1/$0.25) - 2020/04/06 22:53:36
Table 'RushAndCash317529' 6-max Seat #1 is the button
Seat 1: 9423373a ($40.34 in chips)
Seat 2: b00dbb18 ($32.01 in chips)
Seat 3: Hero ($28.85 in chips)
Seat 4: 9d598a03 ($38.37 in chips)
Seat 5: fd369e31 ($57.88 in chips)
Seat 6: 5c45646d ($28.79 in chips)
b00dbb18: posts small blind $0.1
Hero: posts big blind $0.25
*** HOLE CARDS ***
Dealt to 9423373a 
Dealt to b00dbb18 
Dealt to Hero [4d 2c]
Dealt to 9d598a03 
Dealt to fd369e31 
Dealt to 5c45646d 
9d598a03: folds
fd369e31: folds
5c45646d: folds
9423373a: raises $0.38 to $0.63
b00dbb18: folds
Hero: folds
Uncalled bet ($0.38) returned to 9423373a
*** SHOWDOWN ***
9423373a collected $0.6 from pot
*** SUMMARY ***
Total pot $0.6
Seat 1: 9423373a (button) collected ($0.6)
Seat 2: b00dbb18 (small blind) folded before Flop
Seat 3: Hero (big blind) folded before Flop
Seat 4: 9d598a03 folded before Flop (didn't bet)
Seat 5: fd369e31 folded before Flop (didn't bet)
Seat 6: 5c45646d folded before Flop (didn't bet)


Poker Hand #RC94782972: Hold'em No Limit ($0.1/$0.25) - 2020/04/06 22:53:39
Table 'RushAndCash317533' 6-max Seat #1 is the button
Seat 1: 95e15d0d ($80.16 in chips)
Seat 2: Hero ($28.6 in chips)
Seat 3: 93b71bcb ($45.78 in chips)
Seat 4: fe60ae31 ($11.52 in chips)
Seat 5: c9cb3e58 ($106.57 in chips)
Seat 6: 991e0a0c ($14.41 in chips)
Hero: posts small blind $0.1
93b71bcb: posts big blind $0.25
*** HOLE CARDS ***
Dealt to 95e15d0d 
Dealt to Hero [Qh 6h]
Dealt to 93b71bcb 
Dealt to fe60ae31 
Dealt to c9cb3e58 
Dealt to 991e0a0c 
fe60ae31: folds
c9cb3e58: folds
991e0a0c: folds
95e15d0d: raises $0.38 to $0.63
Hero: folds
93b71bcb: folds
Uncalled bet ($0.38) returned to 95e15d0d
*** SHOWDOWN ***
95e15d0d collected $0.6 from pot
*** SUMMARY ***
Total pot $0.6
Seat 1: 95e15d0d (button) collected ($0.6)
Seat 2: Hero (small blind) folded before Flop
Seat 3: 93b71bcb (big blind) folded before Flop
Seat 4: fe60ae31 folded before Flop (didn't bet)
Seat 5: c9cb3e58 folded before Flop (didn't bet)
Seat 6: 991e0a0c folded before Flop (didn't bet)


Poker Hand #RC94782990: Hold'em No Limit ($0.1/$0.25) - 2020/04/06 22:53:42
Table 'RushAndCash317537' 6-max Seat #1 is the button
Seat 1: Hero ($28.5 in chips)
Seat 2: e0680a48 ($39.08 in chips)
Seat 3: f1eff963 ($14.72 in chips)
Seat 4: 84ec2b3a ($40.98 in chips)
Seat 5: 8a31aea7 ($44.62 in chips)
Seat 6: f229719b ($10.97 in chips)
e0680a48: posts small blind $0.1
f1eff963: posts big blind $0.25
*** HOLE CARDS ***
Dealt to Hero [Tc 5c]
Dealt to e0680a48 
Dealt to f1eff963 
Dealt to 84ec2b3a 
Dealt to 8a31aea7 
Dealt to f229719b 
84ec2b3a: folds
8a31aea7: folds
f229719b: folds
Hero: folds
e0680a48: folds
Uncalled bet ($0.15) returned to f1eff963
*** SHOWDOWN ***
f1eff963 collected $0.2 from pot
*** SUMMARY ***
Total pot $0.2
Seat 1: Hero (button) folded before Flop (didn't bet)
Seat 2: e0680a48 (small blind) folded before Flop
Seat 3: f1eff963 (big blind) collected ($0.2)
Seat 4: 84ec2b3a folded before Flop (didn't bet)
Seat 5: 8a31aea7 folded before Flop (didn't bet)
Seat 6: f229719b folded before Flop (didn't bet)


Poker Hand #RC94783022: Hold'em No Limit ($0.1/$0.25) - 2020/04/06 22:53:48
Table 'RushAndCash317542' 6-max Seat #1 is the button
Seat 1: f4ce525 ($25.85 in chips)
Seat 2: e2e66d9b ($109.95 in chips)
Seat 3: b9bbf733 ($44.11 in chips)
Seat 4: 10f87a4a ($43.83 in chips)
Seat 5: 8cda51b0 ($28.12 in chips)
Seat 6: Hero ($28.5 in chips)
e2e66d9b: posts small blind $0.1
b9bbf733: posts big blind $0.25
*** HOLE CARDS ***
Dealt to f4ce525 
Dealt to e2e66d9b 
Dealt to b9bbf733 
Dealt to 10f87a4a 
Dealt to 8cda51b0 
Dealt to Hero [4h 4c]
10f87a4a: folds
8cda51b0: folds
Hero: raises $0.38 to $0.63
f4ce525: folds
e2e66d9b: folds
b9bbf733: calls $0.38
*** FLOP *** [Js Ac 7c]
b9bbf733: checks
Hero: bets $1.1
b9bbf733: folds
Uncalled bet ($1.1) returned to Hero
*** SHOWDOWN ***
Hero collected $1.36 from pot
*** SUMMARY ***
Total pot $1.36
Board [Js Ac 7c]
Seat 1: f4ce525 (button) folded before Flop (didn't bet)
Seat 2: e2e66d9b (small blind) folded before Flop
Seat 3: b9bbf733 (big blind) folded on the Flop
Seat 4: 10f87a4a folded before Flop (didn't bet)
Seat 5: 8cda51b0 folded before Flop (didn't bet)
Seat 6: Hero won ($1.36)


Poker Hand #RC94783180: Hold'em No Limit ($0.1/$0.25) - 2020/04/06 22:54:16
Table 'RushAndCash317567' 6-max Seat #1 is the button
Seat 1: 8e9cefe9 ($27.07 in chips)
Seat 2: 7ed50f46 ($92.98 in chips)
Seat 3: f26b2d0d ($25.35 in chips)
Seat 4: b9bbf733 ($43.48 in chips)
Seat 5: 7259700a ($65.22 in chips)
Seat 6: Hero ($29.17 in chips)
7ed50f46: posts small blind $0.1
f26b2d0d: posts big blind $0.25
*** HOLE CARDS ***
Dealt to 8e9cefe9 
Dealt to 7ed50f46 
Dealt to f26b2d0d 
Dealt to b9bbf733 
Dealt to 7259700a 
Dealt to Hero [Kh 4d]
b9bbf733: folds
7259700a: folds
Hero: folds
8e9cefe9: folds
7ed50f46: folds
Uncalled bet ($0.15) returned to f26b2d0d
*** SHOWDOWN ***
f26b2d0d collected $0.2 from pot
*** SUMMARY ***
Total pot $0.2
Seat 1: 8e9cefe9 (button) folded before Flop (didn't bet)
Seat 2: 7ed50f46 (small blind) folded before Flop
Seat 3: f26b2d0d (big blind) collected ($0.2)
Seat 4: b9bbf733 folded before Flop (didn't bet)
Seat 5: 7259700a folded before Flop (didn't bet)
Seat 6: Hero folded before Flop (didn't bet)


Poker Hand #RC94783223: Hold'em No Limit ($0.1/$0.25) - 2020/04/06 22:54:23
Table 'RushAndCash317575' 6-max Seat #1 is the button
Seat 1: Hero ($29.17 in chips)
Seat 2: a96ed6d7 ($15.69 in chips)
Seat 3: f99bdf7f ($16.33 in chips)
Seat 4: 5e03da34 ($38.06 in chips)
Seat 5: 483b0968 ($32.98 in chips)
Seat 6: d1700444 ($49.33 in chips)
a96ed6d7: posts small blind $0.1
f99bdf7f: posts big blind $0.25
*** HOLE CARDS ***
Dealt to Hero [Jc 5s]
Dealt to a96ed6d7 
Dealt to f99bdf7f 
Dealt to 5e03da34 
Dealt to 483b0968 
Dealt to d1700444 
5e03da34: folds
483b0968: folds
d1700444: raises $0.38 to $0.63
Hero: folds
a96ed6d7: folds
f99bdf7f: folds
Uncalled bet ($0.38) returned to d1700444
*** SHOWDOWN ***
d1700444 collected $0.6 from pot
*** SUMMARY ***
Total pot $0.6
Seat 1: Hero (button) folded before Flop (didn't bet)
Seat 2: a96ed6d7 (small blind) folded before Flop
Seat 3: f99bdf7f (big blind) folded before Flop
Seat 4: 5e03da34 folded before Flop (didn't bet)
Seat 5: 483b0968 folded before Flop (didn't bet)
Seat 6: d1700444 collected ($0.6)


Poker Hand #RC94783247: Hold'em No Limit ($0.1/$0.25) - 2020/04/06 22:54:28
Table 'RushAndCash317579' 6-max Seat #1 is the button
Seat 1: fbdd6126 ($12.64 in chips)
Seat 2: dfab8c76 ($27.11 in chips)
Seat 3: Hero ($29.17 in chips)
Seat 4: 55e409c ($49.92 in chips)
Seat 5: 7ed50f46 ($92.88 in chips)
Seat 6: e974fe83 ($34.4 in chips)
dfab8c76: posts small blind $0.1
Hero: posts big blind $0.25
*** HOLE CARDS ***
Dealt to fbdd6126 
Dealt to dfab8c76 
Dealt to Hero [Ks 5d]
Dealt to 55e409c 
Dealt to 7ed50f46 
Dealt to e974fe83 
55e409c: raises $0.5 to $0.75
7ed50f46: folds
e974fe83: folds
fbdd6126: folds
dfab8c76: folds
Hero: folds
Uncalled bet ($0.5) returned to 55e409c
*** SHOWDOWN ***
55e409c collected $0.6 from pot
*** SUMMARY ***
Total pot $0.6
Seat 1: fbdd6126 (button) folded before Flop (didn't bet)
Seat 2: dfab8c76 (small blind) folded before Flop
Seat 3: Hero (big blind) folded before Flop
Seat 4: 55e409c collected ($0.6)
Seat 5: 7ed50f46 folded before Flop (didn't bet)
Seat 6: e974fe83 folded before Flop (didn't bet)


Poker Hand #RC94783270: Hold'em No Limit ($0.1/$0.25) - 2020/04/06 22:54:32
Table 'RushAndCash317582' 6-max Seat #1 is the button
Seat 1: f26b2d0d ($25.45 in chips)
Seat 2: Hero ($28.92 in chips)
Seat 3: 514454ec ($12.5 in chips)
Seat 4: 7ed50f46 ($92.88 in chips)
Seat 5: ca69da65 ($37.2 in chips)
Seat 6: 41cf19d5 ($62.2 in chips)
Hero: posts small blind $0.1
514454ec: posts big blind $0.25
*** HOLE CARDS ***
Dealt to f26b2d0d 
Dealt to Hero [Tc 5h]
Dealt to 514454ec 
Dealt to 7ed50f46 
Dealt to ca69da65 
Dealt to 41cf19d5 
7ed50f46: folds
ca69da65: raises $0.38 to $0.63
41cf19d5: raises $1.07 to $1.7
f26b2d0d: folds
Hero: folds
514454ec: folds
ca69da65: calls $1.07
*** FLOP *** [Ah 8d 4d]
ca69da65: checks
41cf19d5: bets $1.9
ca69da65: calls $1.9
*** TURN *** [Ah 8d 4d] [6d]
ca69da65: checks
41cf19d5: checks
*** RIVER *** [Ah 8d 4d 6d] [Th]
ca69da65: bets $3.8
41cf19d5: folds
Uncalled bet ($3.8) returned to ca69da65
*** SHOWDOWN ***
ca69da65 collected $7.55 from pot
*** SUMMARY ***
Total pot $7.55
Board [Ah 8d 4d 6d Th]
Seat 1: f26b2d0d (button) folded before Flop (didn't bet)
Seat 2: Hero (small blind) folded before Flop
Seat 3: 514454ec (big blind) folded before Flop
Seat 4: 7ed50f46 folded before Flop (didn't bet)
Seat 5: ca69da65 won ($7.55)
Seat 6: 41cf19d5 folded on the River


Poker Hand #RC94783333: Hold'em No Limit ($0.1/$0.25) - 2020/04/06 22:54:43
Table 'RushAndCash317590' 6-max Seat #1 is the button
Seat 1: 7357eb2f ($36.13 in chips)
Seat 2: 2b4254fb ($46.46 in chips)
Seat 3: 93b71bcb ($45.33 in chips)
Seat 4: Hero ($28.82 in chips)
Seat 5: e974fe83 ($34.4 in chips)
Seat 6: 8c3de99d ($12.95 in chips)
2b4254fb: posts small blind $0.1
93b71bcb: posts big blind $0.25
*** HOLE CARDS ***
Dealt to 7357eb2f 
Dealt to 2b4254fb 
Dealt to 93b71bcb 
Dealt to Hero [8s 2s]
Dealt to e974fe83 
Dealt to 8c3de99d 
Hero: folds
e974fe83: folds
8c3de99d: folds
7357eb2f: raises $0.38 to $0.63
2b4254fb: raises $1.57 to $2.2
93b71bcb: calls $1.95
7357eb2f: folds
*** FLOP *** [4h Js 6d]
2b4254fb: checks
93b71bcb: checks
*** TURN *** [4h Js 6d] [Ts]
2b4254fb: bets $1.45
93b71bcb: raises $4.05 to $5.5
2b4254fb: folds
Uncalled bet ($4.05) returned to 93b71bcb
*** SHOWDOWN ***
93b71bcb collected $7.93 from pot
*** SUMMARY ***
Total pot $7.93
Board [4h Js 6d Ts]
Seat 1: 7357eb2f (button) folded before Flop
Seat 2: 2b4254fb (small blind) folded on the Turn
Seat 3: 93b71bcb (big blind) won ($7.93)
Seat 4: Hero folded before Flop (didn't bet)
Seat 5: e974fe83 folded before Flop (didn't bet)
Seat 6: 8c3de99d folded before Flop (didn't bet)


Poker Hand #RC94783359: Hold'em No Limit ($0.1/$0.25) - 2020/04/06 22:54:48
Table 'RushAndCash317594' 6-max Seat #1 is the button
Seat 1: cce649b7 ($25.14 in chips)
Seat 2: d1700444 ($49.68 in chips)
Seat 3: b9bbf733 ($43.48 in chips)
Seat 4: Hero ($28.82 in chips)
Seat 5: 6b202021 ($8.17 in chips)
Seat 6: e2e66d9b ($110.41 in chips)
d1700444: posts small blind $0.1
b9bbf733: posts big blind $0.25
*** HOLE CARDS ***
Dealt to cce649b7 
Dealt to d1700444 
Dealt to b9bbf733 
Dealt to Hero [3c 2c]
Dealt to 6b202021 
Dealt to e2e66d9b 
Hero: folds
6b202021: folds
e2e66d9b: folds
cce649b7: folds
d1700444: raises $0.63 to $0.88
b9bbf733: folds
Uncalled bet ($0.63) returned to d1700444
*** SHOWDOWN ***
d1700444 collected $0.5 from pot
*** SUMMARY ***
Total pot $0.5
Seat 1: cce649b7 (button) folded before Flop (didn't bet)
Seat 2: d1700444 (small blind) collected ($0.5)
Seat 3: b9bbf733 (big blind) folded before Flop
Seat 4: Hero folded before Flop (didn't bet)
Seat 5: 6b202021 folded before Flop (didn't bet)
Seat 6: e2e66d9b folded before Flop (didn't bet)


Poker Hand #RC94783413: Hold'em No Limit ($0.1/$0.25) - 2020/04/06 22:54:58
Table 'RushAndCash317602' 6-max Seat #1 is the button
Seat 1: 2467bb49 ($37.15 in chips)
Seat 2: Hero ($28.82 in chips)
Seat 3: e2e66d9b ($110.41 in chips)
Seat 4: cce649b7 ($25.14 in chips)
Seat 5: dfab8c76 ($26.76 in chips)
Seat 6: 11dda850 ($25 in chips)
Hero: posts small blind $0.1
e2e66d9b: posts big blind $0.25
*** HOLE CARDS ***
Dealt to 2467bb49 
Dealt to Hero [Kd 2s]
Dealt to e2e66d9b 
Dealt to cce649b7 
Dealt to dfab8c76 
Dealt to 11dda850 
cce649b7: folds
dfab8c76: folds
11dda850: folds
2467bb49: raises $0.38 to $0.63
Hero: folds
e2e66d9b: folds
Uncalled bet ($0.38) returned to 2467bb49
*** SHOWDOWN ***
2467bb49 collected $0.6 from pot
*** SUMMARY ***
Total pot $0.6
Seat 1: 2467bb49 (button) collected ($0.6)
Seat 2: Hero (small blind) folded before Flop
Seat 3: e2e66d9b (big blind) folded before Flop
Seat 4: cce649b7 folded before Flop (didn't bet)
Seat 5: dfab8c76 folded before Flop (didn't bet)
Seat 6: 11dda850 folded before Flop (didn't bet)


Poker Hand #RC94783506: Hold'em No Limit ($0.1/$0.25) - 2020/04/06 22:55:15
Table 'RushAndCash317616' 6-max Seat #1 is the button
Seat 1: 8e9cefe9 ($27.07 in chips)
Seat 2: 856c1d9b ($25 in chips)
Seat 3: Hero ($28.72 in chips)
Seat 4: ba032eea ($35.46 in chips)
Seat 5: cce649b7 ($25.14 in chips)
Seat 6: ea5eba95 ($55.39 in chips)
856c1d9b: posts small blind $0.1
Hero: posts big blind $0.25
*** HOLE CARDS ***
Dealt to 8e9cefe9 
Dealt to 856c1d9b 
Dealt to Hero [Qh Tc]
Dealt to ba032eea 
Dealt to cce649b7 
Dealt to ea5eba95 
ba032eea: folds
cce649b7: folds
ea5eba95: raises $0.38 to $0.63
8e9cefe9: folds
856c1d9b: folds
Hero: folds
Uncalled bet ($0.38) returned to ea5eba95
*** SHOWDOWN ***
ea5eba95 collected $0.6 from pot
*** SUMMARY ***
Total pot $0.6
Seat 1: 8e9cefe9 (button) folded before Flop (didn't bet)
Seat 2: 856c1d9b (small blind) folded before Flop
Seat 3: Hero (big blind) folded before Flop
Seat 4: ba032eea folded before Flop (didn't bet)
Seat 5: cce649b7 folded before Flop (didn't bet)
Seat 6: ea5eba95 collected ($0.6)


Poker Hand #RC94783632: Hold'em No Limit ($0.1/$0.25) - 2020/04/06 22:55:41
Table 'RushAndCash317633' 6-max Seat #1 is the button
Seat 1: 8fb93df3 ($56.33 in chips)
Seat 2: f1eff963 ($13.02 in chips)
Seat 3: f26b2d0d ($25.35 in chips)
Seat 4: Hero ($28.47 in chips)
Seat 5: f99bdf7f ($15.48 in chips)
Seat 6: afc178f9 ($28.44 in chips)
f1eff963: posts small blind $0.1
f26b2d0d: posts big blind $0.25
*** HOLE CARDS ***
Dealt to 8fb93df3 
Dealt to f1eff963 
Dealt to f26b2d0d 
Dealt to Hero [Ac 8h]
Dealt to f99bdf7f 
Dealt to afc178f9 
Hero: folds
f99bdf7f: calls $0.25
afc178f9: folds
8fb93df3: folds
f1eff963: folds
f26b2d0d: checks
*** FLOP *** [Jh 5d 8c]
f26b2d0d: checks
f99bdf7f: bets $0.5
f26b2d0d: folds
Uncalled bet ($0.5) returned to f99bdf7f
*** SHOWDOWN ***
f99bdf7f collected $0.6 from pot
*** SUMMARY ***
Total pot $0.6
Board [Jh 5d 8c]
Seat 1: 8fb93df3 (button) folded before Flop (didn't bet)
Seat 2: f1eff963 (small blind) folded before Flop
Seat 3: f26b2d0d (big blind) folded on the Flop
Seat 4: Hero folded before Flop (didn't bet)
Seat 5: f99bdf7f won ($0.6)
Seat 6: afc178f9 folded before Flop (didn't bet)


Poker Hand #RC94783660: Hold'em No Limit ($0.1/$0.25) - 2020/04/06 22:55:47
Table 'RushAndCash317641' 6-max Seat #1 is the button
Seat 1: Hero ($28.47 in chips)
Seat 2: e32407ac ($25.15 in chips)
Seat 3: ca69da65 ($40.28 in chips)
Seat 4: 591642a3 ($12.91 in chips)
Seat 5: 514454ec ($13.45 in chips)
Seat 6: 16b06c49 ($25 in chips)
e32407ac: posts small blind $0.1
ca69da65: posts big blind $0.25
*** HOLE CARDS ***
Dealt to Hero [Qc 4d]
Dealt to e32407ac 
Dealt to ca69da65 
Dealt to 591642a3 
Dealt to 514454ec 
Dealt to 16b06c49 
591642a3: folds
514454ec: raises $0.38 to $0.63
16b06c49: folds
Hero: folds
e32407ac: folds
ca69da65: folds
Uncalled bet ($0.38) returned to 514454ec
*** SHOWDOWN ***
514454ec collected $0.6 from pot
*** SUMMARY ***
Total pot $0.6
Seat 1: Hero (button) folded before Flop (didn't bet)
Seat 2: e32407ac (small blind) folded before Flop
Seat 3: ca69da65 (big blind) folded before Flop
Seat 4: 591642a3 folded before Flop (didn't bet)
Seat 5: 514454ec collected ($0.6)
Seat 6: 16b06c49 folded before Flop (didn't bet)


Poker Hand #RC94783756: Hold'em No Limit ($0.1/$0.25) - 2020/04/06 22:56:06
Table 'RushAndCash317662' 6-max Seat #1 is the button
Seat 1: a6356844 ($8.27 in chips)
Seat 2: 604f36f0 ($30.4 in chips)
Seat 3: 1de57a80 ($13.74 in chips)
Seat 4: eb5021b0 ($47.94 in chips)
Seat 5: Hero ($28.47 in chips)
Seat 6: 6b202021 ($9.63 in chips)
604f36f0: posts small blind $0.1
1de57a80: posts big blind $0.25
*** HOLE CARDS ***
Dealt to a6356844 
Dealt to 604f36f0 
Dealt to 1de57a80 
Dealt to eb5021b0 
Dealt to Hero [9s 2h]
Dealt to 6b202021 
eb5021b0: folds
Hero: folds
6b202021: raises $0.25 to $0.5
a6356844: raises $1.5 to $2
604f36f0: folds
1de57a80: folds
6b202021: calls $1.5
*** FLOP *** [8c 5c 4c]
6b202021: checks
a6356844: bets $1.5
6b202021: calls $1.5
*** TURN *** [8c 5c 4c] [6s]
6b202021: checks
a6356844: checks
*** RIVER *** [8c 5c 4c 6s] [3h]
6b202021: bets $6.13 and is all-in
a6356844: folds
Uncalled bet ($6.13) returned to 6b202021
*** SHOWDOWN ***
6b202021 collected $7.35 from pot
*** SUMMARY ***
Total pot $7.35
Board [8c 5c 4c 6s 3h]
Seat 1: a6356844 (button) folded on the River
Seat 2: 604f36f0 (small blind) folded before Flop
Seat 3: 1de57a80 (big blind) folded before Flop
Seat 4: eb5021b0 folded before Flop (didn't bet)
Seat 5: Hero folded before Flop (didn't bet)
Seat 6: 6b202021 won ($7.35)


Poker Hand #RC94783784: Hold'em No Limit ($0.1/$0.25) - 2020/04/06 22:56:11
Table 'RushAndCash317668' 6-max Seat #1 is the button
Seat 1: f229719b ($4.89 in chips)
Seat 2: 95e15d0d ($81.21 in chips)
Seat 3: 83e38e49 ($67.2 in chips)
Seat 4: Hero ($28.47 in chips)
Seat 5: cce649b7 ($24.79 in chips)
Seat 6: bd6eeaf3 ($46.6 in chips)
95e15d0d: posts small blind $0.1
83e38e49: posts big blind $0.25
*** HOLE CARDS ***
Dealt to f229719b 
Dealt to 95e15d0d 
Dealt to 83e38e49 
Dealt to Hero [Ah Jh]
Dealt to cce649b7 
Dealt to bd6eeaf3 
Hero: raises $0.38 to $0.63
cce649b7: folds
bd6eeaf3: calls $0.63
f229719b: folds
95e15d0d: calls $0.53
83e38e49: calls $0.38
*** FLOP *** [5d 7h 3c]
95e15d0d: checks
83e38e49: checks
Hero: checks
bd6eeaf3: checks
*** TURN *** [5d 7h 3c] [Js]
95e15d0d: checks
83e38e49: checks
Hero: bets $1.9
bd6eeaf3: folds
95e15d0d: folds
83e38e49: folds
Uncalled bet ($1.9) returned to Hero
*** SHOWDOWN ***
Hero collected $2.52 from pot
*** SUMMARY ***
Total pot $2.52
Board [5d 7h 3c Js]
Seat 1: f229719b (button) folded before Flop (didn't bet)
Seat 2: 95e15d0d (small blind) folded on the Turn
Seat 3: 83e38e49 (big blind) folded on the Turn
Seat 4: Hero won ($2.52)
Seat 5: cce649b7 folded before Flop (didn't bet)
Seat 6: bd6eeaf3 folded on the Turn


Poker Hand #RC94784112: Hold'em No Limit ($0.1/$0.25) - 2020/04/06 22:57:17
Table 'RushAndCash317718' 6-max Seat #1 is the button
Seat 1: 16b06c49 ($27.22 in chips)
Seat 2: 95e15d0d ($80.58 in chips)
Seat 3: 38359122 ($12.5 in chips)
Seat 4: 17480666 ($79.8 in chips)
Seat 5: afc178f9 ($28.09 in chips)
Seat 6: Hero ($30.24 in chips)
95e15d0d: posts small blind $0.1
38359122: posts big blind $0.25
*** HOLE CARDS ***
Dealt to 16b06c49 
Dealt to 95e15d0d 
Dealt to 38359122 
Dealt to 17480666 
Dealt to afc178f9 
Dealt to Hero [4h 2c]
17480666: folds
afc178f9: folds
Hero: folds
16b06c49: folds
95e15d0d: folds
Uncalled bet ($0.15) returned to 38359122
*** SHOWDOWN ***
38359122 collected $0.2 from pot
*** SUMMARY ***
Total pot $0.2
Seat 1: 16b06c49 (button) folded before Flop (didn't bet)
Seat 2: 95e15d0d (small blind) folded before Flop
Seat 3: 38359122 (big blind) collected ($0.2)
Seat 4: 17480666 folded before Flop (didn't bet)
Seat 5: afc178f9 folded before Flop (didn't bet)
Seat 6: Hero folded before Flop (didn't bet)


Poker Hand #RC94784128: Hold'em No Limit ($0.1/$0.25) - 2020/04/06 22:57:19
Table 'RushAndCash317720' 6-max Seat #1 is the button
Seat 1: Hero ($30.24 in chips)
Seat 2: 591642a3 ($12.91 in chips)
Seat 3: 8cda51b0 ($25 in chips)
Seat 4: ba032eea ($61.17 in chips)
Seat 5: fa7b67d4 ($12.5 in chips)
Seat 6: e2e66d9b ($110.41 in chips)
591642a3: posts small blind $0.1
8cda51b0: posts big blind $0.25
*** HOLE CARDS ***
Dealt to Hero [6h 5h]
Dealt to 591642a3 
Dealt to 8cda51b0 
Dealt to ba032eea 
Dealt to fa7b67d4 
Dealt to e2e66d9b 
ba032eea: raises $0.38 to $0.63
fa7b67d4: folds
e2e66d9b: folds
Hero: folds
591642a3: folds
8cda51b0: folds
Uncalled bet ($0.38) returned to ba032eea
*** SHOWDOWN ***
ba032eea collected $0.6 from pot
*** SUMMARY ***
Total pot $0.6
Seat 1: Hero (button) folded before Flop (didn't bet)
Seat 2: 591642a3 (small blind) folded before Flop
Seat 3: 8cda51b0 (big blind) folded before Flop
Seat 4: ba032eea collected ($0.6)
Seat 5: fa7b67d4 folded before Flop (didn't bet)
Seat 6: e2e66d9b folded before Flop (didn't bet)


Poker Hand #RC94784196: Hold'em No Limit ($0.1/$0.25) - 2020/04/06 22:57:32
Table 'RushAndCash317730' 6-max Seat #1 is the button
Seat 1: f229719b ($5.46 in chips)
Seat 2: 9876d8db ($89.57 in chips)
Seat 3: Hero ($30.24 in chips)
Seat 4: 7357eb2f ($35.12 in chips)
Seat 5: dfab8c76 ($26.06 in chips)
Seat 6: 83e38e49 ($66.47 in chips)
9876d8db: posts small blind $0.1
Hero: posts big blind $0.25
*** HOLE CARDS ***
Dealt to f229719b 
Dealt to 9876d8db 
Dealt to Hero [8h 5s]
Dealt to 7357eb2f 
Dealt to dfab8c76 
Dealt to 83e38e49 
7357eb2f: raises $0.38 to $0.63
dfab8c76: folds
83e38e49: folds
f229719b: folds
9876d8db: folds
Hero: folds
Uncalled bet ($0.38) returned to 7357eb2f
*** SHOWDOWN ***
7357eb2f collected $0.6 from pot
*** SUMMARY ***
Total pot $0.6
Seat 1: f229719b (button) folded before Flop (didn't bet)
Seat 2: 9876d8db (small blind) folded before Flop
Seat 3: Hero (big blind) folded before Flop
Seat 4: 7357eb2f collected ($0.6)
Seat 5: dfab8c76 folded before Flop (didn't bet)
Seat 6: 83e38e49 folded before Flop (didn't bet)


Poker Hand #RC94784215: Hold'em No Limit ($0.1/$0.25) - 2020/04/06 22:57:36
Table 'RushAndCash317733' 6-max Seat #1 is the button
Seat 1: 5c45646d ($25.35 in chips)
Seat 2: Hero ($29.99 in chips)
Seat 3: afc178f9 ($27.99 in chips)
Seat 4: e32407ac ($25 in chips)
Seat 5: dfab8c76 ($26.06 in chips)
Seat 6: bf4a35c0 ($14.38 in chips)
Hero: posts small blind $0.1
afc178f9: posts big blind $0.25
*** HOLE CARDS ***
Dealt to 5c45646d 
Dealt to Hero [Qc 8d]
Dealt to afc178f9 
Dealt to e32407ac 
Dealt to dfab8c76 
Dealt to bf4a35c0 
e32407ac: folds
dfab8c76: folds
bf4a35c0: folds
5c45646d: folds
Hero: folds
Uncalled bet ($0.15) returned to afc178f9
*** SHOWDOWN ***
afc178f9 collected $0.2 from pot
*** SUMMARY ***
Total pot $0.2
Seat 1: 5c45646d (button) folded before Flop (didn't bet)
Seat 2: Hero (small blind) folded before Flop
Seat 3: afc178f9 (big blind) collected ($0.2)
Seat 4: e32407ac folded before Flop (didn't bet)
Seat 5: dfab8c76 folded before Flop (didn't bet)
Seat 6: bf4a35c0 folded before Flop (didn't bet)


Poker Hand #RC94784244: Hold'em No Limit ($0.1/$0.25) - 2020/04/06 22:57:41
Table 'RushAndCash317739' 6-max Seat #1 is the button
Seat 1: 7ed50f46 ($93.31 in chips)
Seat 2: 55e409c ($49.39 in chips)
Seat 3: 9d598a03 ($50.78 in chips)
Seat 4: 856c1d9b ($26.26 in chips)
Seat 5: eb5021b0 ($51.15 in chips)
Seat 6: Hero ($29.89 in chips)
55e409c: posts small blind $0.1
9d598a03: posts big blind $0.25
*** HOLE CARDS ***
Dealt to 7ed50f46 
Dealt to 55e409c 
Dealt to 9d598a03 
Dealt to 856c1d9b 
Dealt to eb5021b0 
Dealt to Hero [Js 8h]
856c1d9b: raises $0.38 to $0.63
eb5021b0: raises $1.32 to $1.95
Hero: folds
7ed50f46: folds
55e409c: folds
9d598a03: folds
856c1d9b: folds
Uncalled bet ($1.32) returned to eb5021b0
*** SHOWDOWN ***
eb5021b0 collected $1.61 from pot
*** SUMMARY ***
Total pot $1.61
Seat 1: 7ed50f46 (button) folded before Flop (didn't bet)
Seat 2: 55e409c (small blind) folded before Flop
Seat 3: 9d598a03 (big blind) folded before Flop
Seat 4: 856c1d9b folded before Flop
Seat 5: eb5021b0 collected ($1.61)
Seat 6: Hero folded before Flop (didn't bet)


Poker Hand #RC94784263: Hold'em No Limit ($0.1/$0.25) - 2020/04/06 22:57:45
Table 'RushAndCash317743' 6-max Seat #1 is the button
Seat 1: afc178f9 ($28.09 in chips)
Seat 2: ba032eea ($61.52 in chips)
Seat 3: cce649b7 ($25.49 in chips)
Seat 4: Hero ($29.89 in chips)
Seat 5: 604f36f0 ($33.21 in chips)
Seat 6: e32407ac ($25 in chips)
ba032eea: posts small blind $0.1
cce649b7: posts big blind $0.25
*** HOLE CARDS ***
Dealt to afc178f9 
Dealt to ba032eea 
Dealt to cce649b7 
Dealt to Hero [As 6d]
Dealt to 604f36f0 
Dealt to e32407ac 
Hero: folds
604f36f0: raises $0.5 to $0.75
e32407ac: folds
afc178f9: folds
ba032eea: folds
cce649b7: folds
Uncalled bet ($0.5) returned to 604f36f0
*** SHOWDOWN ***
604f36f0 collected $0.6 from pot
*** SUMMARY ***
Total pot $0.6
Seat 1: afc178f9 (button) folded before Flop (didn't bet)
Seat 2: ba032eea (small blind) folded before Flop
Seat 3: cce649b7 (big blind) folded before Flop
Seat 4: Hero folded before Flop (didn't bet)
Seat 5: 604f36f0 collected ($0.6)
Seat 6: e32407ac folded before Flop (didn't bet)


Poker Hand #RC94784289: Hold'em No Limit ($0.1/$0.25) - 2020/04/06 22:57:50
Table 'RushAndCash317747' 6-max Seat #1 is the button
Seat 1: 2904eaa2 ($25.34 in chips)
Seat 2: dfab8c76 ($26.06 in chips)
Seat 3: 5c45646d ($25.25 in chips)
Seat 4: Hero ($29.89 in chips)
Seat 5: fe60ae31 ($11.4 in chips)
Seat 6: 16b06c49 ($26.87 in chips)
dfab8c76: posts small blind $0.1
5c45646d: posts big blind $0.25
*** HOLE CARDS ***
Dealt to 2904eaa2 
Dealt to dfab8c76 
Dealt to 5c45646d 
Dealt to Hero [Ac Ts]
Dealt to fe60ae31 
Dealt to 16b06c49 
Hero: folds
fe60ae31: folds
16b06c49: folds
2904eaa2: raises $0.25 to $0.5
dfab8c76: folds
5c45646d: folds
Uncalled bet ($0.25) returned to 2904eaa2
*** SHOWDOWN ***
2904eaa2 collected $0.6 from pot
*** SUMMARY ***
Total pot $0.6
Seat 1: 2904eaa2 (button) collected ($0.6)
Seat 2: dfab8c76 (small blind) folded before Flop
Seat 3: 5c45646d (big blind) folded before Flop
Seat 4: Hero folded before Flop (didn't bet)
Seat 5: fe60ae31 folded before Flop (didn't bet)
Seat 6: 16b06c49 folded before Flop (didn't bet)


Poker Hand #RC94784313: Hold'em No Limit ($0.1/$0.25) - 2020/04/06 22:57:55
Table 'RushAndCash317752' 6-max Seat #1 is the button
Seat 1: 8f2f88a4 ($42.02 in chips)
Seat 2: 2aa6d89 ($38.11 in chips)
Seat 3: Hero ($29.89 in chips)
Seat 4: b827f1d9 ($14.63 in chips)
Seat 5: 16b06c49 ($26.87 in chips)
Seat 6: 7259700a ($64.55 in chips)
2aa6d89: posts small blind $0.1
Hero: posts big blind $0.25
*** HOLE CARDS ***
Dealt to 8f2f88a4 
Dealt to 2aa6d89 
Dealt to Hero [Qd 8s]
Dealt to b827f1d9 
Dealt to 16b06c49 
Dealt to 7259700a 
b827f1d9: folds
16b06c49: folds
7259700a: raises $0.38 to $0.63
8f2f88a4: folds
2aa6d89: folds
Hero: folds
Uncalled bet ($0.38) returned to 7259700a
*** SHOWDOWN ***
7259700a collected $0.6 from pot
*** SUMMARY ***
Total pot $0.6
Seat 1: 8f2f88a4 (button) folded before Flop (didn't bet)
Seat 2: 2aa6d89 (small blind) folded before Flop
Seat 3: Hero (big blind) folded before Flop
Seat 4: b827f1d9 folded before Flop (didn't bet)
Seat 5: 16b06c49 folded before Flop (didn't bet)
Seat 6: 7259700a collected ($0.6)


Poker Hand #RC94784334: Hold'em No Limit ($0.1/$0.25) - 2020/04/06 22:57:59
Table 'RushAndCash317755' 6-max Seat #1 is the button
Seat 1: 9876d8db ($89.22 in chips)
Seat 2: Hero ($29.64 in chips)
Seat 3: 2aa6d89 ($38.01 in chips)
Seat 4: 8f2f88a4 ($42.02 in chips)
Seat 5: afc178f9 ($28.09 in chips)
Seat 6: 5c45646d ($25 in chips)
Hero: posts small blind $0.1
2aa6d89: posts big blind $0.25
*** HOLE CARDS ***
Dealt to 9876d8db 
Dealt to Hero [8c 2c]
Dealt to 2aa6d89 
Dealt to 8f2f88a4 
Dealt to afc178f9 
Dealt to 5c45646d 
8f2f88a4: folds
afc178f9: folds
5c45646d: folds
9876d8db: raises $0.25 to $0.5
Hero: folds
2aa6d89: folds
Uncalled bet ($0.25) returned to 9876d8db
*** SHOWDOWN ***
9876d8db collected $0.6 from pot
*** SUMMARY ***
Total pot $0.6
Seat 1: 9876d8db (button) collected ($0.6)
Seat 2: Hero (small blind) folded before Flop
Seat 3: 2aa6d89 (big blind) folded before Flop
Seat 4: 8f2f88a4 folded before Flop (didn't bet)
Seat 5: afc178f9 folded before Flop (didn't bet)
Seat 6: 5c45646d folded before Flop (didn't bet)


Poker Hand #RC94784353: Hold'em No Limit ($0.1/$0.25) - 2020/04/06 22:58:03
Table 'RushAndCash317759' 6-max Seat #1 is the button
Seat 1: e974fe83 ($32.3 in chips)
Seat 2: afc178f9 ($28.09 in chips)
Seat 3: 2904eaa2 ($25.69 in chips)
Seat 4: b827f1d9 ($14.63 in chips)
Seat 5: 2aa6d89 ($37.76 in chips)
Seat 6: Hero ($29.54 in chips)
afc178f9: posts small blind $0.1
2904eaa2: posts big blind $0.25
*** HOLE CARDS ***
Dealt to e974fe83 
Dealt to afc178f9 
Dealt to 2904eaa2 
Dealt to b827f1d9 
Dealt to 2aa6d89 
Dealt to Hero [As 3c]
b827f1d9: folds
2aa6d89: folds
Hero: folds
e974fe83: raises $0.35 to $0.6
afc178f9: folds
2904eaa2: folds
Uncalled bet ($0.35) returned to e974fe83
*** SHOWDOWN ***
e974fe83 collected $0.6 from pot
*** SUMMARY ***
Total pot $0.6
Seat 1: e974fe83 (button) collected ($0.6)
Seat 2: afc178f9 (small blind) folded before Flop
Seat 3: 2904eaa2 (big blind) folded before Flop
Seat 4: b827f1d9 folded before Flop (didn't bet)
Seat 5: 2aa6d89 folded before Flop (didn't bet)
Seat 6: Hero folded before Flop (didn't bet)


Poker Hand #RC94784374: Hold'em No Limit ($0.1/$0.25) - 2020/04/06 22:58:07
Table 'RushAndCash317763' 6-max Seat #1 is the button
Seat 1: f1eff963 ($12.5 in chips)
Seat 2: 93ed1a37 ($11.75 in chips)
Seat 3: 2467bb49 ($34.35 in chips)
Seat 4: 2aa6d89 ($37.76 in chips)
Seat 5: Hero ($29.54 in chips)
Seat 6: f229719b ($5.21 in chips)
93ed1a37: posts small blind $0.1
2467bb49: posts big blind $0.25
*** HOLE CARDS ***
Dealt to f1eff963 
Dealt to 93ed1a37 
Dealt to 2467bb49 
Dealt to 2aa6d89 
Dealt to Hero [Ks 3d]
Dealt to f229719b 
2aa6d89: folds
Hero: folds
f229719b: raises $0.25 to $0.5
f1eff963: folds
93ed1a37: folds
2467bb49: calls $0.25
*** FLOP *** [6s 2s Jh]
2467bb49: checks
f229719b: bets $0.6
2467bb49: calls $0.6
*** TURN *** [6s 2s Jh] [4c]
2467bb49: checks
f229719b: bets $1.7
2467bb49: raises $31.55 to $33.25 and is all-in
f229719b: calls $2.41 and is all-in
Uncalled bet ($29.14) returned to 2467bb49
2467bb49: shows [8d 8s] (Pair of Eights)
f229719b: shows [Tc Js] (Pair of Jacks)
*** RIVER *** [6s 2s Jh 4c] [5s]
*** SHOWDOWN ***
f229719b collected $10.52 from pot
*** SUMMARY ***
Total pot $10.52
Board [6s 2s Jh 4c 5s]
Seat 1: f1eff963 (button) folded before Flop (didn't bet)
Seat 2: 93ed1a37 (small blind) folded before Flop
Seat 3: 2467bb49 (big blind) showed [8s 8d] and lost with Pair of Eights
Seat 4: 2aa6d89 folded before Flop (didn't bet)
Seat 5: Hero folded before Flop (didn't bet)
Seat 6: f229719b showed [Js Tc] and won ($10.52) with Pair of Jacks


Poker Hand #RC94784545: Hold'em No Limit ($0.1/$0.25) - 2020/04/06 22:58:38
Table 'RushAndCash317789' 6-max Seat #1 is the button
Seat 1: Hero ($29.54 in chips)
Seat 2: eb5021b0 ($52.05 in chips)
Seat 3: bd6eeaf3 ($45.24 in chips)
Seat 4: 604f36f0 ($33.21 in chips)
Seat 5: 38359122 ($13.2 in chips)
Seat 6: cf20c14f ($14.57 in chips)
eb5021b0: posts small blind $0.1
bd6eeaf3: posts big blind $0.25
*** HOLE CARDS ***
Dealt to Hero [9c 3h]
Dealt to eb5021b0 
Dealt to bd6eeaf3 
Dealt to 604f36f0 
Dealt to 38359122 
Dealt to cf20c14f 
604f36f0: folds
38359122: raises $0.5 to $0.75
cf20c14f: folds
Hero: folds
eb5021b0: folds
bd6eeaf3: calls $0.5
*** FLOP *** [Jd 7h Td]
bd6eeaf3: checks
38359122: bets $0.8
bd6eeaf3: raises $3.15 to $3.95
38359122: folds
Uncalled bet ($3.15) returned to bd6eeaf3
*** SHOWDOWN ***
bd6eeaf3 collected $3.2 from pot
*** SUMMARY ***
Total pot $3.2
Board [Jd 7h Td]
Seat 1: Hero (button) folded before Flop (didn't bet)
Seat 2: eb5021b0 (small blind) folded before Flop
Seat 3: bd6eeaf3 (big blind) won ($3.2)
Seat 4: 604f36f0 folded before Flop (didn't bet)
Seat 5: 38359122 folded on the Flop
Seat 6: cf20c14f folded before Flop (didn't bet)


Poker Hand #RC94784562: Hold'em No Limit ($0.1/$0.25) - 2020/04/06 22:58:42
Table 'RushAndCash317792' 6-max Seat #1 is the button
Seat 1: cf20c14f ($14.57 in chips)
Seat 2: 604f36f0 ($33.21 in chips)
Seat 3: ba032eea ($61.17 in chips)
Seat 4: e32407ac ($25 in chips)
Seat 5: f26b2d0d ($29.68 in chips)
Seat 6: Hero ($29.54 in chips)
604f36f0: posts small blind $0.1
ba032eea: posts big blind $0.25
*** HOLE CARDS ***
Dealt to cf20c14f 
Dealt to 604f36f0 
Dealt to ba032eea 
Dealt to e32407ac 
Dealt to f26b2d0d 
Dealt to Hero [Qd Jd]
e32407ac: folds
f26b2d0d: folds
Hero: raises $0.38 to $0.63
cf20c14f: raises $1.67 to $2.3
604f36f0: folds
ba032eea: folds
Hero: folds
Uncalled bet ($1.67) returned to cf20c14f
*** SHOWDOWN ***
cf20c14f collected $1.61 from pot
*** SUMMARY ***
Total pot $1.61
Seat 1: cf20c14f (button) collected ($1.61)
Seat 2: 604f36f0 (small blind) folded before Flop
Seat 3: ba032eea (big blind) folded before Flop
Seat 4: e32407ac folded before Flop (didn't bet)
Seat 5: f26b2d0d folded before Flop (didn't bet)
Seat 6: Hero folded before Flop


Poker Hand #RC94784730: Hold'em No Limit ($0.1/$0.25) - 2020/04/06 22:59:16
Table 'RushAndCash317815' 6-max Seat #1 is the button
Seat 1: Hero ($28.91 in chips)
Seat 2: f229719b ($9.75 in chips)
Seat 3: cf20c14f ($15.47 in chips)
Seat 4: c6968d64 ($15.6 in chips)
Seat 5: fd369e31 ($55.92 in chips)
Seat 6: 9423373a ($42.02 in chips)
f229719b: posts small blind $0.1
cf20c14f: posts big blind $0.25
*** HOLE CARDS ***
Dealt to Hero [Kd Qd]
Dealt to f229719b 
Dealt to cf20c14f 
Dealt to c6968d64 
Dealt to fd369e31 
Dealt to 9423373a 
c6968d64: folds
fd369e31: folds
9423373a: raises $0.38 to $0.63
Hero: raises $1.49 to $2.12
f229719b: calls $2.02
cf20c14f: folds
9423373a: folds
*** FLOP *** [7d 3h 4d]
f229719b: checks
Hero: bets $7.75
f229719b: calls $7.63 and is all-in
Uncalled bet ($0.12) returned to Hero
Hero: shows [Kd Qd] (King-High)
f229719b: shows [6d 6s] (Pair of Sixes)
*** TURN *** [7d 3h 4d] [As]
*** RIVER *** [7d 3h 4d As] [7h]
*** SHOWDOWN ***
f229719b collected $20.38 from pot
*** SUMMARY ***
Total pot $20.38
Board [7d 3h 4d As 7h]
Seat 1: Hero (button) showed [Kd Qd] and lost with Pair of Sevens
Seat 2: f229719b (small blind) showed [6s 6d] and won ($20.38) with Pair of Sevens and Pair of Sixes
Seat 3: cf20c14f (big blind) folded before Flop
Seat 4: c6968d64 folded before Flop (didn't bet)
Seat 5: fd369e31 folded before Flop (didn't bet)
Seat 6: 9423373a folded before Flop


Poker Hand #RC94785179: Hold'em No Limit ($0.1/$0.25) - 2020/04/06 23:00:41
Table 'RushAndCash317876' 6-max Seat #1 is the button
Seat 1: eb5021b0 ($51.3 in chips)
Seat 2: 83e38e49 ($67.13 in chips)
Seat 3: Hero ($25 in chips)
Seat 4: f229719b ($19.38 in chips)
Seat 5: 17480666 ($81.76 in chips)
Seat 6: b827f1d9 ($15.52 in chips)
83e38e49: posts small blind $0.1
Hero: posts big blind $0.25
*** HOLE CARDS ***
Dealt to eb5021b0 
Dealt to 83e38e49 
Dealt to Hero [5c 3d]
Dealt to f229719b 
Dealt to 17480666 
Dealt to b827f1d9 
f229719b: folds
17480666: folds
b827f1d9: folds
eb5021b0: raises $0.25 to $0.5
83e38e49: folds
Hero: folds
Uncalled bet ($0.25) returned to eb5021b0
*** SHOWDOWN ***
eb5021b0 collected $0.6 from pot
*** SUMMARY ***
Total pot $0.6
Seat 1: eb5021b0 (button) collected ($0.6)
Seat 2: 83e38e49 (small blind) folded before Flop
Seat 3: Hero (big blind) folded before Flop
Seat 4: f229719b folded before Flop (didn't bet)
Seat 5: 17480666 folded before Flop (didn't bet)
Seat 6: b827f1d9 folded before Flop (didn't bet)


Poker Hand #RC94785212: Hold'em No Limit ($0.1/$0.25) - 2020/04/06 23:00:46
Table 'RushAndCash317881' 6-max Seat #1 is the button
Seat 1: 7357eb2f ($36.56 in chips)
Seat 2: fa7b67d4 ($14.4 in chips)
Seat 3: 8fb93df3 ($44.6 in chips)
Seat 4: Hero ($25 in chips)
Seat 5: 93ed1a37 ($13.19 in chips)
Seat 6: f229719b ($19.38 in chips)
fa7b67d4: posts small blind $0.1
8fb93df3: posts big blind $0.25
*** HOLE CARDS ***
Dealt to 7357eb2f 
Dealt to fa7b67d4 
Dealt to 8fb93df3 
Dealt to Hero [Js 4h]
Dealt to 93ed1a37 
Dealt to f229719b 
Hero: folds
93ed1a37: folds
f229719b: raises $0.63 to $0.88
7357eb2f: folds
fa7b67d4: folds
8fb93df3: folds
Uncalled bet ($0.63) returned to f229719b
*** SHOWDOWN ***
f229719b collected $0.6 from pot
*** SUMMARY ***
Total pot $0.6
Seat 1: 7357eb2f (button) folded before Flop (didn't bet)
Seat 2: fa7b67d4 (small blind) folded before Flop
Seat 3: 8fb93df3 (big blind) folded before Flop
Seat 4: Hero folded before Flop (didn't bet)
Seat 5: 93ed1a37 folded before Flop (didn't bet)
Seat 6: f229719b collected ($0.6)


Poker Hand #RC94785231: Hold'em No Limit ($0.1/$0.25) - 2020/04/06 23:00:50
Table 'RushAndCash317884' 6-max Seat #1 is the button
Seat 1: 7259700a ($65.58 in chips)
Seat 2: Hero ($25 in chips)
Seat 3: 2904eaa2 ($25.05 in chips)
Seat 4: 83e38e49 ($67.03 in chips)
Seat 5: 8cda51b0 ($25.35 in chips)
Seat 6: 9d598a03 ($49.93 in chips)
Hero: posts small blind $0.1
2904eaa2: posts big blind $0.25
*** HOLE CARDS ***
Dealt to 7259700a 
Dealt to Hero [Qd Jh]
Dealt to 2904eaa2 
Dealt to 83e38e49 
Dealt to 8cda51b0 
Dealt to 9d598a03 
83e38e49: folds
8cda51b0: raises $0.5 to $0.75
9d598a03: folds
7259700a: folds
Hero: folds
2904eaa2: folds
Uncalled bet ($0.5) returned to 8cda51b0
*** SHOWDOWN ***
8cda51b0 collected $0.6 from pot
*** SUMMARY ***
Total pot $0.6
Seat 1: 7259700a (button) folded before Flop (didn't bet)
Seat 2: Hero (small blind) folded before Flop
Seat 3: 2904eaa2 (big blind) folded before Flop
Seat 4: 83e38e49 folded before Flop (didn't bet)
Seat 5: 8cda51b0 collected ($0.6)
Seat 6: 9d598a03 folded before Flop (didn't bet)


Poker Hand #RC94785327: Hold'em No Limit ($0.1/$0.25) - 2020/04/06 23:01:04
Table 'RushAndCash317898' 6-max Seat #1 is the button
Seat 1: 8f2f88a4 ($43.14 in chips)
Seat 2: 95e15d0d ($91.17 in chips)
Seat 3: a6356844 ($12.45 in chips)
Seat 4: fa7b67d4 ($14.3 in chips)
Seat 5: Hero ($25 in chips)
Seat 6: f99bdf7f ($15.31 in chips)
95e15d0d: posts small blind $0.1
a6356844: posts big blind $0.25
*** HOLE CARDS ***
Dealt to 8f2f88a4 
Dealt to 95e15d0d 
Dealt to a6356844 
Dealt to fa7b67d4 
Dealt to Hero [8s 3s]
Dealt to f99bdf7f 
fa7b67d4: folds
Hero: folds
f99bdf7f: folds
8f2f88a4: folds
95e15d0d: folds
Uncalled bet ($0.15) returned to a6356844
*** SHOWDOWN ***
a6356844 collected $0.2 from pot
*** SUMMARY ***
Total pot $0.2
Seat 1: 8f2f88a4 (button) folded before Flop (didn't bet)
Seat 2: 95e15d0d (small blind) folded before Flop
Seat 3: a6356844 (big blind) collected ($0.2)
Seat 4: fa7b67d4 folded before Flop (didn't bet)
Seat 5: Hero folded before Flop (didn't bet)
Seat 6: f99bdf7f folded before Flop (didn't bet)


Poker Hand #RC94785363: Hold'em No Limit ($0.1/$0.25) - 2020/04/06 23:01:11
Table 'RushAndCash317904' 6-max Seat #1 is the button
Seat 1: 95e15d0d ($91.07 in chips)
Seat 2: a0feaaaf ($13.09 in chips)
Seat 3: 94efc628 ($26.11 in chips)
Seat 4: e3605695 ($2.82 in chips)
Seat 5: Hero ($25 in chips)
Seat 6: a6356844 ($12.2 in chips)
a0feaaaf: posts small blind $0.1
94efc628: posts big blind $0.25
*** HOLE CARDS ***
Dealt to 95e15d0d 
Dealt to a0feaaaf 
Dealt to 94efc628 
Dealt to e3605695 
Dealt to Hero [6s 5h]
Dealt to a6356844 
e3605695: folds
Hero: folds
a6356844: folds
95e15d0d: raises $0.38 to $0.63
a0feaaaf: folds
94efc628: folds
Uncalled bet ($0.38) returned to 95e15d0d
*** SHOWDOWN ***
95e15d0d collected $0.6 from pot
*** SUMMARY ***
Total pot $0.6
Seat 1: 95e15d0d (button) collected ($0.6)
Seat 2: a0feaaaf (small blind) folded before Flop
Seat 3: 94efc628 (big blind) folded before Flop
Seat 4: e3605695 folded before Flop (didn't bet)
Seat 5: Hero folded before Flop (didn't bet)
Seat 6: a6356844 folded before Flop (didn't bet)


Poker Hand #RC94785405: Hold'em No Limit ($0.1/$0.25) - 2020/04/06 23:01:19
Table 'RushAndCash317910' 6-max Seat #1 is the button
Seat 1: 2258ad9f ($30.07 in chips)
Seat 2: ea5eba95 ($100.53 in chips)
Seat 3: 2b4254fb ($55 in chips)
Seat 4: Hero ($25 in chips)
Seat 5: 38359122 ($12.85 in chips)
Seat 6: 2904eaa2 ($25 in chips)
ea5eba95: posts small blind $0.1
2b4254fb: posts big blind $0.25
*** HOLE CARDS ***
Dealt to 2258ad9f 
Dealt to ea5eba95 
Dealt to 2b4254fb 
Dealt to Hero [7s 5h]
Dealt to 38359122 
Dealt to 2904eaa2 
Hero: folds
38359122: folds
2904eaa2: folds
2258ad9f: folds
ea5eba95: folds
Uncalled bet ($0.15) returned to 2b4254fb
*** SHOWDOWN ***
2b4254fb collected $0.2 from pot
*** SUMMARY ***
Total pot $0.2
Seat 1: 2258ad9f (button) folded before Flop (didn't bet)
Seat 2: ea5eba95 (small blind) folded before Flop
Seat 3: 2b4254fb (big blind) collected ($0.2)
Seat 4: Hero folded before Flop (didn't bet)
Seat 5: 38359122 folded before Flop (didn't bet)
Seat 6: 2904eaa2 folded before Flop (didn't bet)


Poker Hand #RC94785427: Hold'em No Limit ($0.1/$0.25) - 2020/04/06 23:01:23
Table 'RushAndCash317913' 6-max Seat #1 is the button
Seat 1: e2e66d9b ($109.15 in chips)
Seat 2: 2b4254fb ($54.75 in chips)
Seat 3: Hero ($25 in chips)
Seat 4: a0feaaaf ($12.99 in chips)
Seat 5: 2258ad9f ($30.07 in chips)
Seat 6: ea5eba95 ($100.43 in chips)
2b4254fb: posts small blind $0.1
Hero: posts big blind $0.25
*** HOLE CARDS ***
Dealt to e2e66d9b 
Dealt to 2b4254fb 
Dealt to Hero [9c 7h]
Dealt to a0feaaaf 
Dealt to 2258ad9f 
Dealt to ea5eba95 
a0feaaaf: calls $0.25
2258ad9f: folds
ea5eba95: folds
e2e66d9b: raises $1.65 to $1.9
2b4254fb: folds
Hero: folds
a0feaaaf: folds
Uncalled bet ($1.65) returned to e2e66d9b
*** SHOWDOWN ***
e2e66d9b collected $0.85 from pot
*** SUMMARY ***
Total pot $0.85
Seat 1: e2e66d9b (button) collected ($0.85)
Seat 2: 2b4254fb (small blind) folded before Flop
Seat 3: Hero (big blind) folded before Flop
Seat 4: a0feaaaf folded before Flop
Seat 5: 2258ad9f folded before Flop (didn't bet)
Seat 6: ea5eba95 folded before Flop (didn't bet)


Poker Hand #RC94785450: Hold'em No Limit ($0.1/$0.25) - 2020/04/06 23:01:27
Table 'RushAndCash317916' 6-max Seat #1 is the button
Seat 1: 92aca4e8 ($27.15 in chips)
Seat 2: Hero ($25 in chips)
Seat 3: 2258ad9f ($30.07 in chips)
Seat 4: 2467bb49 ($26.64 in chips)
Seat 5: ea5eba95 ($100.43 in chips)
Seat 6: d43f12c1 ($12.5 in chips)
Hero: posts small blind $0.1
2258ad9f: posts big blind $0.25
*** HOLE CARDS ***
Dealt to 92aca4e8 
Dealt to Hero [9d 3s]
Dealt to 2258ad9f 
Dealt to 2467bb49 
Dealt to ea5eba95 
Dealt to d43f12c1 
2467bb49: folds
ea5eba95: raises $0.38 to $0.63
d43f12c1: folds
92aca4e8: folds
Hero: folds
2258ad9f: calls $0.38
*** FLOP *** [4d 4c 6s]
2258ad9f: checks
ea5eba95: checks
*** TURN *** [4d 4c 6s] [2d]
2258ad9f: bets $1.25
ea5eba95: calls $1.25
*** RIVER *** [4d 4c 6s 2d] [2h]
2258ad9f: bets $2.5
ea5eba95: calls $2.5
2258ad9f: shows [7s 5s] (Pair of Fours and Pair of Twos)
ea5eba95: shows [Td Kd] (Pair of Fours and Pair of Twos)
*** SHOWDOWN ***
ea5eba95 collected $8.86 from pot
*** SUMMARY ***
Total pot $8.86
Board [4d 4c 6s 2d 2h]
Seat 1: 92aca4e8 (button) folded before Flop (didn't bet)
Seat 2: Hero (small blind) folded before Flop
Seat 3: 2258ad9f (big blind) showed [7s 5s] and lost with Pair of Fours and Pair of Twos
Seat 4: 2467bb49 folded before Flop (didn't bet)
Seat 5: ea5eba95 showed [Kd Td] and won ($8.86) with Pair of Fours and Pair of Twos
Seat 6: d43f12c1 folded before Flop (didn't bet)


Poker Hand #RC94785470: Hold'em No Limit ($0.1/$0.25) - 2020/04/06 23:01:31
Table 'RushAndCash317920' 6-max Seat #1 is the button
Seat 1: Hero ($25 in chips)
Seat 2: 83e38e49 ($66.78 in chips)
Seat 3: 2b4254fb ($54.65 in chips)
Seat 4: 94efc628 ($25.76 in chips)
Seat 5: 856c1d9b ($25.8 in chips)
Seat 6: d13258d2 ($12.34 in chips)
83e38e49: posts small blind $0.1
2b4254fb: posts big blind $0.25
*** HOLE CARDS ***
Dealt to Hero [5s 2h]
Dealt to 83e38e49 
Dealt to 2b4254fb 
Dealt to 94efc628 
Dealt to 856c1d9b 
Dealt to d13258d2 
94efc628: folds
856c1d9b: raises $0.38 to $0.63
d13258d2: folds
Hero: folds
83e38e49: folds
2b4254fb: folds
Uncalled bet ($0.38) returned to 856c1d9b
*** SHOWDOWN ***
856c1d9b collected $0.6 from pot
*** SUMMARY ***
Total pot $0.6
Seat 1: Hero (button) folded before Flop (didn't bet)
Seat 2: 83e38e49 (small blind) folded before Flop
Seat 3: 2b4254fb (big blind) folded before Flop
Seat 4: 94efc628 folded before Flop (didn't bet)
Seat 5: 856c1d9b collected ($0.6)
Seat 6: d13258d2 folded before Flop (didn't bet)


Poker Hand #RC94785497: Hold'em No Limit ($0.1/$0.25) - 2020/04/06 23:01:36
Table 'RushAndCash317925' 6-max Seat #1 is the button
Seat 1: bd6eeaf3 ($43.6 in chips)
Seat 2: 8fb93df3 ($44.92 in chips)
Seat 3: b9bbf733 ($44.03 in chips)
Seat 4: a0feaaaf ($12.74 in chips)
Seat 5: 95e15d0d ($91.42 in chips)
Seat 6: Hero ($25 in chips)
8fb93df3: posts small blind $0.1
b9bbf733: posts big blind $0.25
*** HOLE CARDS ***
Dealt to bd6eeaf3 
Dealt to 8fb93df3 
Dealt to b9bbf733 
Dealt to a0feaaaf 
Dealt to 95e15d0d 
Dealt to Hero [6h 3c]
a0feaaaf: raises $0.75 to $1
95e15d0d: folds
Hero: folds
bd6eeaf3: calls $1
8fb93df3: folds
b9bbf733: folds
*** FLOP *** [3s Qh 7c]
a0feaaaf: bets $1.2
bd6eeaf3: calls $1.2
*** TURN *** [3s Qh 7c] [Js]
a0feaaaf: checks
bd6eeaf3: checks
*** RIVER *** [3s Qh 7c Js] [Ad]
a0feaaaf: checks
bd6eeaf3: checks
a0feaaaf: shows [Th Tc] (Pair of Tens)
bd6eeaf3: shows [8c 8h] (Pair of Eights)
*** SHOWDOWN ***
a0feaaaf collected $4.75 from pot
*** SUMMARY ***
Total pot $4.75
Board [3s Qh 7c Js Ad]
Seat 1: bd6eeaf3 (button) showed [8h 8c] and lost with Pair of Eights
Seat 2: 8fb93df3 (small blind) folded before Flop
Seat 3: b9bbf733 (big blind) folded before Flop
Seat 4: a0feaaaf showed [Th Tc] and won ($4.75) with Pair of Tens
Seat 5: 95e15d0d folded before Flop (didn't bet)
Seat 6: Hero folded before Flop (didn't bet)


Poker Hand #RC94785520: Hold'em No Limit ($0.1/$0.25) - 2020/04/06 23:01:40
Table 'RushAndCash317929' 6-max Seat #1 is the button
Seat 1: ba032eea ($60.42 in chips)
Seat 2: 7ed50f46 ($93.24 in chips)
Seat 3: 83e38e49 ($66.68 in chips)
Seat 4: d1700444 ($42.32 in chips)
Seat 5: fa7b67d4 ($13.95 in chips)
Seat 6: Hero ($25 in chips)
7ed50f46: posts small blind $0.1
83e38e49: posts big blind $0.25
*** HOLE CARDS ***
Dealt to ba032eea 
Dealt to 7ed50f46 
Dealt to 83e38e49 
Dealt to d1700444 
Dealt to fa7b67d4 
Dealt to Hero [4s 3d]
d1700444: raises $0.38 to $0.63
fa7b67d4: folds
Hero: folds
ba032eea: folds
7ed50f46: folds
83e38e49: calls $0.38
*** FLOP *** [5c As 7s]
83e38e49: checks
d1700444: bets $0.7
83e38e49: calls $0.7
*** TURN *** [5c As 7s] [8s]
83e38e49: checks
d1700444: checks
*** RIVER *** [5c As 7s 8s] [8h]
83e38e49: bets $2.1
d1700444: folds
Uncalled bet ($2.1) returned to 83e38e49
*** SHOWDOWN ***
83e38e49 collected $2.76 from pot
*** SUMMARY ***
Total pot $2.76
Board [5c As 7s 8s 8h]
Seat 1: ba032eea (button) folded before Flop (didn't bet)
Seat 2: 7ed50f46 (small blind) folded before Flop
Seat 3: 83e38e49 (big blind) won ($2.76)
Seat 4: d1700444 folded on the River
Seat 5: fa7b67d4 folded before Flop (didn't bet)
Seat 6: Hero folded before Flop (didn't bet)


Poker Hand #RC94785555: Hold'em No Limit ($0.1/$0.25) - 2020/04/06 23:01:45
Table 'RushAndCash317936' 6-max Seat #1 is the button
Seat 1: afc178f9 ($25.57 in chips)
Seat 2: 6b202021 ($15.22 in chips)
Seat 3: Hero ($25 in chips)
Seat 4: 95e15d0d ($91.42 in chips)
Seat 5: 856c1d9b ($26.15 in chips)
Seat 6: f1eff963 ($13.2 in chips)
6b202021: posts small blind $0.1
Hero: posts big blind $0.25
*** HOLE CARDS ***
Dealt to afc178f9 
Dealt to 6b202021 
Dealt to Hero [9d 9c]
Dealt to 95e15d0d 
Dealt to 856c1d9b 
Dealt to f1eff963 
95e15d0d: folds
856c1d9b: folds
f1eff963: folds
afc178f9: raises $0.38 to $0.63
6b202021: folds
Hero: calls $0.38
*** FLOP *** [Qd Ts 4c]
Hero: checks
afc178f9: bets $0.7
Hero: folds
Uncalled bet ($0.7) returned to afc178f9
*** SHOWDOWN ***
afc178f9 collected $1.36 from pot
*** SUMMARY ***
Total pot $1.36
Board [Qd Ts 4c]
Seat 1: afc178f9 (button) won ($1.36)
Seat 2: 6b202021 (small blind) folded before Flop
Seat 3: Hero (big blind) folded on the Flop
Seat 4: 95e15d0d folded before Flop (didn't bet)
Seat 5: 856c1d9b folded before Flop (didn't bet)
Seat 6: f1eff963 folded before Flop (didn't bet)


Poker Hand #RC94785709: Hold'em No Limit ($0.1/$0.25) - 2020/04/06 23:02:13
Table 'RushAndCash317958' 6-max Seat #1 is the button
Seat 1: Hero ($25 in chips)
Seat 2: f1eff963 ($13.2 in chips)
Seat 3: cf20c14f ($12.75 in chips)
Seat 4: fd369e31 ($53.06 in chips)
Seat 5: 2aa6d89 ($36.63 in chips)
Seat 6: ba032eea ($60.42 in chips)
f1eff963: posts small blind $0.1
cf20c14f: posts big blind $0.25
*** HOLE CARDS ***
Dealt to Hero [8d 5c]
Dealt to f1eff963 
Dealt to cf20c14f 
Dealt to fd369e31 
Dealt to 2aa6d89 
Dealt to ba032eea 
fd369e31: raises $0.38 to $0.63
2aa6d89: folds
ba032eea: folds
Hero: folds
f1eff963: folds
cf20c14f: folds
Uncalled bet ($0.38) returned to fd369e31
*** SHOWDOWN ***
fd369e31 collected $0.6 from pot
*** SUMMARY ***
Total pot $0.6
Seat 1: Hero (button) folded before Flop (didn't bet)
Seat 2: f1eff963 (small blind) folded before Flop
Seat 3: cf20c14f (big blind) folded before Flop
Seat 4: fd369e31 collected ($0.6)
Seat 5: 2aa6d89 folded before Flop (didn't bet)
Seat 6: ba032eea folded before Flop (didn't bet)


Poker Hand #RC94785724: Hold'em No Limit ($0.1/$0.25) - 2020/04/06 23:02:16
Table 'RushAndCash317961' 6-max Seat #1 is the button
Seat 1: 17480666 ($79.81 in chips)
Seat 2: bc19997 ($25.1 in chips)
Seat 3: 55e409c ($63.65 in chips)
Seat 4: 93b71bcb ($54.04 in chips)
Seat 5: 38359122 ($13.27 in chips)
Seat 6: Hero ($25 in chips)
bc19997: posts small blind $0.1
55e409c: posts big blind $0.25
*** HOLE CARDS ***
Dealt to 17480666 
Dealt to bc19997 
Dealt to 55e409c 
Dealt to 93b71bcb 
Dealt to 38359122 
Dealt to Hero [Td 3h]
93b71bcb: folds
38359122: folds
Hero: folds
17480666: raises $0.5 to $0.75
bc19997: folds
55e409c: folds
Uncalled bet ($0.5) returned to 17480666
*** SHOWDOWN ***
17480666 collected $0.6 from pot
*** SUMMARY ***
Total pot $0.6
Seat 1: 17480666 (button) collected ($0.6)
Seat 2: bc19997 (small blind) folded before Flop
Seat 3: 55e409c (big blind) folded before Flop
Seat 4: 93b71bcb folded before Flop (didn't bet)
Seat 5: 38359122 folded before Flop (didn't bet)
Seat 6: Hero folded before Flop (didn't bet)


Poker Hand #RC94785744: Hold'em No Limit ($0.1/$0.25) - 2020/04/06 23:02:20
Table 'RushAndCash317964' 6-max Seat #1 is the button
Seat 1: 1b4ad4ae ($25.58 in chips)
Seat 2: Hero ($25 in chips)
Seat 3: 373b37af ($25 in chips)
Seat 4: 93b71bcb ($54.04 in chips)
Seat 5: d43f12c1 ($13.52 in chips)
Seat 6: afc178f9 ($26.24 in chips)
Hero: posts small blind $0.1
373b37af: posts big blind $0.25
*** HOLE CARDS ***
Dealt to 1b4ad4ae 
Dealt to Hero [4s 3d]
Dealt to 373b37af 
Dealt to 93b71bcb 
Dealt to d43f12c1 
Dealt to afc178f9 
93b71bcb: folds
d43f12c1: folds
afc178f9: folds
1b4ad4ae: raises $0.38 to $0.63
Hero: folds
373b37af: calls $0.38
*** FLOP *** [2s 5h Kc]
373b37af: checks
1b4ad4ae: bets $0.5
373b37af: calls $0.5
*** TURN *** [2s 5h Kc] [6c]
373b37af: checks
1b4ad4ae: bets $1.8
373b37af: folds
Uncalled bet ($1.8) returned to 1b4ad4ae
*** SHOWDOWN ***
1b4ad4ae collected $2.36 from pot
*** SUMMARY ***
Total pot $2.36
Board [2s 5h Kc 6c]
Seat 1: 1b4ad4ae (button) won ($2.36)
Seat 2: Hero (small blind) folded before Flop
Seat 3: 373b37af (big blind) folded on the Turn
Seat 4: 93b71bcb folded before Flop (didn't bet)
Seat 5: d43f12c1 folded before Flop (didn't bet)
Seat 6: afc178f9 folded before Flop (didn't bet)


Poker Hand #RC94785770: Hold'em No Limit ($0.1/$0.25) - 2020/04/06 23:02:25
Table 'RushAndCash317969' 6-max Seat #1 is the button
Seat 1: fbdd6126 ($14.98 in chips)
Seat 2: 9876d8db ($88.33 in chips)
Seat 3: b9bbf733 ($43.78 in chips)
Seat 4: Hero ($25 in chips)
Seat 5: ea5eba95 ($103.97 in chips)
Seat 6: d43f12c1 ($13.52 in chips)
9876d8db: posts small blind $0.1
b9bbf733: posts big blind $0.25
*** HOLE CARDS ***
Dealt to fbdd6126 
Dealt to 9876d8db 
Dealt to b9bbf733 
Dealt to Hero [Qh 8d]
Dealt to ea5eba95 
Dealt to d43f12c1 
Hero: folds
ea5eba95: folds
d43f12c1: folds
fbdd6126: raises $0.25 to $0.5
9876d8db: calls $0.4
b9bbf733: folds
*** FLOP *** [Jc Kc Ts]
9876d8db: checks
fbdd6126: checks
*** TURN *** [Jc Kc Ts] [5c]
9876d8db: bets $0.5
fbdd6126: calls $0.5
*** RIVER *** [Jc Kc Ts 5c] [3c]
9876d8db: bets $0.8
fbdd6126: folds
Uncalled bet ($0.8) returned to 9876d8db
*** SHOWDOWN ***
9876d8db collected $2.25 from pot
*** SUMMARY ***
Total pot $2.25
Board [Jc Kc Ts 5c 3c]
Seat 1: fbdd6126 (button) folded on the River
Seat 2: 9876d8db (small blind) won ($2.25)
Seat 3: b9bbf733 (big blind) folded before Flop
Seat 4: Hero folded before Flop (didn't bet)
Seat 5: ea5eba95 folded before Flop (didn't bet)
Seat 6: d43f12c1 folded before Flop (didn't bet)


Poker Hand #RC94785807: Hold'em No Limit ($0.1/$0.25) - 2020/04/06 23:02:31
Table 'RushAndCash317976' 6-max Seat #1 is the button
Seat 1: c6968d64 ($15.6 in chips)
Seat 2: 93b71bcb ($53.94 in chips)
Seat 3: ba032eea ($60.42 in chips)
Seat 4: 9423373a ($39.16 in chips)
Seat 5: 8cda51b0 ($27.2 in chips)
Seat 6: Hero ($25 in chips)
Cash Drop to Pot : total $2.5 
93b71bcb: posts small blind $0.1
ba032eea: posts big blind $0.25
*** HOLE CARDS ***
Dealt to c6968d64 
Dealt to 93b71bcb 
Dealt to ba032eea 
Dealt to 9423373a 
Dealt to 8cda51b0 
Dealt to Hero [Kc Qc]
9423373a: folds
8cda51b0: folds
Hero: raises $0.5 to $0.75
c6968d64: raises $14.85 to $15.6 and is all-in
93b71bcb: folds
ba032eea: folds
Hero: folds
Uncalled bet ($14.85) returned to c6968d64
*** SHOWDOWN ***
c6968d64 collected $4.35 from pot
*** SUMMARY ***
Total pot $4.35
Seat 1: c6968d64 (button) collected ($4.35)
Seat 2: 93b71bcb (small blind) folded before Flop
Seat 3: ba032eea (big blind) folded before Flop
Seat 4: 9423373a folded before Flop (didn't bet)
Seat 5: 8cda51b0 folded before Flop (didn't bet)
Seat 6: Hero folded before Flop


Poker Hand #RC94785989: Hold'em No Limit ($0.1/$0.25) - 2020/04/06 23:03:05
Table 'RushAndCash318003' 6-max Seat #1 is the button
Seat 1: 7357eb2f ($38.55 in chips)
Seat 2: 55e409c ($63.4 in chips)
Seat 3: Hero ($25 in chips)
Seat 4: 2258ad9f ($25.16 in chips)
Seat 5: 41cf19d5 ($65.05 in chips)
Seat 6: e32407ac ($25 in chips)
55e409c: posts small blind $0.1
Hero: posts big blind $0.25
*** HOLE CARDS ***
Dealt to 7357eb2f 
Dealt to 55e409c 
Dealt to Hero [8s 5c]
Dealt to 2258ad9f 
Dealt to 41cf19d5 
Dealt to e32407ac 
2258ad9f: folds
41cf19d5: folds
e32407ac: folds
7357eb2f: folds
55e409c: raises $0.5 to $0.75
Hero: folds
Uncalled bet ($0.5) returned to 55e409c
*** SHOWDOWN ***
55e409c collected $0.5 from pot
*** SUMMARY ***
Total pot $0.5
Seat 1: 7357eb2f (button) folded before Flop (didn't bet)
Seat 2: 55e409c (small blind) collected ($0.5)
Seat 3: Hero (big blind) folded before Flop
Seat 4: 2258ad9f folded before Flop (didn't bet)
Seat 5: 41cf19d5 folded before Flop (didn't bet)
Seat 6: e32407ac folded before Flop (didn't bet)


Poker Hand #RC94786017: Hold'em No Limit ($0.1/$0.25) - 2020/04/06 23:03:10
Table 'RushAndCash318006' 6-max Seat #1 is the button
Seat 1: 2467bb49 ($25 in chips)
Seat 2: Hero ($25 in chips)
Seat 3: e2e66d9b ($110.74 in chips)
Seat 4: 94efc628 ($25.06 in chips)
Seat 5: 41cf19d5 ($65.05 in chips)
Seat 6: e32407ac ($25 in chips)
Hero: posts small blind $0.1
e2e66d9b: posts big blind $0.25
*** HOLE CARDS ***
Dealt to 2467bb49 
Dealt to Hero [Kd 2c]
Dealt to e2e66d9b 
Dealt to 94efc628 
Dealt to 41cf19d5 
Dealt to e32407ac 
94efc628: folds
41cf19d5: folds
e32407ac: raises $0.38 to $0.63
2467bb49: folds
Hero: folds
e2e66d9b: raises $1.82 to $2.45
e32407ac: calls $1.82
*** FLOP *** [4c 9d Qd]
e2e66d9b: bets $1.95
e32407ac: folds
Uncalled bet ($1.95) returned to e2e66d9b
*** SHOWDOWN ***
e2e66d9b collected $5 from pot
*** SUMMARY ***
Total pot $5
Board [4c 9d Qd]
Seat 1: 2467bb49 (button) folded before Flop (didn't bet)
Seat 2: Hero (small blind) folded before Flop
Seat 3: e2e66d9b (big blind) won ($5)
Seat 4: 94efc628 folded before Flop (didn't bet)
Seat 5: 41cf19d5 folded before Flop (didn't bet)
Seat 6: e32407ac folded on the Flop


Poker Hand #RC94786041: Hold'em No Limit ($0.1/$0.25) - 2020/04/06 23:03:14
Table 'RushAndCash318009' 6-max Seat #1 is the button
Seat 1: Hero ($25 in chips)
Seat 2: 41cf19d5 ($65.05 in chips)
Seat 3: 93b71bcb ($53.59 in chips)
Seat 4: 17480666 ($79.81 in chips)
Seat 5: 94efc628 ($25.06 in chips)
Seat 6: fa7b67d4 ($13.25 in chips)
41cf19d5: posts small blind $0.1
93b71bcb: posts big blind $0.25
*** HOLE CARDS ***
Dealt to Hero [Ks Tc]
Dealt to 41cf19d5 
Dealt to 93b71bcb 
Dealt to 17480666 
Dealt to 94efc628 
Dealt to fa7b67d4 
17480666: folds
94efc628: raises $0.38 to $0.63
fa7b67d4: folds
Hero: folds
41cf19d5: folds
93b71bcb: folds
Uncalled bet ($0.38) returned to 94efc628
*** SHOWDOWN ***
94efc628 collected $0.6 from pot
*** SUMMARY ***
Total pot $0.6
Seat 1: Hero (button) folded before Flop (didn't bet)
Seat 2: 41cf19d5 (small blind) folded before Flop
Seat 3: 93b71bcb (big blind) folded before Flop
Seat 4: 17480666 folded before Flop (didn't bet)
Seat 5: 94efc628 collected ($0.6)
Seat 6: fa7b67d4 folded before Flop (didn't bet)


Poker Hand #RC94786097: Hold'em No Limit ($0.1/$0.25) - 2020/04/06 23:03:24
Table 'RushAndCash318017' 6-max Seat #1 is the button
Seat 1: 41cf19d5 ($64.95 in chips)
Seat 2: a6356844 ($12.45 in chips)
Seat 3: 8cda51b0 ($27.55 in chips)
Seat 4: 93b71bcb ($53.34 in chips)
Seat 5: 1b4ad4ae ($26.7 in chips)
Seat 6: Hero ($25 in chips)
a6356844: posts small blind $0.1
8cda51b0: posts big blind $0.25
*** HOLE CARDS ***
Dealt to 41cf19d5 
Dealt to a6356844 
Dealt to 8cda51b0 
Dealt to 93b71bcb 
Dealt to 1b4ad4ae 
Dealt to Hero [9h 8h]
93b71bcb: folds
1b4ad4ae: raises $0.5 to $0.75
Hero: folds
41cf19d5: folds
a6356844: folds
8cda51b0: calls $0.5
*** FLOP *** [4d Ac Ah]
8cda51b0: checks
1b4ad4ae: bets $0.6
8cda51b0: calls $0.6
*** TURN *** [4d Ac Ah] [Ks]
8cda51b0: checks
1b4ad4ae: bets $2.1
8cda51b0: calls $2.1
*** RIVER *** [4d Ac Ah Ks] [9c]
8cda51b0: checks
1b4ad4ae: bets $5.3
8cda51b0: calls $5.3
1b4ad4ae: shows [8d 7d] (Pair of Aces)
8cda51b0: shows [Ad 6c] (Three Aces)
*** SHOWDOWN ***
8cda51b0 collected $17.6 from pot
*** SUMMARY ***
Total pot $17.6
Board [4d Ac Ah Ks 9c]
Seat 1: 41cf19d5 (button) folded before Flop (didn't bet)
Seat 2: a6356844 (small blind) folded before Flop
Seat 3: 8cda51b0 (big blind) showed [Ad 6c] and won ($17.6) with Three Aces
Seat 4: 93b71bcb folded before Flop (didn't bet)
Seat 5: 1b4ad4ae showed [8d 7d] and lost with Pair of Aces
Seat 6: Hero folded before Flop (didn't bet)


Poker Hand #RC94786154: Hold'em No Limit ($0.1/$0.25) - 2020/04/06 23:03:35
Table 'RushAndCash318025' 6-max Seat #1 is the button
Seat 1: d1700444 ($40.54 in chips)
Seat 2: ba032eea ($60.07 in chips)
Seat 3: afa5143c ($25 in chips)
Seat 4: Hero ($25 in chips)
Seat 5: b9bbf733 ($42.93 in chips)
Seat 6: 373b37af ($25 in chips)
ba032eea: posts small blind $0.1
afa5143c: posts big blind $0.25
*** HOLE CARDS ***
Dealt to d1700444 
Dealt to ba032eea 
Dealt to afa5143c 
Dealt to Hero [Kh 4h]
Dealt to b9bbf733 
Dealt to 373b37af 
Hero: folds
b9bbf733: folds
373b37af: folds
d1700444: folds
ba032eea: folds
Uncalled bet ($0.15) returned to afa5143c
*** SHOWDOWN ***
afa5143c collected $0.2 from pot
*** SUMMARY ***
Total pot $0.2
Seat 1: d1700444 (button) folded before Flop (didn't bet)
Seat 2: ba032eea (small blind) folded before Flop
Seat 3: afa5143c (big blind) collected ($0.2)
Seat 4: Hero folded before Flop (didn't bet)
Seat 5: b9bbf733 folded before Flop (didn't bet)
Seat 6: 373b37af folded before Flop (didn't bet)


Poker Hand #RC94786175: Hold'em No Limit ($0.1/$0.25) - 2020/04/06 23:03:39
Table 'RushAndCash318029' 6-max Seat #1 is the button
Seat 1: 9d598a03 ($42.03 in chips)
Seat 2: 38359122 ($13.02 in chips)
Seat 3: d1700444 ($40.54 in chips)
Seat 4: 93b71bcb ($53.34 in chips)
Seat 5: c9cb3e58 ($101.29 in chips)
Seat 6: Hero ($25 in chips)
38359122: posts small blind $0.1
d1700444: posts big blind $0.25
*** HOLE CARDS ***
Dealt to 9d598a03 
Dealt to 38359122 
Dealt to d1700444 
Dealt to 93b71bcb 
Dealt to c9cb3e58 
Dealt to Hero [6h 5h]
93b71bcb: folds
c9cb3e58: raises $0.25 to $0.5
Hero: folds
9d598a03: folds
38359122: folds
d1700444: calls $0.25
*** FLOP *** [4c 9s Ac]
d1700444: checks
c9cb3e58: checks
*** TURN *** [4c 9s Ac] [Jh]
d1700444: bets $0.6
c9cb3e58: folds
Uncalled bet ($0.6) returned to d1700444
*** SHOWDOWN ***
d1700444 collected $1.1 from pot
*** SUMMARY ***
Total pot $1.1
Board [4c 9s Ac Jh]
Seat 1: 9d598a03 (button) folded before Flop (didn't bet)
Seat 2: 38359122 (small blind) folded before Flop
Seat 3: d1700444 (big blind) won ($1.1)
Seat 4: 93b71bcb folded before Flop (didn't bet)
Seat 5: c9cb3e58 folded on the Turn
Seat 6: Hero folded before Flop (didn't bet)


Poker Hand #RC94786193: Hold'em No Limit ($0.1/$0.25) - 2020/04/06 23:03:41
Table 'RushAndCash318034' 6-max Seat #1 is the button
Seat 1: 92c8c82d ($26.15 in chips)
Seat 2: fd369e31 ($52.41 in chips)
Seat 3: 2258ad9f ($25.51 in chips)
Seat 4: 373b37af ($25 in chips)
Seat 5: 7357eb2f ($38.3 in chips)
Seat 6: Hero ($25 in chips)
fd369e31: posts small blind $0.1
2258ad9f: posts big blind $0.25
*** HOLE CARDS ***
Dealt to 92c8c82d 
Dealt to fd369e31 
Dealt to 2258ad9f 
Dealt to 373b37af 
Dealt to 7357eb2f 
Dealt to Hero [6h 4h]
373b37af: raises $0.5 to $0.75
7357eb2f: folds
Hero: folds
92c8c82d: folds
fd369e31: folds
2258ad9f: folds
Uncalled bet ($0.5) returned to 373b37af
*** SHOWDOWN ***
373b37af collected $0.6 from pot
*** SUMMARY ***
Total pot $0.6
Seat 1: 92c8c82d (button) folded before Flop (didn't bet)
Seat 2: fd369e31 (small blind) folded before Flop
Seat 3: 2258ad9f (big blind) folded before Flop
Seat 4: 373b37af collected ($0.6)
Seat 5: 7357eb2f folded before Flop (didn't bet)
Seat 6: Hero folded before Flop (didn't bet)


Poker Hand #RC94786240: Hold'em No Limit ($0.1/$0.25) - 2020/04/06 23:03:50
Table 'RushAndCash318042' 6-max Seat #1 is the button
Seat 1: f99bdf7f ($17.44 in chips)
Seat 2: Hero ($25 in chips)
Seat 3: f229719b ($17.93 in chips)
Seat 4: fcd4c9fa ($15.37 in chips)
Seat 5: ea5eba95 ($103.37 in chips)
Seat 6: 7ed50f46 ($100.56 in chips)
Hero: posts small blind $0.1
f229719b: posts big blind $0.25
*** HOLE CARDS ***
Dealt to f99bdf7f 
Dealt to Hero [Qc 2d]
Dealt to f229719b 
Dealt to fcd4c9fa 
Dealt to ea5eba95 
Dealt to 7ed50f46 
fcd4c9fa: folds
ea5eba95: folds
7ed50f46: raises $0.5 to $0.75
f99bdf7f: folds
Hero: folds
f229719b: folds
Uncalled bet ($0.5) returned to 7ed50f46
*** SHOWDOWN ***
7ed50f46 collected $0.6 from pot
*** SUMMARY ***
Total pot $0.6
Seat 1: f99bdf7f (button) folded before Flop (didn't bet)
Seat 2: Hero (small blind) folded before Flop
Seat 3: f229719b (big blind) folded before Flop
Seat 4: fcd4c9fa folded before Flop (didn't bet)
Seat 5: ea5eba95 folded before Flop (didn't bet)
Seat 6: 7ed50f46 collected ($0.6)


Poker Hand #RC94786265: Hold'em No Limit ($0.1/$0.25) - 2020/04/06 23:03:55
Table 'RushAndCash318047' 6-max Seat #1 is the button
Seat 1: 17480666 ($78.81 in chips)
Seat 2: a8c8d025 ($12.5 in chips)
Seat 3: Hero ($25 in chips)
Seat 4: 94efc628 ($25.21 in chips)
Seat 5: 92c8c82d ($26.15 in chips)
Seat 6: 95833c67 ($14.53 in chips)
a8c8d025: posts small blind $0.1
Hero: posts big blind $0.25
*** HOLE CARDS ***
Dealt to 17480666 
Dealt to a8c8d025 
Dealt to Hero [Ks Th]
Dealt to 94efc628 
Dealt to 92c8c82d 
Dealt to 95833c67 
94efc628: folds
92c8c82d: folds
95833c67: folds
17480666: raises $0.5 to $0.75
a8c8d025: raises $0.95 to $1.7
Hero: folds
17480666: folds
Uncalled bet ($0.95) returned to a8c8d025
*** SHOWDOWN ***
a8c8d025 collected $1.75 from pot
*** SUMMARY ***
Total pot $1.75
Seat 1: 17480666 (button) folded before Flop
Seat 2: a8c8d025 (small blind) collected ($1.75)
Seat 3: Hero (big blind) folded before Flop
Seat 4: 94efc628 folded before Flop (didn't bet)
Seat 5: 92c8c82d folded before Flop (didn't bet)
Seat 6: 95833c67 folded before Flop (didn't bet)


Poker Hand #RC94786297: Hold'em No Limit ($0.1/$0.25) - 2020/04/06 23:04:01
Table 'RushAndCash318051' 6-max Seat #1 is the button
Seat 1: Hero ($25 in chips)
Seat 2: fcd4c9fa ($15.12 in chips)
Seat 3: afc178f9 ($25.89 in chips)
Seat 4: 8f2f88a4 ($43.19 in chips)
Seat 5: 94efc628 ($25.21 in chips)
Seat 6: d43f12c1 ($15.85 in chips)
fcd4c9fa: posts small blind $0.1
afc178f9: posts big blind $0.25
*** HOLE CARDS ***
Dealt to Hero [Qs Jh]
Dealt to fcd4c9fa 
Dealt to afc178f9 
Dealt to 8f2f88a4 
Dealt to 94efc628 
Dealt to d43f12c1 
8f2f88a4: folds
94efc628: raises $0.38 to $0.63
d43f12c1: folds
Hero: folds
fcd4c9fa: folds
afc178f9: folds
Uncalled bet ($0.38) returned to 94efc628
*** SHOWDOWN ***
94efc628 collected $0.6 from pot
*** SUMMARY ***
Total pot $0.6
Seat 1: Hero (button) folded before Flop (didn't bet)
Seat 2: fcd4c9fa (small blind) folded before Flop
Seat 3: afc178f9 (big blind) folded before Flop
Seat 4: 8f2f88a4 folded before Flop (didn't bet)
Seat 5: 94efc628 collected ($0.6)
Seat 6: d43f12c1 folded before Flop (didn't bet)


Poker Hand #RC94786345: Hold'em No Limit ($0.1/$0.25) - 2020/04/06 23:04:11
Table 'RushAndCash318057' 6-max Seat #1 is the button
Seat 1: afc178f9 ($25.54 in chips)
Seat 2: c9cb3e58 ($100.79 in chips)
Seat 3: ba032eea ($59.97 in chips)
Seat 4: 82438514 ($12.62 in chips)
Seat 5: fcd4c9fa ($15.02 in chips)
Seat 6: Hero ($25 in chips)
c9cb3e58: posts small blind $0.1
ba032eea: posts big blind $0.25
*** HOLE CARDS ***
Dealt to afc178f9 
Dealt to c9cb3e58 
Dealt to ba032eea 
Dealt to 82438514 
Dealt to fcd4c9fa 
Dealt to Hero [Qd 8c]
82438514: folds
fcd4c9fa: folds
Hero: folds
afc178f9: folds
c9cb3e58: raises $0.5 to $0.75
ba032eea: folds
Uncalled bet ($0.5) returned to c9cb3e58
*** SHOWDOWN ***
c9cb3e58 collected $0.5 from pot
*** SUMMARY ***
Total pot $0.5
Seat 1: afc178f9 (button) folded before Flop (didn't bet)
Seat 2: c9cb3e58 (small blind) collected ($0.5)
Seat 3: ba032eea (big blind) folded before Flop
Seat 4: 82438514 folded before Flop (didn't bet)
Seat 5: fcd4c9fa folded before Flop (didn't bet)
Seat 6: Hero folded before Flop (didn't bet)


Poker Hand #RC94786384: Hold'em No Limit ($0.1/$0.25) - 2020/04/06 23:04:19
Table 'RushAndCash318063' 6-max Seat #1 is the button
Seat 1: d13258d2 ($12.75 in chips)
Seat 2: b00dbb18 ($25.7 in chips)
Seat 3: 9423373a ($56.19 in chips)
Seat 4: 2258ad9f ($26.17 in chips)
Seat 5: fcd4c9fa ($15.02 in chips)
Seat 6: Hero ($25 in chips)
b00dbb18: posts small blind $0.1
9423373a: posts big blind $0.25
*** HOLE CARDS ***
Dealt to d13258d2 
Dealt to b00dbb18 
Dealt to 9423373a 
Dealt to 2258ad9f 
Dealt to fcd4c9fa 
Dealt to Hero [Ac 3s]
2258ad9f: folds
fcd4c9fa: raises $0.5 to $0.75
Hero: folds
d13258d2: folds
b00dbb18: folds
9423373a: folds
Uncalled bet ($0.5) returned to fcd4c9fa
*** SHOWDOWN ***
fcd4c9fa collected $0.6 from pot
*** SUMMARY ***
Total pot $0.6
Seat 1: d13258d2 (button) folded before Flop (didn't bet)
Seat 2: b00dbb18 (small blind) folded before Flop
Seat 3: 9423373a (big blind) folded before Flop
Seat 4: 2258ad9f folded before Flop (didn't bet)
Seat 5: fcd4c9fa collected ($0.6)
Seat 6: Hero folded before Flop (didn't bet)


Poker Hand #RC94786409: Hold'em No Limit ($0.1/$0.25) - 2020/04/06 23:04:24
Table 'RushAndCash318067' 6-max Seat #1 is the button
Seat 1: Hero ($25 in chips)
Seat 2: 83e38e49 ($69.6 in chips)
Seat 3: 604f36f0 ($28.61 in chips)
Seat 4: dfab8c76 ($28.92 in chips)
Seat 5: d1700444 ($41.44 in chips)
Seat 6: 2258ad9f ($26.17 in chips)
83e38e49: posts small blind $0.1
604f36f0: posts big blind $0.25
*** HOLE CARDS ***
Dealt to Hero [8c 7c]
Dealt to 83e38e49 
Dealt to 604f36f0 
Dealt to dfab8c76 
Dealt to d1700444 
Dealt to 2258ad9f 
dfab8c76: raises $0.38 to $0.63
d1700444: folds
2258ad9f: folds
Hero: folds
83e38e49: folds
604f36f0: folds
Uncalled bet ($0.38) returned to dfab8c76
*** SHOWDOWN ***
dfab8c76 collected $0.6 from pot
*** SUMMARY ***
Total pot $0.6
Seat 1: Hero (button) folded before Flop (didn't bet)
Seat 2: 83e38e49 (small blind) folded before Flop
Seat 3: 604f36f0 (big blind) folded before Flop
Seat 4: dfab8c76 collected ($0.6)
Seat 5: d1700444 folded before Flop (didn't bet)
Seat 6: 2258ad9f folded before Flop (didn't bet)


Poker Hand #RC94786471: Hold'em No Limit ($0.1/$0.25) - 2020/04/06 23:04:38
Table 'RushAndCash318079' 6-max Seat #1 is the button
Seat 1: f1eff963 ($12.5 in chips)
Seat 2: f229719b ($17.43 in chips)
Seat 3: 17480666 ($77.96 in chips)
Seat 4: d1700444 ($41.19 in chips)
Seat 5: Hero ($25 in chips)
Seat 6: afa5143c ($25.35 in chips)
f229719b: posts small blind $0.1
17480666: posts big blind $0.25
*** HOLE CARDS ***
Dealt to f1eff963 
Dealt to f229719b 
Dealt to 17480666 
Dealt to d1700444 
Dealt to Hero [Td 3c]
Dealt to afa5143c 
d1700444: folds
Hero: folds
afa5143c: folds
f1eff963: folds
f229719b: raises $0.25 to $0.5
17480666: folds
Uncalled bet ($0.25) returned to f229719b
*** SHOWDOWN ***
f229719b collected $0.5 from pot
*** SUMMARY ***
Total pot $0.5
Seat 1: f1eff963 (button) folded before Flop (didn't bet)
Seat 2: f229719b (small blind) collected ($0.5)
Seat 3: 17480666 (big blind) folded before Flop
Seat 4: d1700444 folded before Flop (didn't bet)
Seat 5: Hero folded before Flop (didn't bet)
Seat 6: afa5143c folded before Flop (didn't bet)


Poker Hand #RC94786500: Hold'em No Limit ($0.1/$0.25) - 2020/04/06 23:04:43
Table 'RushAndCash318083' 6-max Seat #1 is the button
Seat 1: 41cf19d5 ($65.05 in chips)
Seat 2: fbdd6126 ($8 in chips)
Seat 3: Hero ($25 in chips)
Seat 4: f1eff963 ($12.5 in chips)
Seat 5: afa5143c ($25.35 in chips)
Seat 6: e100d89f ($20.24 in chips)
fbdd6126: posts small blind $0.1
Hero: posts big blind $0.25
*** HOLE CARDS ***
Dealt to 41cf19d5 
Dealt to fbdd6126 
Dealt to Hero [Ac 3d]
Dealt to f1eff963 
Dealt to afa5143c 
Dealt to e100d89f 
f1eff963: folds
afa5143c: folds
e100d89f: folds
41cf19d5: raises $0.38 to $0.63
fbdd6126: raises $1.47 to $2.1
Hero: folds
41cf19d5: raises $4.5 to $6.6
fbdd6126: raises $1.4 to $8 and is all-in
41cf19d5: calls $1.4
fbdd6126: shows [Jd Js]
41cf19d5: shows [Ah 4s]
*** FLOP *** [3c 4h 6c]
*** TURN *** [3c 4h 6c] [4c]
41cf19d5: get an all-in insurance (premium ($0/$0.5/$0) for ($0/$8/$0) - (Mandatory/Main/Sub))
*** RIVER *** [3c 4h 6c 4c] [7s]
41cf19d5: pay premium of all-in insurance ($0.5)
*** SHOWDOWN ***
41cf19d5 collected $16.25 from pot
*** SUMMARY ***
Total pot $16.25
Board [3c 4h 6c 4c 7s]
Seat 1: 41cf19d5 (button) showed [Ah 4s] and won ($16.25) with Three Fours, AII Premium ($0.5)
Seat 2: fbdd6126 (small blind) showed [Js Jd] and lost with Pair of Jacks and Pair of Fours
Seat 3: Hero (big blind) folded before Flop
Seat 4: f1eff963 folded before Flop (didn't bet)
Seat 5: afa5143c folded before Flop (didn't bet)
Seat 6: e100d89f folded before Flop (didn't bet)


Poker Hand #RC94786527: Hold'em No Limit ($0.1/$0.25) - 2020/04/06 23:04:49
Table 'RushAndCash318087' 6-max Seat #1 is the button
Seat 1: afa5143c ($25.35 in chips)
Seat 2: Hero ($25 in chips)
Seat 3: f1eff963 ($12.5 in chips)
Seat 4: cce649b7 ($25.77 in chips)
Seat 5: 8b344141 ($14.7 in chips)
Seat 6: e100d89f ($20.24 in chips)
Hero: posts small blind $0.1
f1eff963: posts big blind $0.25
*** HOLE CARDS ***
Dealt to afa5143c 
Dealt to Hero [Jh 7s]
Dealt to f1eff963 
Dealt to cce649b7 
Dealt to 8b344141 
Dealt to e100d89f 
cce649b7: folds
8b344141: folds
e100d89f: raises $0.5 to $0.75
afa5143c: folds
Hero: folds
f1eff963: folds
Uncalled bet ($0.5) returned to e100d89f
*** SHOWDOWN ***
e100d89f collected $0.6 from pot
*** SUMMARY ***
Total pot $0.6
Seat 1: afa5143c (button) folded before Flop (didn't bet)
Seat 2: Hero (small blind) folded before Flop
Seat 3: f1eff963 (big blind) folded before Flop
Seat 4: cce649b7 folded before Flop (didn't bet)
Seat 5: 8b344141 folded before Flop (didn't bet)
Seat 6: e100d89f collected ($0.6)


Poker Hand #RC94786590: Hold'em No Limit ($0.1/$0.25) - 2020/04/06 23:05:00
Table 'RushAndCash318097' 6-max Seat #1 is the button
Seat 1: 9423373a ($55.84 in chips)
Seat 2: 2904eaa2 ($25.35 in chips)
Seat 3: d13258d2 ($12.75 in chips)
Seat 4: e2e66d9b ($112.41 in chips)
Seat 5: Hero ($25 in chips)
Seat 6: ca69da65 ($40.61 in chips)
2904eaa2: posts small blind $0.1
d13258d2: posts big blind $0.25
*** HOLE CARDS ***
Dealt to 9423373a 
Dealt to 2904eaa2 
Dealt to d13258d2 
Dealt to e2e66d9b 
Dealt to Hero [As 4h]
Dealt to ca69da65 
e2e66d9b: folds
Hero: folds
ca69da65: raises $0.38 to $0.63
9423373a: folds
2904eaa2: folds
d13258d2: raises $1.37 to $2
ca69da65: calls $1.37
*** FLOP *** [Tc 8d 5d]
d13258d2: bets $3.1
ca69da65: folds
Uncalled bet ($3.1) returned to d13258d2
*** SHOWDOWN ***
d13258d2 collected $4.1 from pot
*** SUMMARY ***
Total pot $4.1
Board [Tc 8d 5d]
Seat 1: 9423373a (button) folded before Flop (didn't bet)
Seat 2: 2904eaa2 (small blind) folded before Flop
Seat 3: d13258d2 (big blind) won ($4.1)
Seat 4: e2e66d9b folded before Flop (didn't bet)
Seat 5: Hero folded before Flop (didn't bet)
Seat 6: ca69da65 folded on the Flop


Poker Hand #RC94786643: Hold'em No Limit ($0.1/$0.25) - 2020/04/06 23:05:10
Table 'RushAndCash318106' 6-max Seat #1 is the button
Seat 1: 5c45646d ($25.57 in chips)
Seat 2: Hero ($25 in chips)
Seat 3: d7f99a39 ($12.71 in chips)
Seat 4: 6257e474 ($1.39 in chips)
Seat 5: 41ab7510 ($25 in chips)
Seat 6: eb5021b0 ($50.72 in chips)
Hero: posts small blind $0.1
d7f99a39: posts big blind $0.25
*** HOLE CARDS ***
Dealt to 5c45646d 
Dealt to Hero [Tc 4c]
Dealt to d7f99a39 
Dealt to 6257e474 
Dealt to 41ab7510 
Dealt to eb5021b0 
6257e474: folds
41ab7510: folds
eb5021b0: folds
5c45646d: raises $0.5 to $0.75
Hero: folds
d7f99a39: raises $1.55 to $2.3
5c45646d: folds
Uncalled bet ($1.55) returned to d7f99a39
*** SHOWDOWN ***
d7f99a39 collected $1.6 from pot
*** SUMMARY ***
Total pot $1.6
Seat 1: 5c45646d (button) folded before Flop
Seat 2: Hero (small blind) folded before Flop
Seat 3: d7f99a39 (big blind) collected ($1.6)
Seat 4: 6257e474 folded before Flop (didn't bet)
Seat 5: 41ab7510 folded before Flop (didn't bet)
Seat 6: eb5021b0 folded before Flop (didn't bet)


Poker Hand #RC94786681: Hold'em No Limit ($0.1/$0.25) - 2020/04/06 23:05:17
Table 'RushAndCash318111' 6-max Seat #1 is the button
Seat 1: Hero ($25 in chips)
Seat 2: 7cc6a901 ($31.8 in chips)
Seat 3: 55e409c ($63.97 in chips)
Seat 4: 82438514 ($12.12 in chips)
Seat 5: c9cb3e58 ($100.54 in chips)
Seat 6: 94efc628 ($26.11 in chips)
7cc6a901: posts small blind $0.1
55e409c: posts big blind $0.25
*** HOLE CARDS ***
Dealt to Hero [Kc 2c]
Dealt to 7cc6a901 
Dealt to 55e409c 
Dealt to 82438514 
Dealt to c9cb3e58 
Dealt to 94efc628 
82438514: raises $0.25 to $0.5
c9cb3e58: folds
94efc628: folds
Hero: folds
7cc6a901: folds
55e409c: folds
Uncalled bet ($0.25) returned to 82438514
*** SHOWDOWN ***
82438514 collected $0.6 from pot
*** SUMMARY ***
Total pot $0.6
Seat 1: Hero (button) folded before Flop (didn't bet)
Seat 2: 7cc6a901 (small blind) folded before Flop
Seat 3: 55e409c (big blind) folded before Flop
Seat 4: 82438514 collected ($0.6)
Seat 5: c9cb3e58 folded before Flop (didn't bet)
Seat 6: 94efc628 folded before Flop (didn't bet)


Poker Hand #RC94786723: Hold'em No Limit ($0.1/$0.25) - 2020/04/06 23:05:26
Table 'RushAndCash318118' 6-max Seat #1 is the button
Seat 1: 93b71bcb ($51.79 in chips)
Seat 2: cce649b7 ($25.77 in chips)
Seat 3: d1700444 ($40.99 in chips)
Seat 4: 604f36f0 ($29.5 in chips)
Seat 5: 591642a3 ($13.36 in chips)
Seat 6: Hero ($25 in chips)
cce649b7: posts small blind $0.1
d1700444: posts big blind $0.25
*** HOLE CARDS ***
Dealt to 93b71bcb 
Dealt to cce649b7 
Dealt to d1700444 
Dealt to 604f36f0 
Dealt to 591642a3 
Dealt to Hero [Ac 7c]
604f36f0: folds
591642a3: raises $0.38 to $0.63
Hero: folds
93b71bcb: folds
cce649b7: folds
d1700444: folds
Uncalled bet ($0.38) returned to 591642a3
*** SHOWDOWN ***
591642a3 collected $0.6 from pot
*** SUMMARY ***
Total pot $0.6
Seat 1: 93b71bcb (button) folded before Flop (didn't bet)
Seat 2: cce649b7 (small blind) folded before Flop
Seat 3: d1700444 (big blind) folded before Flop
Seat 4: 604f36f0 folded before Flop (didn't bet)
Seat 5: 591642a3 collected ($0.6)
Seat 6: Hero folded before Flop (didn't bet)


Poker Hand #RC94786816: Hold'em No Limit ($0.1/$0.25) - 2020/04/06 23:05:46
Table 'RushAndCash318131' 6-max Seat #1 is the button
Seat 1: 2467bb49 ($25.93 in chips)
Seat 2: 38359122 ($12.5 in chips)
Seat 3: Hero ($25 in chips)
Seat 4: dfcfe0b3 ($28.35 in chips)
Seat 5: f99bdf7f ($13.64 in chips)
Seat 6: 17480666 ($76.01 in chips)
38359122: posts small blind $0.1
Hero: posts big blind $0.25
*** HOLE CARDS ***
Dealt to 2467bb49 
Dealt to 38359122 
Dealt to Hero [Ad 3h]
Dealt to dfcfe0b3 
Dealt to f99bdf7f 
Dealt to 17480666 
dfcfe0b3: folds
f99bdf7f: folds
17480666: raises $0.5 to $0.75
2467bb49: folds
38359122: folds
Hero: folds
Uncalled bet ($0.5) returned to 17480666
*** SHOWDOWN ***
17480666 collected $0.6 from pot
*** SUMMARY ***
Total pot $0.6
Seat 1: 2467bb49 (button) folded before Flop (didn't bet)
Seat 2: 38359122 (small blind) folded before Flop
Seat 3: Hero (big blind) folded before Flop
Seat 4: dfcfe0b3 folded before Flop (didn't bet)
Seat 5: f99bdf7f folded before Flop (didn't bet)
Seat 6: 17480666 collected ($0.6)


Poker Hand #RC94786868: Hold'em No Limit ($0.1/$0.25) - 2020/04/06 23:05:55
Table 'RushAndCash318139' 6-max Seat #1 is the button
Seat 1: e2e66d9b ($109.86 in chips)
Seat 2: 41ab7510 ($27.07 in chips)
Seat 3: 604f36f0 ($29.4 in chips)
Seat 4: Hero ($25 in chips)
Seat 5: 9423373a ($56.19 in chips)
Seat 6: d13258d2 ($14.65 in chips)
41ab7510: posts small blind $0.1
604f36f0: posts big blind $0.25
*** HOLE CARDS ***
Dealt to e2e66d9b 
Dealt to 41ab7510 
Dealt to 604f36f0 
Dealt to Hero [8s 8c]
Dealt to 9423373a 
Dealt to d13258d2 
Hero: raises $0.38 to $0.63
9423373a: folds
d13258d2: folds
e2e66d9b: folds
41ab7510: raises $1.87 to $2.5
604f36f0: folds
Hero: calls $1.87
*** FLOP *** [3c Js 2s]
41ab7510: bets $1.8
Hero: calls $1.8
*** TURN *** [3c Js 2s] [Qh]
41ab7510: checks
Hero: checks
*** RIVER *** [3c Js 2s Qh] [5s]
41ab7510: checks
Hero: bets $6.7
41ab7510: folds
Uncalled bet ($6.7) returned to Hero
*** SHOWDOWN ***
Hero collected $8.85 from pot
*** SUMMARY ***
Total pot $8.85
Board [3c Js 2s Qh 5s]
Seat 1: e2e66d9b (button) folded before Flop (didn't bet)
Seat 2: 41ab7510 (small blind) folded on the River
Seat 3: 604f36f0 (big blind) folded before Flop
Seat 4: Hero won ($8.85)
Seat 5: 9423373a folded before Flop (didn't bet)
Seat 6: d13258d2 folded before Flop (didn't bet)


Poker Hand #RC94787120: Hold'em No Limit ($0.1/$0.25) - 2020/04/06 23:06:46
Table 'RushAndCash318178' 6-max Seat #1 is the button
Seat 1: ea5eba95 ($97.19 in chips)
Seat 2: f38f7769 ($24.75 in chips)
Seat 3: 739b1a3d ($27.11 in chips)
Seat 4: Hero ($28.86 in chips)
Seat 5: 72fa991e ($25 in chips)
Seat 6: 1b4ad4ae ($25.35 in chips)
f38f7769: posts small blind $0.1
739b1a3d: posts big blind $0.25
*** HOLE CARDS ***
Dealt to ea5eba95 
Dealt to f38f7769 
Dealt to 739b1a3d 
Dealt to Hero [6d 5c]
Dealt to 72fa991e 
Dealt to 1b4ad4ae 
Hero: folds
72fa991e: folds
1b4ad4ae: folds
ea5eba95: folds
f38f7769: raises $0.5 to $0.75
739b1a3d: folds
Uncalled bet ($0.5) returned to f38f7769
*** SHOWDOWN ***
f38f7769 collected $0.5 from pot
*** SUMMARY ***
Total pot $0.5
Seat 1: ea5eba95 (button) folded before Flop (didn't bet)
Seat 2: f38f7769 (small blind) collected ($0.5)
Seat 3: 739b1a3d (big blind) folded before Flop
Seat 4: Hero folded before Flop (didn't bet)
Seat 5: 72fa991e folded before Flop (didn't bet)
Seat 6: 1b4ad4ae folded before Flop (didn't bet)


Poker Hand #RC94787146: Hold'em No Limit ($0.1/$0.25) - 2020/04/06 23:06:51
Table 'RushAndCash318182' 6-max Seat #1 is the button
Seat 1: e2e66d9b ($109.86 in chips)
Seat 2: fbdd6126 ($23.35 in chips)
Seat 3: afa5143c ($25.35 in chips)
Seat 4: 2b4254fb ($58.26 in chips)
Seat 5: bc19997 ($27.29 in chips)
Seat 6: Hero ($28.86 in chips)
fbdd6126: posts small blind $0.1
afa5143c: posts big blind $0.25
*** HOLE CARDS ***
Dealt to e2e66d9b 
Dealt to fbdd6126 
Dealt to afa5143c 
Dealt to 2b4254fb 
Dealt to bc19997 
Dealt to Hero [8h 7h]
2b4254fb: folds
bc19997: raises $0.38 to $0.63
Hero: folds
e2e66d9b: folds
fbdd6126: folds
afa5143c: folds
Uncalled bet ($0.38) returned to bc19997
*** SHOWDOWN ***
bc19997 collected $0.6 from pot
*** SUMMARY ***
Total pot $0.6
Seat 1: e2e66d9b (button) folded before Flop (didn't bet)
Seat 2: fbdd6126 (small blind) folded before Flop
Seat 3: afa5143c (big blind) folded before Flop
Seat 4: 2b4254fb folded before Flop (didn't bet)
Seat 5: bc19997 collected ($0.6)
Seat 6: Hero folded before Flop (didn't bet)


Poker Hand #RC94787207: Hold'em No Limit ($0.1/$0.25) - 2020/04/06 23:07:03
Table 'RushAndCash318193' 6-max Seat #1 is the button
Seat 1: f38f7769 ($25 in chips)
Seat 2: fcd4c9fa ($12.6 in chips)
Seat 3: 5e03da34 ($43.16 in chips)
Seat 4: 8f2f88a4 ($46.6 in chips)
Seat 5: Hero ($28.86 in chips)
Seat 6: aa8e6e7c ($14.7 in chips)
fcd4c9fa: posts small blind $0.1
5e03da34: posts big blind $0.25
*** HOLE CARDS ***
Dealt to f38f7769 
Dealt to fcd4c9fa 
Dealt to 5e03da34 
Dealt to 8f2f88a4 
Dealt to Hero [8d 8c]
Dealt to aa8e6e7c 
8f2f88a4: folds
Hero: raises $0.38 to $0.63
aa8e6e7c: folds
f38f7769: folds
fcd4c9fa: folds
5e03da34: folds
Uncalled bet ($0.38) returned to Hero
*** SHOWDOWN ***
Hero collected $0.6 from pot
*** SUMMARY ***
Total pot $0.6
Seat 1: f38f7769 (button) folded before Flop (didn't bet)
Seat 2: fcd4c9fa (small blind) folded before Flop
Seat 3: 5e03da34 (big blind) folded before Flop
Seat 4: 8f2f88a4 folded before Flop (didn't bet)
Seat 5: Hero collected ($0.6)
Seat 6: aa8e6e7c folded before Flop (didn't bet)


Poker Hand #RC94787330: Hold'em No Limit ($0.1/$0.25) - 2020/04/06 23:07:30
Table 'RushAndCash318213' 6-max Seat #1 is the button
Seat 1: Hero ($29.21 in chips)
Seat 2: d43f12c1 ($18.48 in chips)
Seat 3: 604f36f0 ($28.7 in chips)
Seat 4: 7259700a ($62.05 in chips)
Seat 5: 591642a3 ($15.23 in chips)
Seat 6: ca69da65 ($38.11 in chips)
d43f12c1: posts small blind $0.1
604f36f0: posts big blind $0.25
*** HOLE CARDS ***
Dealt to Hero [Ad Kh]
Dealt to d43f12c1 
Dealt to 604f36f0 
Dealt to 7259700a 
Dealt to 591642a3 
Dealt to ca69da65 
7259700a: folds
591642a3: folds
ca69da65: folds
Hero: raises $0.38 to $0.63
d43f12c1: folds
604f36f0: folds
Uncalled bet ($0.38) returned to Hero
*** SHOWDOWN ***
Hero collected $0.6 from pot
*** SUMMARY ***
Total pot $0.6
Seat 1: Hero (button) collected ($0.6)
Seat 2: d43f12c1 (small blind) folded before Flop
Seat 3: 604f36f0 (big blind) folded before Flop
Seat 4: 7259700a folded before Flop (didn't bet)
Seat 5: 591642a3 folded before Flop (didn't bet)
Seat 6: ca69da65 folded before Flop (didn't bet)


Poker Hand #RC94787436: Hold'em No Limit ($0.1/$0.25) - 2020/04/06 23:07:52
Table 'RushAndCash318228' 6-max Seat #1 is the button
Seat 1: 7259700a ($62.05 in chips)
Seat 2: a0feaaaf ($15.98 in chips)
Seat 3: Hero ($29.56 in chips)
Seat 4: 92c8c82d ($26.22 in chips)
Seat 5: f8b1513e ($25 in chips)
Seat 6: 58b04451 ($30.25 in chips)
a0feaaaf: posts small blind $0.1
Hero: posts big blind $0.25
*** HOLE CARDS ***
Dealt to 7259700a 
Dealt to a0feaaaf 
Dealt to Hero [Kh 3s]
Dealt to 92c8c82d 
Dealt to f8b1513e 
Dealt to 58b04451 
92c8c82d: folds
f8b1513e: folds
58b04451: folds
7259700a: folds
a0feaaaf: calls $0.15
Hero: checks
*** FLOP *** [6d 7c 3h]
a0feaaaf: bets $0.5
Hero: folds
Uncalled bet ($0.5) returned to a0feaaaf
*** SHOWDOWN ***
a0feaaaf collected $0.5 from pot
*** SUMMARY ***
Total pot $0.5
Board [6d 7c 3h]
Seat 1: 7259700a (button) folded before Flop (didn't bet)
Seat 2: a0feaaaf (small blind) won ($0.5)
Seat 3: Hero (big blind) folded on the Flop
Seat 4: 92c8c82d folded before Flop (didn't bet)
Seat 5: f8b1513e folded before Flop (didn't bet)
Seat 6: 58b04451 folded before Flop (didn't bet)


Poker Hand #RC94787457: Hold'em No Limit ($0.1/$0.25) - 2020/04/06 23:07:56
Table 'RushAndCash318231' 6-max Seat #1 is the button
Seat 1: bc19997 ($27.29 in chips)
Seat 2: d43f12c1 ($18.38 in chips)
Seat 3: 3f7e31d ($24.82 in chips)
Seat 4: ea5eba95 ($96.59 in chips)
Seat 5: Hero ($29.31 in chips)
Seat 6: f8b1513e ($25 in chips)
d43f12c1: posts small blind $0.1
3f7e31d: posts big blind $0.25
*** HOLE CARDS ***
Dealt to bc19997 
Dealt to d43f12c1 
Dealt to 3f7e31d 
Dealt to ea5eba95 
Dealt to Hero [Qs Th]
Dealt to f8b1513e 
ea5eba95: folds
Hero: folds
f8b1513e: folds
bc19997: raises $0.38 to $0.63
d43f12c1: folds
3f7e31d: folds
Uncalled bet ($0.38) returned to bc19997
*** SHOWDOWN ***
bc19997 collected $0.6 from pot
*** SUMMARY ***
Total pot $0.6
Seat 1: bc19997 (button) collected ($0.6)
Seat 2: d43f12c1 (small blind) folded before Flop
Seat 3: 3f7e31d (big blind) folded before Flop
Seat 4: ea5eba95 folded before Flop (didn't bet)
Seat 5: Hero folded before Flop (didn't bet)
Seat 6: f8b1513e folded before Flop (didn't bet)


Poker Hand #RC94787478: Hold'em No Limit ($0.1/$0.25) - 2020/04/06 23:08:00
Table 'RushAndCash318234' 6-max Seat #1 is the button
Seat 1: cce649b7 ($16.11 in chips)
Seat 2: Hero ($29.31 in chips)
Seat 3: f8b1513e ($25 in chips)
Seat 4: 739b1a3d ($30.26 in chips)
Seat 5: dfcfe0b3 ($28.43 in chips)
Seat 6: 94efc628 ($33.89 in chips)
Hero: posts small blind $0.1
f8b1513e: posts big blind $0.25
*** HOLE CARDS ***
Dealt to cce649b7 
Dealt to Hero [Js 8s]
Dealt to f8b1513e 
Dealt to 739b1a3d 
Dealt to dfcfe0b3 
Dealt to 94efc628 
739b1a3d: raises $0.38 to $0.63
dfcfe0b3: folds
94efc628: folds
cce649b7: folds
Hero: folds
f8b1513e: folds
Uncalled bet ($0.38) returned to 739b1a3d
*** SHOWDOWN ***
739b1a3d collected $0.6 from pot
*** SUMMARY ***
Total pot $0.6
Seat 1: cce649b7 (button) folded before Flop (didn't bet)
Seat 2: Hero (small blind) folded before Flop
Seat 3: f8b1513e (big blind) folded before Flop
Seat 4: 739b1a3d collected ($0.6)
Seat 5: dfcfe0b3 folded before Flop (didn't bet)
Seat 6: 94efc628 folded before Flop (didn't bet)


Poker Hand #RC94787503: Hold'em No Limit ($0.1/$0.25) - 2020/04/06 23:08:06
Table 'RushAndCash318237' 6-max Seat #1 is the button
Seat 1: 8cda51b0 ($74.62 in chips)
Seat 2: fa7b67d4 ($12.5 in chips)
Seat 3: 92c8c82d ($26.22 in chips)
Seat 4: 9afeb2a7 ($25 in chips)
Seat 5: Hero ($29.21 in chips)
Seat 6: 2aa6d89 ($26.46 in chips)
fa7b67d4: posts small blind $0.1
92c8c82d: posts big blind $0.25
*** HOLE CARDS ***
Dealt to 8cda51b0 
Dealt to fa7b67d4 
Dealt to 92c8c82d 
Dealt to 9afeb2a7 
Dealt to Hero [5s 4h]
Dealt to 2aa6d89 
9afeb2a7: folds
Hero: folds
2aa6d89: folds
8cda51b0: folds
fa7b67d4: folds
Uncalled bet ($0.15) returned to 92c8c82d
*** SHOWDOWN ***
92c8c82d collected $0.2 from pot
*** SUMMARY ***
Total pot $0.2
Seat 1: 8cda51b0 (button) folded before Flop (didn't bet)
Seat 2: fa7b67d4 (small blind) folded before Flop
Seat 3: 92c8c82d (big blind) collected ($0.2)
Seat 4: 9afeb2a7 folded before Flop (didn't bet)
Seat 5: Hero folded before Flop (didn't bet)
Seat 6: 2aa6d89 folded before Flop (didn't bet)


Poker Hand #RC94787554: Hold'em No Limit ($0.1/$0.25) - 2020/04/06 23:08:16
Table 'RushAndCash318247' 6-max Seat #1 is the button
Seat 1: 93b71bcb ($47.44 in chips)
Seat 2: Hero ($29.21 in chips)
Seat 3: b215699c ($25 in chips)
Seat 4: eb5021b0 ($47.51 in chips)
Seat 5: 58b04451 ($29.9 in chips)
Seat 6: 41ab7510 ($26.34 in chips)
Hero: posts small blind $0.1
b215699c: posts big blind $0.25
*** HOLE CARDS ***
Dealt to 93b71bcb 
Dealt to Hero [Kh 5d]
Dealt to b215699c 
Dealt to eb5021b0 
Dealt to 58b04451 
Dealt to 41ab7510 
eb5021b0: folds
58b04451: folds
41ab7510: folds
93b71bcb: folds
Hero: folds
Uncalled bet ($0.15) returned to b215699c
*** SHOWDOWN ***
b215699c collected $0.2 from pot
*** SUMMARY ***
Total pot $0.2
Seat 1: 93b71bcb (button) folded before Flop (didn't bet)
Seat 2: Hero (small blind) folded before Flop
Seat 3: b215699c (big blind) collected ($0.2)
Seat 4: eb5021b0 folded before Flop (didn't bet)
Seat 5: 58b04451 folded before Flop (didn't bet)
Seat 6: 41ab7510 folded before Flop (didn't bet)


Poker Hand #RC94787587: Hold'em No Limit ($0.1/$0.25) - 2020/04/06 23:08:22
Table 'RushAndCash318253' 6-max Seat #1 is the button
Seat 1: a0feaaaf ($16.21 in chips)
Seat 2: 2aa6d89 ($26.11 in chips)
Seat 3: d1700444 ($39.63 in chips)
Seat 4: f99bdf7f ($15.57 in chips)
Seat 5: Hero ($29.11 in chips)
Seat 6: f229719b ($16.67 in chips)
2aa6d89: posts small blind $0.1
d1700444: posts big blind $0.25
*** HOLE CARDS ***
Dealt to a0feaaaf 
Dealt to 2aa6d89 
Dealt to d1700444 
Dealt to f99bdf7f 
Dealt to Hero [5s 3h]
Dealt to f229719b 
f99bdf7f: folds
Hero: folds
f229719b: raises $0.63 to $0.88
a0feaaaf: calls $0.88
2aa6d89: folds
d1700444: folds
*** FLOP *** [Js 5d 8c]
f229719b: checks
a0feaaaf: bets $1.1
f229719b: calls $1.1
*** TURN *** [Js 5d 8c] [4c]
f229719b: checks
a0feaaaf: checks
*** RIVER *** [Js 5d 8c 4c] [4d]
f229719b: bets $2.2
a0feaaaf: raises $2.2 to $4.4
f229719b: calls $2.2
a0feaaaf: shows [3s 4s] (Three Fours)
f229719b: shows [Ad Kd] (Pair of Fours)
*** SHOWDOWN ***
a0feaaaf collected $13.11 from pot
*** SUMMARY ***
Total pot $13.11
Board [Js 5d 8c 4c 4d]
Seat 1: a0feaaaf (button) showed [4s 3s] and won ($13.11) with Three Fours
Seat 2: 2aa6d89 (small blind) folded before Flop
Seat 3: d1700444 (big blind) folded before Flop
Seat 4: f99bdf7f folded before Flop (didn't bet)
Seat 5: Hero folded before Flop (didn't bet)
Seat 6: f229719b showed [Ad Kd] and lost with Pair of Fours


Poker Hand #RC94787610: Hold'em No Limit ($0.1/$0.25) - 2020/04/06 23:08:27
Table 'RushAndCash318257' 6-max Seat #1 is the button
Seat 1: 8f2f88a4 ($45.62 in chips)
Seat 2: b215699c ($25.1 in chips)
Seat 3: Hero ($29.11 in chips)
Seat 4: cce649b7 ($25 in chips)
Seat 5: 93b71bcb ($47.19 in chips)
Seat 6: f8b1513e ($25 in chips)
b215699c: posts small blind $0.1
Hero: posts big blind $0.25
*** HOLE CARDS ***
Dealt to 8f2f88a4 
Dealt to b215699c 
Dealt to Hero [4c 3s]
Dealt to cce649b7 
Dealt to 93b71bcb 
Dealt to f8b1513e 
cce649b7: folds
93b71bcb: folds
f8b1513e: folds
8f2f88a4: raises $0.38 to $0.63
b215699c: folds
Hero: folds
Uncalled bet ($0.38) returned to 8f2f88a4
*** SHOWDOWN ***
8f2f88a4 collected $0.6 from pot
*** SUMMARY ***
Total pot $0.6
Seat 1: 8f2f88a4 (button) collected ($0.6)
Seat 2: b215699c (small blind) folded before Flop
Seat 3: Hero (big blind) folded before Flop
Seat 4: cce649b7 folded before Flop (didn't bet)
Seat 5: 93b71bcb folded before Flop (didn't bet)
Seat 6: f8b1513e folded before Flop (didn't bet)


Poker Hand #RC94787649: Hold'em No Limit ($0.1/$0.25) - 2020/04/06 23:08:35
Table 'RushAndCash318264' 6-max Seat #1 is the button
Seat 1: Hero ($28.86 in chips)
Seat 2: f99bdf7f ($15.57 in chips)
Seat 3: 8b344141 ($14.95 in chips)
Seat 4: f1eff963 ($12.6 in chips)
Seat 5: 93b71bcb ($46.94 in chips)
Seat 6: f4e2b370 ($12.5 in chips)
f99bdf7f: posts small blind $0.1
8b344141: posts big blind $0.25
*** HOLE CARDS ***
Dealt to Hero [Kd 5h]
Dealt to f99bdf7f 
Dealt to 8b344141 
Dealt to f1eff963 
Dealt to 93b71bcb 
Dealt to f4e2b370 
f1eff963: folds
93b71bcb: folds
f4e2b370: raises $0.5 to $0.75
Hero: folds
f99bdf7f: folds
8b344141: folds
Uncalled bet ($0.5) returned to f4e2b370
*** SHOWDOWN ***
f4e2b370 collected $0.6 from pot
*** SUMMARY ***
Total pot $0.6
Seat 1: Hero (button) folded before Flop (didn't bet)
Seat 2: f99bdf7f (small blind) folded before Flop
Seat 3: 8b344141 (big blind) folded before Flop
Seat 4: f1eff963 folded before Flop (didn't bet)
Seat 5: 93b71bcb folded before Flop (didn't bet)
Seat 6: f4e2b370 collected ($0.6)


Poker Hand #RC94787670: Hold'em No Limit ($0.1/$0.25) - 2020/04/06 23:08:39
Table 'RushAndCash318268' 6-max Seat #1 is the button
Seat 1: fcd4c9fa ($12.5 in chips)
Seat 2: 17480666 ($77.93 in chips)
Seat 3: 58b04451 ($29.9 in chips)
Seat 4: Hero ($28.86 in chips)
Seat 5: ba032eea ($60.96 in chips)
Seat 6: f99bdf7f ($15.47 in chips)
17480666: posts small blind $0.1
58b04451: posts big blind $0.25
*** HOLE CARDS ***
Dealt to fcd4c9fa 
Dealt to 17480666 
Dealt to 58b04451 
Dealt to Hero [Qd 5c]
Dealt to ba032eea 
Dealt to f99bdf7f 
Hero: folds
ba032eea: folds
f99bdf7f: folds
fcd4c9fa: folds
17480666: raises $0.5 to $0.75
58b04451: calls $0.5
*** FLOP *** [Jc 8d Js]
17480666: checks
58b04451: checks
*** TURN *** [Jc 8d Js] [Ah]
17480666: bets $0.35
58b04451: raises $1.65 to $2
17480666: calls $1.65
*** RIVER *** [Jc 8d Js Ah] [Jh]
17480666: checks
58b04451: checks
17480666: shows [As 2s] (Jacks Full over Aces)
58b04451: shows [7h 9h] (Three Jacks)
*** SHOWDOWN ***
17480666 collected $5.5 from pot
*** SUMMARY ***
Total pot $5.5
Board [Jc 8d Js Ah Jh]
Seat 1: fcd4c9fa (button) folded before Flop (didn't bet)
Seat 2: 17480666 (small blind) showed [As 2s] and won ($5.5) with Jacks Full over Aces
Seat 3: 58b04451 (big blind) showed [9h 7h] and lost with Three Jacks
Seat 4: Hero folded before Flop (didn't bet)
Seat 5: ba032eea folded before Flop (didn't bet)
Seat 6: f99bdf7f folded before Flop (didn't bet)


Poker Hand #RC94787686: Hold'em No Limit ($0.1/$0.25) - 2020/04/06 23:08:43
Table 'RushAndCash318271' 6-max Seat #1 is the button
Seat 1: 38359122 ($12.5 in chips)
Seat 2: f8b1513e ($25 in chips)
Seat 3: 7357eb2f ($38.84 in chips)
Seat 4: 739b1a3d ($30.51 in chips)
Seat 5: 93b71bcb ($46.94 in chips)
Seat 6: Hero ($28.86 in chips)
f8b1513e: posts small blind $0.1
7357eb2f: posts big blind $0.25
*** HOLE CARDS ***
Dealt to 38359122 
Dealt to f8b1513e 
Dealt to 7357eb2f 
Dealt to 739b1a3d 
Dealt to 93b71bcb 
Dealt to Hero [Qd 6s]
739b1a3d: folds
93b71bcb: folds
Hero: folds
38359122: folds
f8b1513e: raises $0.5 to $0.75
7357eb2f: calls $0.5
*** FLOP *** [3s 2d 7d]
f8b1513e: bets $1
7357eb2f: folds
Uncalled bet ($1) returned to f8b1513e
*** SHOWDOWN ***
f8b1513e collected $1.5 from pot
*** SUMMARY ***
Total pot $1.5
Board [3s 2d 7d]
Seat 1: 38359122 (button) folded before Flop (didn't bet)
Seat 2: f8b1513e (small blind) won ($1.5)
Seat 3: 7357eb2f (big blind) folded on the Flop
Seat 4: 739b1a3d folded before Flop (didn't bet)
Seat 5: 93b71bcb folded before Flop (didn't bet)
Seat 6: Hero folded before Flop (didn't bet)


Poker Hand #RC94787704: Hold'em No Limit ($0.1/$0.25) - 2020/04/06 23:08:47
Table 'RushAndCash318274' 6-max Seat #1 is the button
Seat 1: Hero ($28.86 in chips)
Seat 2: d7f99a39 ($13.33 in chips)
Seat 3: 2aa6d89 ($26.01 in chips)
Seat 4: 38359122 ($12.5 in chips)
Seat 5: 41cf19d5 ($71.73 in chips)
Seat 6: 2467bb49 ($25.05 in chips)
d7f99a39: posts small blind $0.1
2aa6d89: posts big blind $0.25
*** HOLE CARDS ***
Dealt to Hero [9h 3h]
Dealt to d7f99a39 
Dealt to 2aa6d89 
Dealt to 38359122 
Dealt to 41cf19d5 
Dealt to 2467bb49 
38359122: raises $0.5 to $0.75
41cf19d5: folds
2467bb49: folds
Hero: folds
d7f99a39: folds
2aa6d89: calls $0.5
*** FLOP *** [5h Qh Td]
2aa6d89: checks
38359122: bets $1.2
2aa6d89: folds
Uncalled bet ($1.2) returned to 38359122
*** SHOWDOWN ***
38359122 collected $1.6 from pot
*** SUMMARY ***
Total pot $1.6
Board [5h Qh Td]
Seat 1: Hero (button) folded before Flop (didn't bet)
Seat 2: d7f99a39 (small blind) folded before Flop
Seat 3: 2aa6d89 (big blind) folded on the Flop
Seat 4: 38359122 won ($1.6)
Seat 5: 41cf19d5 folded before Flop (didn't bet)
Seat 6: 2467bb49 folded before Flop (didn't bet)


Poker Hand #RC94787741: Hold'em No Limit ($0.1/$0.25) - 2020/04/06 23:08:54
Table 'RushAndCash318278' 6-max Seat #1 is the button
Seat 1: e32407ac ($38.76 in chips)
Seat 2: d13258d2 ($16.15 in chips)
Seat 3: ba032eea ($60.86 in chips)
Seat 4: 72fa991e ($27.25 in chips)
Seat 5: Hero ($28.86 in chips)
Seat 6: 9afeb2a7 ($25.1 in chips)
d13258d2: posts small blind $0.1
ba032eea: posts big blind $0.25
*** HOLE CARDS ***
Dealt to e32407ac 
Dealt to d13258d2 
Dealt to ba032eea 
Dealt to 72fa991e 
Dealt to Hero [7c 5h]
Dealt to 9afeb2a7 
72fa991e: folds
Hero: folds
9afeb2a7: folds
e32407ac: raises $0.38 to $0.63
d13258d2: calls $0.53
ba032eea: raises $2.63 to $3.26
e32407ac: folds
d13258d2: folds
Uncalled bet ($2.63) returned to ba032eea
*** SHOWDOWN ***
ba032eea collected $1.89 from pot
*** SUMMARY ***
Total pot $1.89
Seat 1: e32407ac (button) folded before Flop
Seat 2: d13258d2 (small blind) folded before Flop
Seat 3: ba032eea (big blind) collected ($1.89)
Seat 4: 72fa991e folded before Flop (didn't bet)
Seat 5: Hero folded before Flop (didn't bet)
Seat 6: 9afeb2a7 folded before Flop (didn't bet)


Poker Hand #RC94787755: Hold'em No Limit ($0.1/$0.25) - 2020/04/06 23:08:57
Table 'RushAndCash318281' 6-max Seat #1 is the button
Seat 1: f99bdf7f ($15.57 in chips)
Seat 2: Hero ($28.86 in chips)
Seat 3: 591642a3 ($15.13 in chips)
Seat 4: 2467bb49 ($25.05 in chips)
Seat 5: ea5eba95 ($96.49 in chips)
Seat 6: b215699c ($25 in chips)
Hero: posts small blind $0.1
591642a3: posts big blind $0.25
*** HOLE CARDS ***
Dealt to f99bdf7f 
Dealt to Hero [Kh 4d]
Dealt to 591642a3 
Dealt to 2467bb49 
Dealt to ea5eba95 
Dealt to b215699c 
2467bb49: folds
ea5eba95: raises $0.38 to $0.63
b215699c: calls $0.63
f99bdf7f: folds
Hero: folds
591642a3: folds
*** FLOP *** [2d 9d 3s]
ea5eba95: checks
b215699c: bets $1
ea5eba95: calls $1
*** TURN *** [2d 9d 3s] [Ac]
ea5eba95: checks
b215699c: checks
*** RIVER *** [2d 9d 3s Ac] [5c]
ea5eba95: checks
b215699c: checks
ea5eba95: shows [8c 8d] (Pair of Eights)
b215699c: shows [7h 7s] (Pair of Sevens)
*** SHOWDOWN ***
ea5eba95 collected $3.61 from pot
*** SUMMARY ***
Total pot $3.61
Board [2d 9d 3s Ac 5c]
Seat 1: f99bdf7f (button) folded before Flop (didn't bet)
Seat 2: Hero (small blind) folded before Flop
Seat 3: 591642a3 (big blind) folded before Flop
Seat 4: 2467bb49 folded before Flop (didn't bet)
Seat 5: ea5eba95 showed [8d 8c] and won ($3.61) with Pair of Eights
Seat 6: b215699c showed [7s 7h] and lost with Pair of Sevens


Poker Hand #RC94787774: Hold'em No Limit ($0.1/$0.25) - 2020/04/06 23:09:01
Table 'RushAndCash318284' 6-max Seat #1 is the button
Seat 1: 41cf19d5 ($71.63 in chips)
Seat 2: 7357eb2f ($38.09 in chips)
Seat 3: Hero ($28.76 in chips)
Seat 4: d8a224aa ($27.66 in chips)
Seat 5: 8b344141 ($14.7 in chips)
Seat 6: f8b1513e ($25.68 in chips)
7357eb2f: posts small blind $0.1
Hero: posts big blind $0.25
*** HOLE CARDS ***
Dealt to 41cf19d5 
Dealt to 7357eb2f 
Dealt to Hero [7c 4c]
Dealt to d8a224aa 
Dealt to 8b344141 
Dealt to f8b1513e 
d8a224aa: folds
8b344141: folds
f8b1513e: folds
41cf19d5: folds
7357eb2f: folds
Uncalled bet ($0.15) returned to Hero
*** SHOWDOWN ***
Hero collected $0.2 from pot
*** SUMMARY ***
Total pot $0.2
Seat 1: 41cf19d5 (button) folded before Flop (didn't bet)
Seat 2: 7357eb2f (small blind) folded before Flop
Seat 3: Hero (big blind) collected ($0.2)
Seat 4: d8a224aa folded before Flop (didn't bet)
Seat 5: 8b344141 folded before Flop (didn't bet)
Seat 6: f8b1513e folded before Flop (didn't bet)


Poker Hand #RC94787813: Hold'em No Limit ($0.1/$0.25) - 2020/04/06 23:09:09
Table 'RushAndCash318291' 6-max Seat #1 is the button
Seat 1: 2aa6d89 ($25.26 in chips)
Seat 2: 739b1a3d ($30.51 in chips)
Seat 3: 72fa991e ($27.25 in chips)
Seat 4: 8b344141 ($14.7 in chips)
Seat 5: Hero ($28.66 in chips)
Seat 6: 38359122 ($13.62 in chips)
739b1a3d: posts small blind $0.1
72fa991e: posts big blind $0.25
*** HOLE CARDS ***
Dealt to 2aa6d89 
Dealt to 739b1a3d 
Dealt to 72fa991e 
Dealt to 8b344141 
Dealt to Hero [Qc Ts]
Dealt to 38359122 
8b344141: folds
Hero: folds
38359122: folds
2aa6d89: folds
739b1a3d: raises $0.5 to $0.75
72fa991e: raises $1.55 to $2.3
739b1a3d: folds
Uncalled bet ($1.55) returned to 72fa991e
*** SHOWDOWN ***
72fa991e collected $1.5 from pot
*** SUMMARY ***
Total pot $1.5
Seat 1: 2aa6d89 (button) folded before Flop (didn't bet)
Seat 2: 739b1a3d (small blind) folded before Flop
Seat 3: 72fa991e (big blind) collected ($1.5)
Seat 4: 8b344141 folded before Flop (didn't bet)
Seat 5: Hero folded before Flop (didn't bet)
Seat 6: 38359122 folded before Flop (didn't bet)


Poker Hand #RC94787848: Hold'em No Limit ($0.1/$0.25) - 2020/04/06 23:09:15
Table 'RushAndCash318296' 6-max Seat #1 is the button
Seat 1: c9cb3e58 ($94.71 in chips)
Seat 2: 41ab7510 ($26.44 in chips)
Seat 3: bd6eeaf3 ($41.99 in chips)
Seat 4: 2aa6d89 ($25.26 in chips)
Seat 5: 22aa740d ($25.35 in chips)
Seat 6: Hero ($28.86 in chips)
41ab7510: posts small blind $0.1
bd6eeaf3: posts big blind $0.25
*** HOLE CARDS ***
Dealt to c9cb3e58 
Dealt to 41ab7510 
Dealt to bd6eeaf3 
Dealt to 2aa6d89 
Dealt to 22aa740d 
Dealt to Hero [Ts 6d]
2aa6d89: raises $0.5 to $0.75
22aa740d: folds
Hero: folds
c9cb3e58: raises $1.75 to $2.5
41ab7510: folds
bd6eeaf3: folds
2aa6d89: calls $1.75
*** FLOP *** [Kc Jc 7s]
2aa6d89: checks
c9cb3e58: bets $4.85
2aa6d89: folds
Uncalled bet ($4.85) returned to c9cb3e58
*** SHOWDOWN ***
c9cb3e58 collected $5.35 from pot
*** SUMMARY ***
Total pot $5.35
Board [Kc Jc 7s]
Seat 1: c9cb3e58 (button) won ($5.35)
Seat 2: 41ab7510 (small blind) folded before Flop
Seat 3: bd6eeaf3 (big blind) folded before Flop
Seat 4: 2aa6d89 folded on the Flop
Seat 5: 22aa740d folded before Flop (didn't bet)
Seat 6: Hero folded before Flop (didn't bet)


Poker Hand #RC94787870: Hold'em No Limit ($0.1/$0.25) - 2020/04/06 23:09:20
Table 'RushAndCash318299' 6-max Seat #1 is the button
Seat 1: f4e2b370 ($12.5 in chips)
Seat 2: 2904eaa2 ($25 in chips)
Seat 3: fa7b67d4 ($13.4 in chips)
Seat 4: Hero ($28.86 in chips)
Seat 5: d13258d2 ($15.52 in chips)
Seat 6: ba032eea ($62.03 in chips)
2904eaa2: posts small blind $0.1
fa7b67d4: posts big blind $0.25
*** HOLE CARDS ***
Dealt to f4e2b370 
Dealt to 2904eaa2 
Dealt to fa7b67d4 
Dealt to Hero [9d 3h]
Dealt to d13258d2 
Dealt to ba032eea 
Hero: folds
d13258d2: folds
ba032eea: folds
f4e2b370: folds
2904eaa2: folds
Uncalled bet ($0.15) returned to fa7b67d4
*** SHOWDOWN ***
fa7b67d4 collected $0.2 from pot
*** SUMMARY ***
Total pot $0.2
Seat 1: f4e2b370 (button) folded before Flop (didn't bet)
Seat 2: 2904eaa2 (small blind) folded before Flop
Seat 3: fa7b67d4 (big blind) collected ($0.2)
Seat 4: Hero folded before Flop (didn't bet)
Seat 5: d13258d2 folded before Flop (didn't bet)
Seat 6: ba032eea folded before Flop (didn't bet)


Poker Hand #RC94787889: Hold'em No Limit ($0.1/$0.25) - 2020/04/06 23:09:23
Table 'RushAndCash318303' 6-max Seat #1 is the button
Seat 1: 3f7e31d ($24.47 in chips)
Seat 2: Hero ($28.86 in chips)
Seat 3: eb5021b0 ($49.17 in chips)
Seat 4: 9d598a03 ($55.94 in chips)
Seat 5: a0feaaaf ($22.04 in chips)
Seat 6: 7cc6a901 ($30.44 in chips)
Hero: posts small blind $0.1
eb5021b0: posts big blind $0.25
*** HOLE CARDS ***
Dealt to 3f7e31d 
Dealt to Hero [Kc Th]
Dealt to eb5021b0 
Dealt to 9d598a03 
Dealt to a0feaaaf 
Dealt to 7cc6a901 
9d598a03: folds
a0feaaaf: folds
7cc6a901: raises $0.38 to $0.63
3f7e31d: folds
Hero: folds
eb5021b0: folds
Uncalled bet ($0.38) returned to 7cc6a901
*** SHOWDOWN ***
7cc6a901 collected $0.6 from pot
*** SUMMARY ***
Total pot $0.6
Seat 1: 3f7e31d (button) folded before Flop (didn't bet)
Seat 2: Hero (small blind) folded before Flop
Seat 3: eb5021b0 (big blind) folded before Flop
Seat 4: 9d598a03 folded before Flop (didn't bet)
Seat 5: a0feaaaf folded before Flop (didn't bet)
Seat 6: 7cc6a901 collected ($0.6)


Poker Hand #RC94787911: Hold'em No Limit ($0.1/$0.25) - 2020/04/06 23:09:27
Table 'RushAndCash318307' 6-max Seat #1 is the button
Seat 1: Hero ($28.76 in chips)
Seat 2: 22aa740d ($25.1 in chips)
Seat 3: a0feaaaf ($22.04 in chips)
Seat 4: 9d598a03 ($55.94 in chips)
Seat 5: 2258ad9f ($41.37 in chips)
Seat 6: eb5021b0 ($48.92 in chips)
22aa740d: posts small blind $0.1
a0feaaaf: posts big blind $0.25
*** HOLE CARDS ***
Dealt to Hero [Td 5d]
Dealt to 22aa740d 
Dealt to a0feaaaf 
Dealt to 9d598a03 
Dealt to 2258ad9f 
Dealt to eb5021b0 
9d598a03: folds
2258ad9f: raises $0.38 to $0.63
eb5021b0: folds
Hero: folds
22aa740d: folds
a0feaaaf: raises $1.37 to $2
2258ad9f: calls $1.37
*** FLOP *** [2s Js Jh]
a0feaaaf: bets $4.1
2258ad9f: folds
Uncalled bet ($4.1) returned to a0feaaaf
*** SHOWDOWN ***
a0feaaaf collected $4.1 from pot
*** SUMMARY ***
Total pot $4.1
Board [2s Js Jh]
Seat 1: Hero (button) folded before Flop (didn't bet)
Seat 2: 22aa740d (small blind) folded before Flop
Seat 3: a0feaaaf (big blind) won ($4.1)
Seat 4: 9d598a03 folded before Flop (didn't bet)
Seat 5: 2258ad9f folded on the Flop
Seat 6: eb5021b0 folded before Flop (didn't bet)


Poker Hand #RC94787959: Hold'em No Limit ($0.1/$0.25) - 2020/04/06 23:09:36
Table 'RushAndCash318314' 6-max Seat #1 is the button
Seat 1: f8b1513e ($25.68 in chips)
Seat 2: 58b04451 ($27.15 in chips)
Seat 3: Hero ($28.76 in chips)
Seat 4: 7357eb2f ($37.89 in chips)
Seat 5: 17480666 ($80.41 in chips)
Seat 6: e32407ac ($38.13 in chips)
58b04451: posts small blind $0.1
Hero: posts big blind $0.25
*** HOLE CARDS ***
Dealt to f8b1513e 
Dealt to 58b04451 
Dealt to Hero [7c 4d]
Dealt to 7357eb2f 
Dealt to 17480666 
Dealt to e32407ac 
7357eb2f: folds
17480666: folds
e32407ac: folds
f8b1513e: raises $0.5 to $0.75
58b04451: folds
Hero: folds
Uncalled bet ($0.5) returned to f8b1513e
*** SHOWDOWN ***
f8b1513e collected $0.6 from pot
*** SUMMARY ***
Total pot $0.6
Seat 1: f8b1513e (button) collected ($0.6)
Seat 2: 58b04451 (small blind) folded before Flop
Seat 3: Hero (big blind) folded before Flop
Seat 4: 7357eb2f folded before Flop (didn't bet)
Seat 5: 17480666 folded before Flop (didn't bet)
Seat 6: e32407ac folded before Flop (didn't bet)


Poker Hand #RC94787984: Hold'em No Limit ($0.1/$0.25) - 2020/04/06 23:09:41
Table 'RushAndCash318318' 6-max Seat #1 is the button
Seat 1: 8b344141 ($14.35 in chips)
Seat 2: 2aa6d89 ($22.76 in chips)
Seat 3: 7357eb2f ($37.89 in chips)
Seat 4: Hero ($28.51 in chips)
Seat 5: 41ab7510 ($26.34 in chips)
Seat 6: 22aa740d ($25 in chips)
2aa6d89: posts small blind $0.1
7357eb2f: posts big blind $0.25
*** HOLE CARDS ***
Dealt to 8b344141 
Dealt to 2aa6d89 
Dealt to 7357eb2f 
Dealt to Hero [8h 2h]
Dealt to 41ab7510 
Dealt to 22aa740d 
Hero: folds
41ab7510: raises $0.38 to $0.63
22aa740d: folds
8b344141: folds
2aa6d89: folds
7357eb2f: folds
Uncalled bet ($0.38) returned to 41ab7510
*** SHOWDOWN ***
41ab7510 collected $0.6 from pot
*** SUMMARY ***
Total pot $0.6
Seat 1: 8b344141 (button) folded before Flop (didn't bet)
Seat 2: 2aa6d89 (small blind) folded before Flop
Seat 3: 7357eb2f (big blind) folded before Flop
Seat 4: Hero folded before Flop (didn't bet)
Seat 5: 41ab7510 collected ($0.6)
Seat 6: 22aa740d folded before Flop (didn't bet)


Poker Hand #RC94788004: Hold'em No Limit ($0.1/$0.25) - 2020/04/06 23:09:45
Table 'RushAndCash318321' 6-max Seat #1 is the button
Seat 1: cce649b7 ($23.55 in chips)
Seat 2: 1b4ad4ae ($28.04 in chips)
Seat 3: 83e38e49 ($69.87 in chips)
Seat 4: Hero ($28.51 in chips)
Seat 5: fa7b67d4 ($13.4 in chips)
Seat 6: 2aa6d89 ($22.66 in chips)
1b4ad4ae: posts small blind $0.1
83e38e49: posts big blind $0.25
*** HOLE CARDS ***
Dealt to cce649b7 
Dealt to 1b4ad4ae 
Dealt to 83e38e49 
Dealt to Hero [6c 2h]
Dealt to fa7b67d4 
Dealt to 2aa6d89 
Hero: folds
fa7b67d4: folds
2aa6d89: raises $0.25 to $0.5
cce649b7: calls $0.5
1b4ad4ae: folds
83e38e49: calls $0.25
*** FLOP *** [4c Kd Js]
83e38e49: checks
2aa6d89: checks
cce649b7: checks
*** TURN *** [4c Kd Js] [Qs]
83e38e49: checks
2aa6d89: checks
cce649b7: checks
*** RIVER *** [4c Kd Js Qs] [Ts]
83e38e49: checks
2aa6d89: checks
cce649b7: bets $0.85
83e38e49: calls $0.85
2aa6d89: folds
cce649b7: shows [8c Ac] (Aces-High Straight)
83e38e49: shows [2d Ad] (Aces-High Straight)
*** SHOWDOWN ***
cce649b7 collected $1.65 from pot
83e38e49 collected $1.65 from pot
*** SUMMARY ***
Total pot $3.3
Board [4c Kd Js Qs Ts]
Seat 1: cce649b7 (button) showed [Ac 8c] and won ($1.65) with Aces-High Straight
Seat 2: 1b4ad4ae (small blind) folded before Flop
Seat 3: 83e38e49 (big blind) showed [Ad 2d] and won ($1.65) with Aces-High Straight
Seat 4: Hero folded before Flop (didn't bet)
Seat 5: fa7b67d4 folded before Flop (didn't bet)
Seat 6: 2aa6d89 folded on the River


Poker Hand #RC94788025: Hold'em No Limit ($0.1/$0.25) - 2020/04/06 23:09:50
Table 'RushAndCash318324' 6-max Seat #1 is the button
Seat 1: Hero ($28.51 in chips)
Seat 2: 9d598a03 ($55.69 in chips)
Seat 3: 8f2f88a4 ($45.62 in chips)
Seat 4: aa8e6e7c ($19.61 in chips)
Seat 5: afa5143c ($25 in chips)
Seat 6: fa7b67d4 ($13.4 in chips)
9d598a03: posts small blind $0.1
8f2f88a4: posts big blind $0.25
*** HOLE CARDS ***
Dealt to Hero [Kh 5h]
Dealt to 9d598a03 
Dealt to 8f2f88a4 
Dealt to aa8e6e7c 
Dealt to afa5143c 
Dealt to fa7b67d4 
aa8e6e7c: folds
afa5143c: folds
fa7b67d4: raises $0.5 to $0.75
Hero: folds
9d598a03: raises $1.75 to $2.5
8f2f88a4: folds
fa7b67d4: folds
Uncalled bet ($1.75) returned to 9d598a03
*** SHOWDOWN ***
9d598a03 collected $1.75 from pot
*** SUMMARY ***
Total pot $1.75
Seat 1: Hero (button) folded before Flop (didn't bet)
Seat 2: 9d598a03 (small blind) collected ($1.75)
Seat 3: 8f2f88a4 (big blind) folded before Flop
Seat 4: aa8e6e7c folded before Flop (didn't bet)
Seat 5: afa5143c folded before Flop (didn't bet)
Seat 6: fa7b67d4 folded before Flop


Poker Hand #RC94788042: Hold'em No Limit ($0.1/$0.25) - 2020/04/06 23:09:54
Table 'RushAndCash318327' 6-max Seat #1 is the button
Seat 1: afa5143c ($25 in chips)
Seat 2: 93b71bcb ($47.6 in chips)
Seat 3: Hero ($28.51 in chips)
Seat 4: 8b344141 ($14.35 in chips)
Seat 5: ea5eba95 ($98.29 in chips)
Seat 6: b215699c ($25 in chips)
93b71bcb: posts small blind $0.1
Hero: posts big blind $0.25
*** HOLE CARDS ***
Dealt to afa5143c 
Dealt to 93b71bcb 
Dealt to Hero [Ks Th]
Dealt to 8b344141 
Dealt to ea5eba95 
Dealt to b215699c 
8b344141: folds
ea5eba95: folds
b215699c: folds
afa5143c: raises $0.38 to $0.63
93b71bcb: folds
Hero: folds
Uncalled bet ($0.38) returned to afa5143c
*** SHOWDOWN ***
afa5143c collected $0.6 from pot
*** SUMMARY ***
Total pot $0.6
Seat 1: afa5143c (button) collected ($0.6)
Seat 2: 93b71bcb (small blind) folded before Flop
Seat 3: Hero (big blind) folded before Flop
Seat 4: 8b344141 folded before Flop (didn't bet)
Seat 5: ea5eba95 folded before Flop (didn't bet)
Seat 6: b215699c folded before Flop (didn't bet)


Poker Hand #RC94788058: Hold'em No Limit ($0.1/$0.25) - 2020/04/06 23:09:57
Table 'RushAndCash318330' 6-max Seat #1 is the button
Seat 1: 93b71bcb ($47.5 in chips)
Seat 2: Hero ($28.26 in chips)
Seat 3: 41ab7510 ($26.69 in chips)
Seat 4: ea5eba95 ($98.29 in chips)
Seat 5: 17480666 ($80.16 in chips)
Seat 6: 5e03da34 ($41.08 in chips)
Hero: posts small blind $0.1
41ab7510: posts big blind $0.25
*** HOLE CARDS ***
Dealt to 93b71bcb 
Dealt to Hero [9d 5c]
Dealt to 41ab7510 
Dealt to ea5eba95 
Dealt to 17480666 
Dealt to 5e03da34 
ea5eba95: raises $0.38 to $0.63
17480666: folds
5e03da34: folds
93b71bcb: folds
Hero: folds
41ab7510: calls $0.38
*** FLOP *** [Th 3s 8c]
41ab7510: checks
ea5eba95: checks
*** TURN *** [Th 3s 8c] [Jd]
41ab7510: checks
ea5eba95: bets $0.7
41ab7510: calls $0.7
*** RIVER *** [Th 3s 8c Jd] [5s]
41ab7510: checks
ea5eba95: checks
41ab7510: shows [9h Jh] (Pair of Jacks)
ea5eba95: shows [Kc Qd] (King-High)
*** SHOWDOWN ***
41ab7510 collected $2.76 from pot
*** SUMMARY ***
Total pot $2.76
Board [Th 3s 8c Jd 5s]
Seat 1: 93b71bcb (button) folded before Flop (didn't bet)
Seat 2: Hero (small blind) folded before Flop
Seat 3: 41ab7510 (big blind) showed [Jh 9h] and won ($2.76) with Pair of Jacks
Seat 4: ea5eba95 showed [Kc Qd] and lost with King-High
Seat 5: 17480666 folded before Flop (didn't bet)
Seat 6: 5e03da34 folded before Flop (didn't bet)


Poker Hand #RC94788078: Hold'em No Limit ($0.1/$0.25) - 2020/04/06 23:10:01
Table 'RushAndCash318334' 6-max Seat #1 is the button
Seat 1: Hero ($28.16 in chips)
Seat 2: afc178f9 ($27.15 in chips)
Seat 3: d8a224aa ($27.66 in chips)
Seat 4: 8ef8832c ($25 in chips)
Seat 5: b215699c ($25 in chips)
Seat 6: fcd4c9fa ($12.75 in chips)
afc178f9: posts small blind $0.1
d8a224aa: posts big blind $0.25
*** HOLE CARDS ***
Dealt to Hero [7d 3d]
Dealt to afc178f9 
Dealt to d8a224aa 
Dealt to 8ef8832c 
Dealt to b215699c 
Dealt to fcd4c9fa 
8ef8832c: folds
b215699c: folds
fcd4c9fa: folds
Hero: folds
afc178f9: folds
Uncalled bet ($0.15) returned to d8a224aa
*** SHOWDOWN ***
d8a224aa collected $0.2 from pot
*** SUMMARY ***
Total pot $0.2
Seat 1: Hero (button) folded before Flop (didn't bet)
Seat 2: afc178f9 (small blind) folded before Flop
Seat 3: d8a224aa (big blind) collected ($0.2)
Seat 4: 8ef8832c folded before Flop (didn't bet)
Seat 5: b215699c folded before Flop (didn't bet)
Seat 6: fcd4c9fa folded before Flop (didn't bet)


Poker Hand #RC94788124: Hold'em No Limit ($0.1/$0.25) - 2020/04/06 23:10:10
Table 'RushAndCash318342' 6-max Seat #1 is the button
Seat 1: afc178f9 ($27.4 in chips)
Seat 2: 591642a3 ($14.25 in chips)
Seat 3: 94efc628 ($31.94 in chips)
Seat 4: 8ef8832c ($25 in chips)
Seat 5: Hero ($28.16 in chips)
Seat 6: 5e03da34 ($41.08 in chips)
591642a3: posts small blind $0.1
94efc628: posts big blind $0.25
*** HOLE CARDS ***
Dealt to afc178f9 
Dealt to 591642a3 
Dealt to 94efc628 
Dealt to 8ef8832c 
Dealt to Hero [Qh 7c]
Dealt to 5e03da34 
8ef8832c: folds
Hero: folds
5e03da34: folds
afc178f9: raises $0.38 to $0.63
591642a3: folds
94efc628: folds
Uncalled bet ($0.38) returned to afc178f9
*** SHOWDOWN ***
afc178f9 collected $0.6 from pot
*** SUMMARY ***
Total pot $0.6
Seat 1: afc178f9 (button) collected ($0.6)
Seat 2: 591642a3 (small blind) folded before Flop
Seat 3: 94efc628 (big blind) folded before Flop
Seat 4: 8ef8832c folded before Flop (didn't bet)
Seat 5: Hero folded before Flop (didn't bet)
Seat 6: 5e03da34 folded before Flop (didn't bet)


Poker Hand #RC94788139: Hold'em No Limit ($0.1/$0.25) - 2020/04/06 23:10:14
Table 'RushAndCash318344' 6-max Seat #1 is the button
Seat 1: 8cda51b0 ($72.36 in chips)
Seat 2: d8a224aa ($27.76 in chips)
Seat 3: 2258ad9f ($39.37 in chips)
Seat 4: fcd4c9fa ($12.75 in chips)
Seat 5: 41cf19d5 ($68.95 in chips)
Seat 6: Hero ($28.16 in chips)
d8a224aa: posts small blind $0.1
2258ad9f: posts big blind $0.25
*** HOLE CARDS ***
Dealt to 8cda51b0 
Dealt to d8a224aa 
Dealt to 2258ad9f 
Dealt to fcd4c9fa 
Dealt to 41cf19d5 
Dealt to Hero [Kh 5d]
fcd4c9fa: folds
41cf19d5: folds
Hero: folds
8cda51b0: folds
d8a224aa: folds
Uncalled bet ($0.15) returned to 2258ad9f
*** SHOWDOWN ***
2258ad9f collected $0.2 from pot
*** SUMMARY ***
Total pot $0.2
Seat 1: 8cda51b0 (button) folded before Flop (didn't bet)
Seat 2: d8a224aa (small blind) folded before Flop
Seat 3: 2258ad9f (big blind) collected ($0.2)
Seat 4: fcd4c9fa folded before Flop (didn't bet)
Seat 5: 41cf19d5 folded before Flop (didn't bet)
Seat 6: Hero folded before Flop (didn't bet)


Poker Hand #RC94788157: Hold'em No Limit ($0.1/$0.25) - 2020/04/06 23:10:17
Table 'RushAndCash318347' 6-max Seat #1 is the button
Seat 1: 1b4ad4ae ($27.69 in chips)
Seat 2: 41cf19d5 ($68.95 in chips)
Seat 3: fa7b67d4 ($12.65 in chips)
Seat 4: Hero ($28.16 in chips)
Seat 5: 17480666 ($80.16 in chips)
Seat 6: 9d598a03 ($56.61 in chips)
41cf19d5: posts small blind $0.1
fa7b67d4: posts big blind $0.25
*** HOLE CARDS ***
Dealt to 1b4ad4ae 
Dealt to 41cf19d5 
Dealt to fa7b67d4 
Dealt to Hero [8d 2c]
Dealt to 17480666 
Dealt to 9d598a03 
Hero: folds
17480666: folds
9d598a03: raises $0.38 to $0.63
1b4ad4ae: folds
41cf19d5: folds
fa7b67d4: folds
Uncalled bet ($0.38) returned to 9d598a03
*** SHOWDOWN ***
9d598a03 collected $0.6 from pot
*** SUMMARY ***
Total pot $0.6
Seat 1: 1b4ad4ae (button) folded before Flop (didn't bet)
Seat 2: 41cf19d5 (small blind) folded before Flop
Seat 3: fa7b67d4 (big blind) folded before Flop
Seat 4: Hero folded before Flop (didn't bet)
Seat 5: 17480666 folded before Flop (didn't bet)
Seat 6: 9d598a03 collected ($0.6)


Poker Hand #RC94788171: Hold'em No Limit ($0.1/$0.25) - 2020/04/06 23:10:21
Table 'RushAndCash318349' 6-max Seat #1 is the button
Seat 1: 9423373a ($54.9 in chips)
Seat 2: 8fb93df3 ($35.27 in chips)
Seat 3: Hero ($28.16 in chips)
Seat 4: d43f12c1 ($14.73 in chips)
Seat 5: dc09684b ($25.67 in chips)
Seat 6: 94efc628 ($31.59 in chips)
8fb93df3: posts small blind $0.1
Hero: posts big blind $0.25
*** HOLE CARDS ***
Dealt to 9423373a 
Dealt to 8fb93df3 
Dealt to Hero [Ks 7d]
Dealt to d43f12c1 
Dealt to dc09684b 
Dealt to 94efc628 
d43f12c1: folds
dc09684b: raises $0.38 to $0.63
94efc628: folds
9423373a: folds
8fb93df3: folds
Hero: folds
Uncalled bet ($0.38) returned to dc09684b
*** SHOWDOWN ***
dc09684b collected $0.6 from pot
*** SUMMARY ***
Total pot $0.6
Seat 1: 9423373a (button) folded before Flop (didn't bet)
Seat 2: 8fb93df3 (small blind) folded before Flop
Seat 3: Hero (big blind) folded before Flop
Seat 4: d43f12c1 folded before Flop (didn't bet)
Seat 5: dc09684b collected ($0.6)
Seat 6: 94efc628 folded before Flop (didn't bet)


Poker Hand #RC94788187: Hold'em No Limit ($0.1/$0.25) - 2020/04/06 23:10:24
Table 'RushAndCash318352' 6-max Seat #1 is the button
Seat 1: 2b4254fb ($63.25 in chips)
Seat 2: eeae3d7 ($11.75 in chips)
Seat 3: 8a31aea7 ($58.83 in chips)
Seat 4: f8b1513e ($25.28 in chips)
Seat 5: 95833c67 ($9.5 in chips)
Seat 6: Hero ($27.91 in chips)
eeae3d7: posts small blind $0.1
8a31aea7: posts big blind $0.25
*** HOLE CARDS ***
Dealt to 2b4254fb 
Dealt to eeae3d7 
Dealt to 8a31aea7 
Dealt to f8b1513e 
Dealt to 95833c67 
Dealt to Hero [Kc 4s]
f8b1513e: folds
95833c67: raises $0.25 to $0.5
Hero: folds
2b4254fb: folds
eeae3d7: folds
8a31aea7: calls $0.25
*** FLOP *** [Ad Ac Jh]
8a31aea7: checks
95833c67: bets $0.5
8a31aea7: folds
Uncalled bet ($0.5) returned to 95833c67
*** SHOWDOWN ***
95833c67 collected $1.1 from pot
*** SUMMARY ***
Total pot $1.1
Board [Ad Ac Jh]
Seat 1: 2b4254fb (button) folded before Flop (didn't bet)
Seat 2: eeae3d7 (small blind) folded before Flop
Seat 3: 8a31aea7 (big blind) folded on the Flop
Seat 4: f8b1513e folded before Flop (didn't bet)
Seat 5: 95833c67 won ($1.1)
Seat 6: Hero folded before Flop (didn't bet)


Poker Hand #RC94788203: Hold'em No Limit ($0.1/$0.25) - 2020/04/06 23:10:28
Table 'RushAndCash318355' 6-max Seat #1 is the button
Seat 1: d7f99a39 ($15.9 in chips)
Seat 2: 8cda51b0 ($72.36 in chips)
Seat 3: 41cf19d5 ($68.85 in chips)
Seat 4: 2b4254fb ($63.25 in chips)
Seat 5: 9876d8db ($103.45 in chips)
Seat 6: Hero ($27.91 in chips)
8cda51b0: posts small blind $0.1
41cf19d5: posts big blind $0.25
*** HOLE CARDS ***
Dealt to d7f99a39 
Dealt to 8cda51b0 
Dealt to 41cf19d5 
Dealt to 2b4254fb 
Dealt to 9876d8db 
Dealt to Hero [9d 4h]
2b4254fb: raises $0.38 to $0.63
9876d8db: folds
Hero: folds
d7f99a39: folds
8cda51b0: folds
41cf19d5: folds
Uncalled bet ($0.38) returned to 2b4254fb
*** SHOWDOWN ***
2b4254fb collected $0.6 from pot
*** SUMMARY ***
Total pot $0.6
Seat 1: d7f99a39 (button) folded before Flop (didn't bet)
Seat 2: 8cda51b0 (small blind) folded before Flop
Seat 3: 41cf19d5 (big blind) folded before Flop
Seat 4: 2b4254fb collected ($0.6)
Seat 5: 9876d8db folded before Flop (didn't bet)
Seat 6: Hero folded before Flop (didn't bet)


Poker Hand #RC94788232: Hold'em No Limit ($0.1/$0.25) - 2020/04/06 23:10:34
Table 'RushAndCash318358' 6-max Seat #1 is the button
Seat 1: 8cda51b0 ($72.61 in chips)
Seat 2: fcd4c9fa ($12.5 in chips)
Seat 3: 9d598a03 ($56.96 in chips)
Seat 4: 36ac4586 ($27.56 in chips)
Seat 5: f8b1513e ($25.28 in chips)
Seat 6: Hero ($27.91 in chips)
fcd4c9fa: posts small blind $0.1
9d598a03: posts big blind $0.25
*** HOLE CARDS ***
Dealt to 8cda51b0 
Dealt to fcd4c9fa 
Dealt to 9d598a03 
Dealt to 36ac4586 
Dealt to f8b1513e 
Dealt to Hero [Js 4s]
36ac4586: folds
f8b1513e: folds
Hero: folds
8cda51b0: raises $0.38 to $0.63
fcd4c9fa: folds
9d598a03: calls $0.38
*** FLOP *** [4c 8d 6h]
9d598a03: checks
8cda51b0: bets $0.7
9d598a03: raises $1.4 to $2.1
8cda51b0: raises $3.9 to $6
9d598a03: folds
Uncalled bet ($3.9) returned to 8cda51b0
*** SHOWDOWN ***
8cda51b0 collected $5.56 from pot
*** SUMMARY ***
Total pot $5.56
Board [4c 8d 6h]
Seat 1: 8cda51b0 (button) won ($5.56)
Seat 2: fcd4c9fa (small blind) folded before Flop
Seat 3: 9d598a03 (big blind) folded on the Flop
Seat 4: 36ac4586 folded before Flop (didn't bet)
Seat 5: f8b1513e folded before Flop (didn't bet)
Seat 6: Hero folded before Flop (didn't bet)


Poker Hand #RC94788250: Hold'em No Limit ($0.1/$0.25) - 2020/04/06 23:10:37
Table 'RushAndCash318361' 6-max Seat #1 is the button
Seat 1: 8f2f88a4 ($44.74 in chips)
Seat 2: Hero ($27.91 in chips)
Seat 3: 38359122 ($12.5 in chips)
Seat 4: 9423373a ($54.9 in chips)
Seat 5: 604f36f0 ($30.78 in chips)
Seat 6: 36ac4586 ($27.56 in chips)
Hero: posts small blind $0.1
38359122: posts big blind $0.25
*** HOLE CARDS ***
Dealt to 8f2f88a4 
Dealt to Hero [8h 5c]
Dealt to 38359122 
Dealt to 9423373a 
Dealt to 604f36f0 
Dealt to 36ac4586 
9423373a: raises $0.38 to $0.63
604f36f0: folds
36ac4586: folds
8f2f88a4: folds
Hero: folds
38359122: folds
Uncalled bet ($0.38) returned to 9423373a
*** SHOWDOWN ***
9423373a collected $0.6 from pot
*** SUMMARY ***
Total pot $0.6
Seat 1: 8f2f88a4 (button) folded before Flop (didn't bet)
Seat 2: Hero (small blind) folded before Flop
Seat 3: 38359122 (big blind) folded before Flop
Seat 4: 9423373a collected ($0.6)
Seat 5: 604f36f0 folded before Flop (didn't bet)
Seat 6: 36ac4586 folded before Flop (didn't bet)


Poker Hand #RC94788264: Hold'em No Limit ($0.1/$0.25) - 2020/04/06 23:10:41
Table 'RushAndCash318364' 6-max Seat #1 is the button
Seat 1: 41cf19d5 ($68.6 in chips)
Seat 2: Hero ($27.81 in chips)
Seat 3: fd369e31 ($49.18 in chips)
Seat 4: 36ac4586 ($27.56 in chips)
Seat 5: 2b4254fb ($63.6 in chips)
Seat 6: eeae3d7 ($12 in chips)
Hero: posts small blind $0.1
fd369e31: posts big blind $0.25
*** HOLE CARDS ***
Dealt to 41cf19d5 
Dealt to Hero [Ks 3d]
Dealt to fd369e31 
Dealt to 36ac4586 
Dealt to 2b4254fb 
Dealt to eeae3d7 
36ac4586: folds
2b4254fb: folds
eeae3d7: folds
41cf19d5: folds
Hero: folds
Uncalled bet ($0.15) returned to fd369e31
*** SHOWDOWN ***
fd369e31 collected $0.2 from pot
*** SUMMARY ***
Total pot $0.2
Seat 1: 41cf19d5 (button) folded before Flop (didn't bet)
Seat 2: Hero (small blind) folded before Flop
Seat 3: fd369e31 (big blind) collected ($0.2)
Seat 4: 36ac4586 folded before Flop (didn't bet)
Seat 5: 2b4254fb folded before Flop (didn't bet)
Seat 6: eeae3d7 folded before Flop (didn't bet)


Poker Hand #RC94788281: Hold'em No Limit ($0.1/$0.25) - 2020/04/06 23:10:44
Table 'RushAndCash318366' 6-max Seat #1 is the button
Seat 1: Hero ($27.71 in chips)
Seat 2: 8ef8832c ($25 in chips)
Seat 3: eb5021b0 ($54.84 in chips)
Seat 4: 72fa991e ($29.08 in chips)
Seat 5: b9bbf733 ($37.57 in chips)
Seat 6: d7f99a39 ($15.9 in chips)
8ef8832c: posts small blind $0.1
eb5021b0: posts big blind $0.25
*** HOLE CARDS ***
Dealt to Hero [Kd 4s]
Dealt to 8ef8832c 
Dealt to eb5021b0 
Dealt to 72fa991e 
Dealt to b9bbf733 
Dealt to d7f99a39 
72fa991e: folds
b9bbf733: raises $0.5 to $0.75
d7f99a39: folds
Hero: folds
8ef8832c: folds
eb5021b0: calls $0.5
*** FLOP *** [Ts Ad 8c]
eb5021b0: checks
b9bbf733: bets $1
eb5021b0: folds
Uncalled bet ($1) returned to b9bbf733
*** SHOWDOWN ***
b9bbf733 collected $1.6 from pot
*** SUMMARY ***
Total pot $1.6
Board [Ts Ad 8c]
Seat 1: Hero (button) folded before Flop (didn't bet)
Seat 2: 8ef8832c (small blind) folded before Flop
Seat 3: eb5021b0 (big blind) folded on the Flop
Seat 4: 72fa991e folded before Flop (didn't bet)
Seat 5: b9bbf733 won ($1.6)
Seat 6: d7f99a39 folded before Flop (didn't bet)


Poker Hand #RC94788293: Hold'em No Limit ($0.1/$0.25) - 2020/04/06 23:10:47
Table 'RushAndCash318370' 6-max Seat #1 is the button
Seat 1: 604f36f0 ($30.68 in chips)
Seat 2: 2aa6d89 ($21.91 in chips)
Seat 3: 107baea2 ($12 in chips)
Seat 4: f4e2b370 ($13.64 in chips)
Seat 5: eeae3d7 ($12 in chips)
Seat 6: Hero ($27.71 in chips)
2aa6d89: posts small blind $0.1
107baea2: posts big blind $0.25
*** HOLE CARDS ***
Dealt to 604f36f0 
Dealt to 2aa6d89 
Dealt to 107baea2 
Dealt to f4e2b370 
Dealt to eeae3d7 
Dealt to Hero [Ah Qh]
f4e2b370: folds
eeae3d7: folds
Hero: raises $0.38 to $0.63
604f36f0: folds
2aa6d89: folds
107baea2: calls $0.38
*** FLOP *** [4d 2s 4c]
107baea2: bets $0.7
Hero: calls $0.7
*** TURN *** [4d 2s 4c] [Kh]
107baea2: checks
Hero: checks
*** RIVER *** [4d 2s 4c Kh] [8c]
107baea2: bets $1.4
Hero: folds
Uncalled bet ($1.4) returned to 107baea2
*** SHOWDOWN ***
107baea2 collected $2.76 from pot
*** SUMMARY ***
Total pot $2.76
Board [4d 2s 4c Kh 8c]
Seat 1: 604f36f0 (button) folded before Flop (didn't bet)
Seat 2: 2aa6d89 (small blind) folded before Flop
Seat 3: 107baea2 (big blind) won ($2.76)
Seat 4: f4e2b370 folded before Flop (didn't bet)
Seat 5: eeae3d7 folded before Flop (didn't bet)
Seat 6: Hero folded on the River


Poker Hand #RC94788495: Hold'em No Limit ($0.1/$0.25) - 2020/04/06 23:11:30
Table 'RushAndCash318404' 6-max Seat #1 is the button
Seat 1: b215699c ($25.25 in chips)
Seat 2: 107baea2 ($13.3 in chips)
Seat 3: Hero ($26.38 in chips)
Seat 4: 94efc628 ($31.69 in chips)
Seat 5: 92c8c82d ($27.49 in chips)
Seat 6: 22aa740d ($25.6 in chips)
107baea2: posts small blind $0.1
Hero: posts big blind $0.25
*** HOLE CARDS ***
Dealt to b215699c 
Dealt to 107baea2 
Dealt to Hero [Qc Td]
Dealt to 94efc628 
Dealt to 92c8c82d 
Dealt to 22aa740d 
94efc628: folds
92c8c82d: folds
22aa740d: folds
b215699c: folds
107baea2: folds
Uncalled bet ($0.15) returned to Hero
*** SHOWDOWN ***
Hero collected $0.2 from pot
*** SUMMARY ***
Total pot $0.2
Seat 1: b215699c (button) folded before Flop (didn't bet)
Seat 2: 107baea2 (small blind) folded before Flop
Seat 3: Hero (big blind) collected ($0.2)
Seat 4: 94efc628 folded before Flop (didn't bet)
Seat 5: 92c8c82d folded before Flop (didn't bet)
Seat 6: 22aa740d folded before Flop (didn't bet)


Poker Hand #RC94788562: Hold'em No Limit ($0.1/$0.25) - 2020/04/06 23:11:43
Table 'RushAndCash318413' 6-max Seat #1 is the button
Seat 1: Hero ($26.48 in chips)
Seat 2: b00dbb18 ($25 in chips)
Seat 3: bd6eeaf3 ($41.64 in chips)
Seat 4: d43f12c1 ($12.5 in chips)
Seat 5: f9ffb3ba ($25 in chips)
Seat 6: 2258ad9f ($52.72 in chips)
b00dbb18: posts small blind $0.1
bd6eeaf3: posts big blind $0.25
*** HOLE CARDS ***
Dealt to Hero [Kh 6d]
Dealt to b00dbb18 
Dealt to bd6eeaf3 
Dealt to d43f12c1 
Dealt to f9ffb3ba 
Dealt to 2258ad9f 
d43f12c1: folds
f9ffb3ba: folds
2258ad9f: raises $0.5 to $0.75
Hero: folds
b00dbb18: raises $1.75 to $2.5
bd6eeaf3: folds
2258ad9f: raises $6.5 to $9
b00dbb18: folds
Uncalled bet ($6.5) returned to 2258ad9f
*** SHOWDOWN ***
2258ad9f collected $5.25 from pot
*** SUMMARY ***
Total pot $5.25
Seat 1: Hero (button) folded before Flop (didn't bet)
Seat 2: b00dbb18 (small blind) folded before Flop
Seat 3: bd6eeaf3 (big blind) folded before Flop
Seat 4: d43f12c1 folded before Flop (didn't bet)
Seat 5: f9ffb3ba folded before Flop (didn't bet)
Seat 6: 2258ad9f collected ($5.25)


Poker Hand #RC94788596: Hold'em No Limit ($0.1/$0.25) - 2020/04/06 23:11:50
Table 'RushAndCash318418' 6-max Seat #1 is the button
Seat 1: 6b202021 ($9.95 in chips)
Seat 2: ab0e58dd ($25 in chips)
Seat 3: eb5021b0 ($53.99 in chips)
Seat 4: Hero ($26.48 in chips)
Seat 5: bc19997 ($25.68 in chips)
Seat 6: fd369e31 ($52.02 in chips)
ab0e58dd: posts small blind $0.1
eb5021b0: posts big blind $0.25
*** HOLE CARDS ***
Dealt to 6b202021 
Dealt to ab0e58dd 
Dealt to eb5021b0 
Dealt to Hero [8d 6c]
Dealt to bc19997 
Dealt to fd369e31 
Hero: folds
bc19997: folds
fd369e31: folds
6b202021: folds
ab0e58dd: folds
Uncalled bet ($0.15) returned to eb5021b0
*** SHOWDOWN ***
eb5021b0 collected $0.2 from pot
*** SUMMARY ***
Total pot $0.2
Seat 1: 6b202021 (button) folded before Flop (didn't bet)
Seat 2: ab0e58dd (small blind) folded before Flop
Seat 3: eb5021b0 (big blind) collected ($0.2)
Seat 4: Hero folded before Flop (didn't bet)
Seat 5: bc19997 folded before Flop (didn't bet)
Seat 6: fd369e31 folded before Flop (didn't bet)


Poker Hand #RC94788622: Hold'em No Limit ($0.1/$0.25) - 2020/04/06 23:11:54
Table 'RushAndCash318422' 6-max Seat #1 is the button
Seat 1: ab0e58dd ($25 in chips)
Seat 2: Hero ($26.48 in chips)
Seat 3: 2904eaa2 ($29.12 in chips)
Seat 4: 93b71bcb ($45.58 in chips)
Seat 5: f99bdf7f ($16.89 in chips)
Seat 6: f1eff963 ($12.85 in chips)
Hero: posts small blind $0.1
2904eaa2: posts big blind $0.25
*** HOLE CARDS ***
Dealt to ab0e58dd 
Dealt to Hero [As Td]
Dealt to 2904eaa2 
Dealt to 93b71bcb 
Dealt to f99bdf7f 
Dealt to f1eff963 
93b71bcb: raises $0.75 to $1
f99bdf7f: folds
f1eff963: folds
ab0e58dd: folds
Hero: folds
2904eaa2: raises $2.35 to $3.35
93b71bcb: folds
Uncalled bet ($2.35) returned to 2904eaa2
*** SHOWDOWN ***
2904eaa2 collected $2.1 from pot
*** SUMMARY ***
Total pot $2.1
Seat 1: ab0e58dd (button) folded before Flop (didn't bet)
Seat 2: Hero (small blind) folded before Flop
Seat 3: 2904eaa2 (big blind) collected ($2.1)
Seat 4: 93b71bcb folded before Flop
Seat 5: f99bdf7f folded before Flop (didn't bet)
Seat 6: f1eff963 folded before Flop (didn't bet)


Poker Hand #RC94788696: Hold'em No Limit ($0.1/$0.25) - 2020/04/06 23:12:08
Table 'RushAndCash318436' 6-max Seat #1 is the button
Seat 1: f8b1513e ($25.07 in chips)
Seat 2: 5e03da34 ($41.4 in chips)
Seat 3: 9423373a ($55.95 in chips)
Seat 4: afa5143c ($25 in chips)
Seat 5: 58b04451 ($31.84 in chips)
Seat 6: Hero ($26.38 in chips)
5e03da34: posts small blind $0.1
9423373a: posts big blind $0.25
*** HOLE CARDS ***
Dealt to f8b1513e 
Dealt to 5e03da34 
Dealt to 9423373a 
Dealt to afa5143c 
Dealt to 58b04451 
Dealt to Hero [Ad Qh]
afa5143c: folds
58b04451: folds
Hero: raises $0.38 to $0.63
f8b1513e: folds
5e03da34: folds
9423373a: folds
Uncalled bet ($0.38) returned to Hero
*** SHOWDOWN ***
Hero collected $0.6 from pot
*** SUMMARY ***
Total pot $0.6
Seat 1: f8b1513e (button) folded before Flop (didn't bet)
Seat 2: 5e03da34 (small blind) folded before Flop
Seat 3: 9423373a (big blind) folded before Flop
Seat 4: afa5143c folded before Flop (didn't bet)
Seat 5: 58b04451 folded before Flop (didn't bet)
Seat 6: Hero collected ($0.6)


Poker Hand #RC94788838: Hold'em No Limit ($0.1/$0.25) - 2020/04/06 23:12:35
Table 'RushAndCash318459' 6-max Seat #1 is the button
Seat 1: b00dbb18 ($25 in chips)
Seat 2: 17480666 ($105.24 in chips)
Seat 3: afa5143c ($25.35 in chips)
Seat 4: 2aa6d89 ($31.2 in chips)
Seat 5: ba032eea ($61.75 in chips)
Seat 6: Hero ($26.73 in chips)
17480666: posts small blind $0.1
afa5143c: posts big blind $0.25
*** HOLE CARDS ***
Dealt to b00dbb18 
Dealt to 17480666 
Dealt to afa5143c 
Dealt to 2aa6d89 
Dealt to ba032eea 
Dealt to Hero [Th 6c]
2aa6d89: folds
ba032eea: raises $0.38 to $0.63
Hero: folds
b00dbb18: calls $0.63
17480666: calls $0.53
afa5143c: folds
*** FLOP *** [2d 7s 9d]
17480666: checks
ba032eea: bets $1.1
b00dbb18: folds
17480666: folds
Uncalled bet ($1.1) returned to ba032eea
*** SHOWDOWN ***
ba032eea collected $2.14 from pot
*** SUMMARY ***
Total pot $2.14
Board [2d 7s 9d]
Seat 1: b00dbb18 (button) folded on the Flop
Seat 2: 17480666 (small blind) folded on the Flop
Seat 3: afa5143c (big blind) folded before Flop
Seat 4: 2aa6d89 folded before Flop (didn't bet)
Seat 5: ba032eea won ($2.14)
Seat 6: Hero folded before Flop (didn't bet)


Poker Hand #RC94788868: Hold'em No Limit ($0.1/$0.25) - 2020/04/06 23:12:41
Table 'RushAndCash318463' 6-max Seat #1 is the button
Seat 1: f9ffb3ba ($26.49 in chips)
Seat 2: 2aa6d89 ($31.2 in chips)
Seat 3: e0680a48 ($46.13 in chips)
Seat 4: 7bb17d1 ($12 in chips)
Seat 5: fd369e31 ($51.92 in chips)
Seat 6: Hero ($26.73 in chips)
2aa6d89: posts small blind $0.1
e0680a48: posts big blind $0.25
*** HOLE CARDS ***
Dealt to f9ffb3ba 
Dealt to 2aa6d89 
Dealt to e0680a48 
Dealt to 7bb17d1 
Dealt to fd369e31 
Dealt to Hero [Ks Td]
7bb17d1: folds
fd369e31: folds
Hero: raises $0.38 to $0.63
f9ffb3ba: folds
2aa6d89: folds
e0680a48: calls $0.38
*** FLOP *** [Ac 5s 3h]
e0680a48: checks
Hero: bets $0.5
e0680a48: calls $0.5
*** TURN *** [Ac 5s 3h] [9c]
e0680a48: checks
Hero: checks
*** RIVER *** [Ac 5s 3h 9c] [Ah]
e0680a48: checks
Hero: checks
e0680a48: shows [4s 4c] (Pair of Aces and Pair of Fours)
Hero: shows [Ks Td] (Pair of Aces)
*** SHOWDOWN ***
e0680a48 collected $2.36 from pot
*** SUMMARY ***
Total pot $2.36
Board [Ac 5s 3h 9c Ah]
Seat 1: f9ffb3ba (button) folded before Flop (didn't bet)
Seat 2: 2aa6d89 (small blind) folded before Flop
Seat 3: e0680a48 (big blind) showed [4s 4c] and won ($2.36) with Pair of Aces and Pair of Fours
Seat 4: 7bb17d1 folded before Flop (didn't bet)
Seat 5: fd369e31 folded before Flop (didn't bet)
Seat 6: Hero showed [Ks Td] and lost with Pair of Aces


Poker Hand #RC94789068: Hold'em No Limit ($0.1/$0.25) - 2020/04/06 23:13:24
Table 'RushAndCash318495' 6-max Seat #1 is the button
Seat 1: 2467bb49 ($25 in chips)
Seat 2: e0680a48 ($47.25 in chips)
Seat 3: d8a224aa ($32.88 in chips)
Seat 4: 8ef8832c ($25.67 in chips)
Seat 5: Hero ($25.6 in chips)
Seat 6: 9423373a ($56.26 in chips)
e0680a48: posts small blind $0.1
d8a224aa: posts big blind $0.25
*** HOLE CARDS ***
Dealt to 2467bb49 
Dealt to e0680a48 
Dealt to d8a224aa 
Dealt to 8ef8832c 
Dealt to Hero [9h 4d]
Dealt to 9423373a 
8ef8832c: folds
Hero: folds
9423373a: raises $0.38 to $0.63
2467bb49: folds
e0680a48: folds
d8a224aa: raises $2.12 to $2.75
9423373a: folds
Uncalled bet ($2.12) returned to d8a224aa
*** SHOWDOWN ***
d8a224aa collected $1.36 from pot
*** SUMMARY ***
Total pot $1.36
Seat 1: 2467bb49 (button) folded before Flop (didn't bet)
Seat 2: e0680a48 (small blind) folded before Flop
Seat 3: d8a224aa (big blind) collected ($1.36)
Seat 4: 8ef8832c folded before Flop (didn't bet)
Seat 5: Hero folded before Flop (didn't bet)
Seat 6: 9423373a folded before Flop


Poker Hand #RC94789084: Hold'em No Limit ($0.1/$0.25) - 2020/04/06 23:13:27
Table 'RushAndCash318496' 6-max Seat #1 is the button
Seat 1: afc178f9 ($30.9 in chips)
Seat 2: 6b202021 ($9.2 in chips)
Seat 3: Hero ($25.6 in chips)
Seat 4: 2258ad9f ($54.58 in chips)
Seat 5: f38f7769 ($25 in chips)
Seat 6: fd369e31 ($51.92 in chips)
6b202021: posts small blind $0.1
Hero: posts big blind $0.25
*** HOLE CARDS ***
Dealt to afc178f9 
Dealt to 6b202021 
Dealt to Hero [Qh 7c]
Dealt to 2258ad9f 
Dealt to f38f7769 
Dealt to fd369e31 
2258ad9f: folds
f38f7769: folds
fd369e31: folds
afc178f9: raises $0.38 to $0.63
6b202021: raises $8.57 to $9.2 and is all-in
Hero: folds
afc178f9: folds
Uncalled bet ($8.57) returned to 6b202021
*** SHOWDOWN ***
6b202021 collected $1.51 from pot
*** SUMMARY ***
Total pot $1.51
Seat 1: afc178f9 (button) folded before Flop
Seat 2: 6b202021 (small blind) collected ($1.51)
Seat 3: Hero (big blind) folded before Flop
Seat 4: 2258ad9f folded before Flop (didn't bet)
Seat 5: f38f7769 folded before Flop (didn't bet)
Seat 6: fd369e31 folded before Flop (didn't bet)


Poker Hand #RC94789113: Hold'em No Limit ($0.1/$0.25) - 2020/04/06 23:13:33
Table 'RushAndCash318500' 6-max Seat #1 is the button
Seat 1: Hero ($25.35 in chips)
Seat 2: eeae3d7 ($7.35 in chips)
Seat 3: a0feaaaf ($24.89 in chips)
Seat 4: dc09684b ($25 in chips)
Seat 5: ba032eea ($63.16 in chips)
Seat 6: b00dbb18 ($25 in chips)
eeae3d7: posts small blind $0.1
a0feaaaf: posts big blind $0.25
*** HOLE CARDS ***
Dealt to Hero [Td 7c]
Dealt to eeae3d7 
Dealt to a0feaaaf 
Dealt to dc09684b 
Dealt to ba032eea 
Dealt to b00dbb18 
dc09684b: folds
ba032eea: raises $0.38 to $0.63
b00dbb18: calls $0.63
Hero: folds
eeae3d7: folds
a0feaaaf: folds
*** FLOP *** [Ad 8d 5d]
ba032eea: checks
b00dbb18: bets $1.3
ba032eea: folds
Uncalled bet ($1.3) returned to b00dbb18
*** SHOWDOWN ***
b00dbb18 collected $1.61 from pot
*** SUMMARY ***
Total pot $1.61
Board [Ad 8d 5d]
Seat 1: Hero (button) folded before Flop (didn't bet)
Seat 2: eeae3d7 (small blind) folded before Flop
Seat 3: a0feaaaf (big blind) folded before Flop
Seat 4: dc09684b folded before Flop (didn't bet)
Seat 5: ba032eea folded on the Flop
Seat 6: b00dbb18 won ($1.61)


Poker Hand #RC94789132: Hold'em No Limit ($0.1/$0.25) - 2020/04/06 23:13:37
Table 'RushAndCash318503' 6-max Seat #1 is the button
Seat 1: d43f12c1 ($12.5 in chips)
Seat 2: cce649b7 ($28.63 in chips)
Seat 3: dc09684b ($25 in chips)
Seat 4: 17480666 ($104.61 in chips)
Seat 5: Hero ($25.35 in chips)
Seat 6: 7357eb2f ($31.96 in chips)
cce649b7: posts small blind $0.1
dc09684b: posts big blind $0.25
*** HOLE CARDS ***
Dealt to d43f12c1 
Dealt to cce649b7 
Dealt to dc09684b 
Dealt to 17480666 
Dealt to Hero [Js 6d]
Dealt to 7357eb2f 
17480666: folds
Hero: folds
7357eb2f: folds
d43f12c1: folds
cce649b7: raises $0.5 to $0.75
dc09684b: folds
Uncalled bet ($0.5) returned to cce649b7
*** SHOWDOWN ***
cce649b7 collected $0.5 from pot
*** SUMMARY ***
Total pot $0.5
Seat 1: d43f12c1 (button) folded before Flop (didn't bet)
Seat 2: cce649b7 (small blind) collected ($0.5)
Seat 3: dc09684b (big blind) folded before Flop
Seat 4: 17480666 folded before Flop (didn't bet)
Seat 5: Hero folded before Flop (didn't bet)
Seat 6: 7357eb2f folded before Flop (didn't bet)


Poker Hand #RC94789152: Hold'em No Limit ($0.1/$0.25) - 2020/04/06 23:13:41
Table 'RushAndCash318506' 6-max Seat #1 is the button
Seat 1: 38359122 ($12.5 in chips)
Seat 2: dfcfe0b3 ($26.39 in chips)
Seat 3: 17480666 ($104.61 in chips)
Seat 4: 2258ad9f ($54.48 in chips)
Seat 5: Hero ($25.35 in chips)
Seat 6: 8b344141 ($11.65 in chips)
dfcfe0b3: posts small blind $0.1
17480666: posts big blind $0.25
*** HOLE CARDS ***
Dealt to 38359122 
Dealt to dfcfe0b3 
Dealt to 17480666 
Dealt to 2258ad9f 
Dealt to Hero [Jh Jc]
Dealt to 8b344141 
2258ad9f: folds
Hero: raises $0.38 to $0.63
8b344141: folds
38359122: folds
dfcfe0b3: folds
17480666: folds
Uncalled bet ($0.38) returned to Hero
*** SHOWDOWN ***
Hero collected $0.6 from pot
*** SUMMARY ***
Total pot $0.6
Seat 1: 38359122 (button) folded before Flop (didn't bet)
Seat 2: dfcfe0b3 (small blind) folded before Flop
Seat 3: 17480666 (big blind) folded before Flop
Seat 4: 2258ad9f folded before Flop (didn't bet)
Seat 5: Hero collected ($0.6)
Seat 6: 8b344141 folded before Flop (didn't bet)


Poker Hand #RC94789246: Hold'em No Limit ($0.1/$0.25) - 2020/04/06 23:14:00
Table 'RushAndCash318520' 6-max Seat #1 is the button
Seat 1: fa7b67d4 ($12.5 in chips)
Seat 2: Hero ($25.7 in chips)
Seat 3: bc19997 ($25.51 in chips)
Seat 4: bd6eeaf3 ($44.3 in chips)
Seat 5: 9d598a03 ($49.6 in chips)
Seat 6: d13258d2 ($16.14 in chips)
Hero: posts small blind $0.1
bc19997: posts big blind $0.25
*** HOLE CARDS ***
Dealt to fa7b67d4 
Dealt to Hero [Ks 8d]
Dealt to bc19997 
Dealt to bd6eeaf3 
Dealt to 9d598a03 
Dealt to d13258d2 
bd6eeaf3: folds
9d598a03: folds
d13258d2: raises $0.38 to $0.63
fa7b67d4: folds
Hero: folds
bc19997: calls $0.38
*** FLOP *** [Jc 5d Jh]
bc19997: checks
d13258d2: bets $0.5
bc19997: folds
Uncalled bet ($0.5) returned to d13258d2
*** SHOWDOWN ***
d13258d2 collected $1.36 from pot
*** SUMMARY ***
Total pot $1.36
Board [Jc 5d Jh]
Seat 1: fa7b67d4 (button) folded before Flop (didn't bet)
Seat 2: Hero (small blind) folded before Flop
Seat 3: bc19997 (big blind) folded on the Flop
Seat 4: bd6eeaf3 folded before Flop (didn't bet)
Seat 5: 9d598a03 folded before Flop (didn't bet)
Seat 6: d13258d2 won ($1.36)


Poker Hand #RC94789279: Hold'em No Limit ($0.1/$0.25) - 2020/04/06 23:14:05
Table 'RushAndCash318525' 6-max Seat #1 is the button
Seat 1: f229719b ($10.3 in chips)
Seat 2: 36ac4586 ($31.17 in chips)
Seat 3: Hero ($25.6 in chips)
Seat 4: 8a31aea7 ($54.92 in chips)
Seat 5: fa7b67d4 ($12.5 in chips)
Seat 6: bd6eeaf3 ($44.3 in chips)
36ac4586: posts small blind $0.1
Hero: posts big blind $0.25
*** HOLE CARDS ***
Dealt to f229719b 
Dealt to 36ac4586 
Dealt to Hero [Js 7d]
Dealt to 8a31aea7 
Dealt to fa7b67d4 
Dealt to bd6eeaf3 
8a31aea7: folds
fa7b67d4: raises $0.5 to $0.75
bd6eeaf3: folds
f229719b: folds
36ac4586: folds
Hero: folds
Uncalled bet ($0.5) returned to fa7b67d4
*** SHOWDOWN ***
fa7b67d4 collected $0.6 from pot
*** SUMMARY ***
Total pot $0.6
Seat 1: f229719b (button) folded before Flop (didn't bet)
Seat 2: 36ac4586 (small blind) folded before Flop
Seat 3: Hero (big blind) folded before Flop
Seat 4: 8a31aea7 folded before Flop (didn't bet)
Seat 5: fa7b67d4 collected ($0.6)
Seat 6: bd6eeaf3 folded before Flop (didn't bet)


Poker Hand #RC94789300: Hold'em No Limit ($0.1/$0.25) - 2020/04/06 23:14:09
Table 'RushAndCash318528' 6-max Seat #1 is the button
Seat 1: 8a31aea7 ($54.92 in chips)
Seat 2: 8b344141 ($11.65 in chips)
Seat 3: b215699c ($25.35 in chips)
Seat 4: Hero ($25.35 in chips)
Seat 5: 8ef8832c ($25.32 in chips)
Seat 6: f4e2b370 ($14.93 in chips)
8b344141: posts small blind $0.1
b215699c: posts big blind $0.25
*** HOLE CARDS ***
Dealt to 8a31aea7 
Dealt to 8b344141 
Dealt to b215699c 
Dealt to Hero [Kc 7s]
Dealt to 8ef8832c 
Dealt to f4e2b370 
Hero: folds
8ef8832c: raises $0.38 to $0.63
f4e2b370: folds
8a31aea7: folds
8b344141: folds
b215699c: folds
Uncalled bet ($0.38) returned to 8ef8832c
*** SHOWDOWN ***
8ef8832c collected $0.6 from pot
*** SUMMARY ***
Total pot $0.6
Seat 1: 8a31aea7 (button) folded before Flop (didn't bet)
Seat 2: 8b344141 (small blind) folded before Flop
Seat 3: b215699c (big blind) folded before Flop
Seat 4: Hero folded before Flop (didn't bet)
Seat 5: 8ef8832c collected ($0.6)
Seat 6: f4e2b370 folded before Flop (didn't bet)


Poker Hand #RC94789315: Hold'em No Limit ($0.1/$0.25) - 2020/04/06 23:14:12
Table 'RushAndCash318530' 6-max Seat #1 is the button
Seat 1: Hero ($25.35 in chips)
Seat 2: 55ad449b ($15.46 in chips)
Seat 3: ba032eea ($62.53 in chips)
Seat 4: c9cb3e58 ($94.92 in chips)
Seat 5: fd369e31 ($52.27 in chips)
Seat 6: 6b202021 ($10.01 in chips)
55ad449b: posts small blind $0.1
ba032eea: posts big blind $0.25
*** HOLE CARDS ***
Dealt to Hero [Qc 9c]
Dealt to 55ad449b 
Dealt to ba032eea 
Dealt to c9cb3e58 
Dealt to fd369e31 
Dealt to 6b202021 
c9cb3e58: folds
fd369e31: folds
6b202021: folds
Hero: raises $0.38 to $0.63
55ad449b: calls $0.53
ba032eea: calls $0.38
*** FLOP *** [3s Ks 8d]
55ad449b: checks
ba032eea: checks
Hero: checks
*** TURN *** [3s Ks 8d] [3d]
55ad449b: bets $2.2
ba032eea: folds
Hero: folds
Uncalled bet ($2.2) returned to 55ad449b
*** SHOWDOWN ***
55ad449b collected $1.89 from pot
*** SUMMARY ***
Total pot $1.89
Board [3s Ks 8d 3d]
Seat 1: Hero (button) folded on the Turn
Seat 2: 55ad449b (small blind) won ($1.89)
Seat 3: ba032eea (big blind) folded on the Turn
Seat 4: c9cb3e58 folded before Flop (didn't bet)
Seat 5: fd369e31 folded before Flop (didn't bet)
Seat 6: 6b202021 folded before Flop (didn't bet)


Poker Hand #RC94789539: Hold'em No Limit ($0.1/$0.25) - 2020/04/06 23:14:54
Table 'RushAndCash318555' 6-max Seat #1 is the button
Seat 1: 38359122 ($12.5 in chips)
Seat 2: 928a94bb ($25 in chips)
Seat 3: Hero ($25 in chips)
Seat 4: f99bdf7f ($20.05 in chips)
Seat 5: e0680a48 ($46.62 in chips)
Seat 6: 36ac4586 ($30.82 in chips)
928a94bb: posts small blind $0.1
Hero: posts big blind $0.25
*** HOLE CARDS ***
Dealt to 38359122 
Dealt to 928a94bb 
Dealt to Hero [Ah 6d]
Dealt to f99bdf7f 
Dealt to e0680a48 
Dealt to 36ac4586 
f99bdf7f: calls $0.25
e0680a48: raises $0.65 to $0.9
36ac4586: folds
38359122: folds
928a94bb: folds
Hero: folds
f99bdf7f: folds
Uncalled bet ($0.65) returned to e0680a48
*** SHOWDOWN ***
e0680a48 collected $0.85 from pot
*** SUMMARY ***
Total pot $0.85
Seat 1: 38359122 (button) folded before Flop (didn't bet)
Seat 2: 928a94bb (small blind) folded before Flop
Seat 3: Hero (big blind) folded before Flop
Seat 4: f99bdf7f folded before Flop
Seat 5: e0680a48 collected ($0.85)
Seat 6: 36ac4586 folded before Flop (didn't bet)


Poker Hand #RC94789571: Hold'em No Limit ($0.1/$0.25) - 2020/04/06 23:15:00
Table 'RushAndCash318560' 6-max Seat #1 is the button
Seat 1: eb5021b0 ($49.93 in chips)
Seat 2: afc178f9 ($29.67 in chips)
Seat 3: b9bbf733 ($34.09 in chips)
Seat 4: d13258d2 ($16.81 in chips)
Seat 5: fd369e31 ($51.14 in chips)
Seat 6: Hero ($25 in chips)
afc178f9: posts small blind $0.1
b9bbf733: posts big blind $0.25
*** HOLE CARDS ***
Dealt to eb5021b0 
Dealt to afc178f9 
Dealt to b9bbf733 
Dealt to d13258d2 
Dealt to fd369e31 
Dealt to Hero [Th 7h]
d13258d2: folds
fd369e31: folds
Hero: folds
eb5021b0: raises $0.5 to $0.75
afc178f9: folds
b9bbf733: calls $0.5
*** FLOP *** [Jh 8c Ac]
b9bbf733: checks
eb5021b0: checks
*** TURN *** [Jh 8c Ac] [Ks]
b9bbf733: bets $1.25
eb5021b0: folds
Uncalled bet ($1.25) returned to b9bbf733
*** SHOWDOWN ***
b9bbf733 collected $1.6 from pot
*** SUMMARY ***
Total pot $1.6
Board [Jh 8c Ac Ks]
Seat 1: eb5021b0 (button) folded on the Turn
Seat 2: afc178f9 (small blind) folded before Flop
Seat 3: b9bbf733 (big blind) won ($1.6)
Seat 4: d13258d2 folded before Flop (didn't bet)
Seat 5: fd369e31 folded before Flop (didn't bet)
Seat 6: Hero folded before Flop (didn't bet)


Poker Hand #RC94789605: Hold'em No Limit ($0.1/$0.25) - 2020/04/06 23:15:07
Table 'RushAndCash318567' 6-max Seat #1 is the button
Seat 1: b215699c ($25 in chips)
Seat 2: Hero ($25 in chips)
Seat 3: afa5143c ($27.39 in chips)
Seat 4: cce649b7 ($27.62 in chips)
Seat 5: 5e03da34 ($43.22 in chips)
Seat 6: ca69da65 ($39.94 in chips)
Hero: posts small blind $0.1
afa5143c: posts big blind $0.25
*** HOLE CARDS ***
Dealt to b215699c 
Dealt to Hero [Ad Th]
Dealt to afa5143c 
Dealt to cce649b7 
Dealt to 5e03da34 
Dealt to ca69da65 
cce649b7: folds
5e03da34: folds
ca69da65: folds
b215699c: folds
Hero: raises $0.5 to $0.75
afa5143c: calls $0.5
*** FLOP *** [Kd 7h Ts]
Hero: checks
afa5143c: bets $0.5
Hero: calls $0.5
*** TURN *** [Kd 7h Ts] [5c]
Hero: checks
afa5143c: bets $2.12
Hero: folds
Uncalled bet ($2.12) returned to afa5143c
*** SHOWDOWN ***
afa5143c collected $2.5 from pot
*** SUMMARY ***
Total pot $2.5
Board [Kd 7h Ts 5c]
Seat 1: b215699c (button) folded before Flop (didn't bet)
Seat 2: Hero (small blind) folded on the Turn
Seat 3: afa5143c (big blind) won ($2.5)
Seat 4: cce649b7 folded before Flop (didn't bet)
Seat 5: 5e03da34 folded before Flop (didn't bet)
Seat 6: ca69da65 folded before Flop (didn't bet)


Poker Hand #RC94789884: Hold'em No Limit ($0.1/$0.25) - 2020/04/06 23:16:04
Table 'RushAndCash318612' 6-max Seat #1 is the button
Seat 1: afa5143c ($28.52 in chips)
Seat 2: d7bbc6af ($25.89 in chips)
Seat 3: fa7b67d4 ($13.06 in chips)
Seat 4: ab0e58dd ($25.6 in chips)
Seat 5: Hero ($25 in chips)
Seat 6: b77c4f4a ($4.95 in chips)
d7bbc6af: posts small blind $0.1
fa7b67d4: posts big blind $0.25
*** HOLE CARDS ***
Dealt to afa5143c 
Dealt to d7bbc6af 
Dealt to fa7b67d4 
Dealt to ab0e58dd 
Dealt to Hero [Kh 7s]
Dealt to b77c4f4a 
ab0e58dd: folds
Hero: folds
b77c4f4a: folds
afa5143c: raises $0.38 to $0.63
d7bbc6af: raises $1.17 to $1.8
fa7b67d4: folds
afa5143c: folds
Uncalled bet ($1.17) returned to d7bbc6af
*** SHOWDOWN ***
d7bbc6af collected $1.51 from pot
*** SUMMARY ***
Total pot $1.51
Seat 1: afa5143c (button) folded before Flop
Seat 2: d7bbc6af (small blind) collected ($1.51)
Seat 3: fa7b67d4 (big blind) folded before Flop
Seat 4: ab0e58dd folded before Flop (didn't bet)
Seat 5: Hero folded before Flop (didn't bet)
Seat 6: b77c4f4a folded before Flop (didn't bet)


Poker Hand #RC94789904: Hold'em No Limit ($0.1/$0.25) - 2020/04/06 23:16:07
Table 'RushAndCash318615' 6-max Seat #1 is the button
Seat 1: e0680a48 ($46.18 in chips)
Seat 2: 92c8c82d ($27.96 in chips)
Seat 3: 2b4254fb ($69.02 in chips)
Seat 4: Hero ($25 in chips)
Seat 5: 36ac4586 ($30.47 in chips)
Seat 6: 8ef8832c ($25.23 in chips)
92c8c82d: posts small blind $0.1
2b4254fb: posts big blind $0.25
*** HOLE CARDS ***
Dealt to e0680a48 
Dealt to 92c8c82d 
Dealt to 2b4254fb 
Dealt to Hero [9h 7d]
Dealt to 36ac4586 
Dealt to 8ef8832c 
Hero: folds
36ac4586: folds
8ef8832c: folds
e0680a48: raises $0.5 to $0.75
92c8c82d: folds
2b4254fb: calls $0.5
*** FLOP *** [Qd Jd 4h]
2b4254fb: checks
e0680a48: checks
*** TURN *** [Qd Jd 4h] [6d]
2b4254fb: checks
e0680a48: checks
*** RIVER *** [Qd Jd 4h 6d] [Kc]
2b4254fb: checks
e0680a48: bets $1.6
2b4254fb: folds
Uncalled bet ($1.6) returned to e0680a48
*** SHOWDOWN ***
e0680a48 collected $1.6 from pot
*** SUMMARY ***
Total pot $1.6
Board [Qd Jd 4h 6d Kc]
Seat 1: e0680a48 (button) won ($1.6)
Seat 2: 92c8c82d (small blind) folded before Flop
Seat 3: 2b4254fb (big blind) folded on the River
Seat 4: Hero folded before Flop (didn't bet)
Seat 5: 36ac4586 folded before Flop (didn't bet)
Seat 6: 8ef8832c folded before Flop (didn't bet)


Poker Hand #RC94789937: Hold'em No Limit ($0.1/$0.25) - 2020/04/06 23:16:13
Table 'RushAndCash318619' 6-max Seat #1 is the button
Seat 1: Hero ($25 in chips)
Seat 2: 9876d8db ($104.83 in chips)
Seat 3: 7bb17d1 ($9.72 in chips)
Seat 4: 93b71bcb ($43.83 in chips)
Seat 5: b77c4f4a ($4.95 in chips)
Seat 6: 8ef8832c ($25.23 in chips)
9876d8db: posts small blind $0.1
7bb17d1: posts big blind $0.25
*** HOLE CARDS ***
Dealt to Hero [5d 2s]
Dealt to 9876d8db 
Dealt to 7bb17d1 
Dealt to 93b71bcb 
Dealt to b77c4f4a 
Dealt to 8ef8832c 
93b71bcb: folds
b77c4f4a: folds
8ef8832c: folds
Hero: folds
9876d8db: folds
Uncalled bet ($0.15) returned to 7bb17d1
*** SHOWDOWN ***
7bb17d1 collected $0.2 from pot
*** SUMMARY ***
Total pot $0.2
Seat 1: Hero (button) folded before Flop (didn't bet)
Seat 2: 9876d8db (small blind) folded before Flop
Seat 3: 7bb17d1 (big blind) collected ($0.2)
Seat 4: 93b71bcb folded before Flop (didn't bet)
Seat 5: b77c4f4a folded before Flop (didn't bet)
Seat 6: 8ef8832c folded before Flop (didn't bet)


Poker Hand #RC94789953: Hold'em No Limit ($0.1/$0.25) - 2020/04/06 23:16:17
Table 'RushAndCash318622' 6-max Seat #1 is the button
Seat 1: 928a94bb ($27.46 in chips)
Seat 2: 8cda51b0 ($86.47 in chips)
Seat 3: Hero ($25 in chips)
Seat 4: 9876d8db ($104.73 in chips)
Seat 5: 41ab7510 ($26.81 in chips)
Seat 6: 5e03da34 ($42.97 in chips)
8cda51b0: posts small blind $0.1
Hero: posts big blind $0.25
*** HOLE CARDS ***
Dealt to 928a94bb 
Dealt to 8cda51b0 
Dealt to Hero [Ad 7h]
Dealt to 9876d8db 
Dealt to 41ab7510 
Dealt to 5e03da34 
9876d8db: folds
41ab7510: folds
5e03da34: folds
928a94bb: folds
8cda51b0: folds
Uncalled bet ($0.15) returned to Hero
*** SHOWDOWN ***
Hero collected $0.2 from pot
*** SUMMARY ***
Total pot $0.2
Seat 1: 928a94bb (button) folded before Flop (didn't bet)
Seat 2: 8cda51b0 (small blind) folded before Flop
Seat 3: Hero (big blind) collected ($0.2)
Seat 4: 9876d8db folded before Flop (didn't bet)
Seat 5: 41ab7510 folded before Flop (didn't bet)
Seat 6: 5e03da34 folded before Flop (didn't bet)


Poker Hand #RC94789986: Hold'em No Limit ($0.1/$0.25) - 2020/04/06 23:16:23
Table 'RushAndCash318627' 6-max Seat #1 is the button
Seat 1: 8ef8832c ($25.23 in chips)
Seat 2: Hero ($25 in chips)
Seat 3: dfab8c76 ($31.67 in chips)
Seat 4: 8b344141 ($6.62 in chips)
Seat 5: 93b71bcb ($43.83 in chips)
Seat 6: afc178f9 ($29.24 in chips)
Hero: posts small blind $0.1
dfab8c76: posts big blind $0.25
*** HOLE CARDS ***
Dealt to 8ef8832c 
Dealt to Hero [Ts 2h]
Dealt to dfab8c76 
Dealt to 8b344141 
Dealt to 93b71bcb 
Dealt to afc178f9 
8b344141: raises $0.38 to $0.63
93b71bcb: folds
afc178f9: calls $0.63
8ef8832c: folds
Hero: folds
dfab8c76: folds
*** FLOP *** [2d Ah Td]
8b344141: bets $1.3
afc178f9: folds
Uncalled bet ($1.3) returned to 8b344141
*** SHOWDOWN ***
8b344141 collected $1.61 from pot
*** SUMMARY ***
Total pot $1.61
Board [2d Ah Td]
Seat 1: 8ef8832c (button) folded before Flop (didn't bet)
Seat 2: Hero (small blind) folded before Flop
Seat 3: dfab8c76 (big blind) folded before Flop
Seat 4: 8b344141 won ($1.61)
Seat 5: 93b71bcb folded before Flop (didn't bet)
Seat 6: afc178f9 folded on the Flop


Poker Hand #RC94790012: Hold'em No Limit ($0.1/$0.25) - 2020/04/06 23:16:28
Table 'RushAndCash318631' 6-max Seat #1 is the button
Seat 1: f8b1513e ($25 in chips)
Seat 2: e44fce1a ($21.66 in chips)
Seat 3: 8fb93df3 ($34.82 in chips)
Seat 4: Hero ($25 in chips)
Seat 5: 93b71bcb ($43.83 in chips)
Seat 6: e58da42d ($26.33 in chips)
e44fce1a: posts small blind $0.1
8fb93df3: posts big blind $0.25
*** HOLE CARDS ***
Dealt to f8b1513e 
Dealt to e44fce1a 
Dealt to 8fb93df3 
Dealt to Hero [Ac 7d]
Dealt to 93b71bcb 
Dealt to e58da42d 
Hero: folds
93b71bcb: folds
e58da42d: folds
f8b1513e: raises $0.5 to $0.75
e44fce1a: folds
8fb93df3: folds
Uncalled bet ($0.5) returned to f8b1513e
*** SHOWDOWN ***
f8b1513e collected $0.6 from pot
*** SUMMARY ***
Total pot $0.6
Seat 1: f8b1513e (button) collected ($0.6)
Seat 2: e44fce1a (small blind) folded before Flop
Seat 3: 8fb93df3 (big blind) folded before Flop
Seat 4: Hero folded before Flop (didn't bet)
Seat 5: 93b71bcb folded before Flop (didn't bet)
Seat 6: e58da42d folded before Flop (didn't bet)


Poker Hand #RC94790030: Hold'em No Limit ($0.1/$0.25) - 2020/04/06 23:16:31
Table 'RushAndCash318634' 6-max Seat #1 is the button
Seat 1: 5e03da34 ($42.97 in chips)
Seat 2: d7f99a39 ($7.12 in chips)
Seat 3: 8cda51b0 ($86.37 in chips)
Seat 4: Hero ($25 in chips)
Seat 5: d8a224aa ($32.47 in chips)
Seat 6: 93b71bcb ($43.83 in chips)
d7f99a39: posts small blind $0.1
8cda51b0: posts big blind $0.25
*** HOLE CARDS ***
Dealt to 5e03da34 
Dealt to d7f99a39 
Dealt to 8cda51b0 
Dealt to Hero [Ac 3c]
Dealt to d8a224aa 
Dealt to 93b71bcb 
Hero: raises $0.38 to $0.63
d8a224aa: folds
93b71bcb: folds
5e03da34: folds
d7f99a39: folds
8cda51b0: calls $0.38
*** FLOP *** [2h Jd Qh]
8cda51b0: checks
Hero: checks
*** TURN *** [2h Jd Qh] [4c]
8cda51b0: bets $0.7
Hero: calls $0.7
*** RIVER *** [2h Jd Qh 4c] [2c]
8cda51b0: checks
Hero: checks
8cda51b0: shows [Th 5h] (Pair of Twos)
Hero: shows [3c Ac] (Pair of Twos)
*** SHOWDOWN ***
Hero collected $2.76 from pot
*** SUMMARY ***
Total pot $2.76
Board [2h Jd Qh 4c 2c]
Seat 1: 5e03da34 (button) folded before Flop (didn't bet)
Seat 2: d7f99a39 (small blind) folded before Flop
Seat 3: 8cda51b0 (big blind) showed [Th 5h] and lost with Pair of Twos
Seat 4: Hero showed [Ac 3c] and won ($2.76) with Pair of Twos
Seat 5: d8a224aa folded before Flop (didn't bet)
Seat 6: 93b71bcb folded before Flop (didn't bet)


Poker Hand #RC94790311: Hold'em No Limit ($0.1/$0.25) - 2020/04/06 23:17:28
Table 'RushAndCash318674' 6-max Seat #1 is the button
Seat 1: 7cc6a901 ($31.21 in chips)
Seat 2: b00dbb18 ($25 in chips)
Seat 3: Hero ($26.65 in chips)
Seat 4: 36ac4586 ($30.47 in chips)
Seat 5: eeae3d7 ($14.73 in chips)
Seat 6: 8cda51b0 ($85.04 in chips)
b00dbb18: posts small blind $0.1
Hero: posts big blind $0.25
*** HOLE CARDS ***
Dealt to 7cc6a901 
Dealt to b00dbb18 
Dealt to Hero [7c 3c]
Dealt to 36ac4586 
Dealt to eeae3d7 
Dealt to 8cda51b0 
36ac4586: raises $0.38 to $0.63
eeae3d7: folds
8cda51b0: folds
7cc6a901: folds
b00dbb18: folds
Hero: folds
Uncalled bet ($0.38) returned to 36ac4586
*** SHOWDOWN ***
36ac4586 collected $0.6 from pot
*** SUMMARY ***
Total pot $0.6
Seat 1: 7cc6a901 (button) folded before Flop (didn't bet)
Seat 2: b00dbb18 (small blind) folded before Flop
Seat 3: Hero (big blind) folded before Flop
Seat 4: 36ac4586 collected ($0.6)
Seat 5: eeae3d7 folded before Flop (didn't bet)
Seat 6: 8cda51b0 folded before Flop (didn't bet)


Poker Hand #RC94790332: Hold'em No Limit ($0.1/$0.25) - 2020/04/06 23:17:33
Table 'RushAndCash318677' 6-max Seat #1 is the button
Seat 1: Hero ($26.4 in chips)
Seat 2: fa7b67d4 ($12.81 in chips)
Seat 3: bd6eeaf3 ($48.62 in chips)
Seat 4: d8a224aa ($32.47 in chips)
Seat 5: eeae3d7 ($14.73 in chips)
Seat 6: 8cda51b0 ($85.04 in chips)
fa7b67d4: posts small blind $0.1
bd6eeaf3: posts big blind $0.25
*** HOLE CARDS ***
Dealt to Hero [Js 7s]
Dealt to fa7b67d4 
Dealt to bd6eeaf3 
Dealt to d8a224aa 
Dealt to eeae3d7 
Dealt to 8cda51b0 
d8a224aa: folds
eeae3d7: folds
8cda51b0: folds
Hero: folds
fa7b67d4: raises $0.25 to $0.5
bd6eeaf3: folds
Uncalled bet ($0.25) returned to fa7b67d4
*** SHOWDOWN ***
fa7b67d4 collected $0.5 from pot
*** SUMMARY ***
Total pot $0.5
Seat 1: Hero (button) folded before Flop (didn't bet)
Seat 2: fa7b67d4 (small blind) collected ($0.5)
Seat 3: bd6eeaf3 (big blind) folded before Flop
Seat 4: d8a224aa folded before Flop (didn't bet)
Seat 5: eeae3d7 folded before Flop (didn't bet)
Seat 6: 8cda51b0 folded before Flop (didn't bet)


Poker Hand #RC94790356: Hold'em No Limit ($0.1/$0.25) - 2020/04/06 23:17:38
Table 'RushAndCash318681' 6-max Seat #1 is the button
Seat 1: 9c511c89 ($12.85 in chips)
Seat 2: Hero ($26.4 in chips)
Seat 3: d8a224aa ($32.47 in chips)
Seat 4: 7cc6a901 ($31.21 in chips)
Seat 5: 2904eaa2 ($28.68 in chips)
Seat 6: 7bb17d1 ($12.46 in chips)
Hero: posts small blind $0.1
d8a224aa: posts big blind $0.25
*** HOLE CARDS ***
Dealt to 9c511c89 
Dealt to Hero [4c 3h]
Dealt to d8a224aa 
Dealt to 7cc6a901 
Dealt to 2904eaa2 
Dealt to 7bb17d1 
7cc6a901: folds
2904eaa2: folds
7bb17d1: folds
9c511c89: raises $0.25 to $0.5
Hero: folds
d8a224aa: folds
Uncalled bet ($0.25) returned to 9c511c89
*** SHOWDOWN ***
9c511c89 collected $0.6 from pot
*** SUMMARY ***
Total pot $0.6
Seat 1: 9c511c89 (button) collected ($0.6)
Seat 2: Hero (small blind) folded before Flop
Seat 3: d8a224aa (big blind) folded before Flop
Seat 4: 7cc6a901 folded before Flop (didn't bet)
Seat 5: 2904eaa2 folded before Flop (didn't bet)
Seat 6: 7bb17d1 folded before Flop (didn't bet)


Poker Hand #RC94790374: Hold'em No Limit ($0.1/$0.25) - 2020/04/06 23:17:41
Table 'RushAndCash318684' 6-max Seat #1 is the button
Seat 1: 2b4254fb ($69.17 in chips)
Seat 2: afa5143c ($27.54 in chips)
Seat 3: ba032eea ($60.92 in chips)
Seat 4: Hero ($26.3 in chips)
Seat 5: 7cc6a901 ($31.21 in chips)
Seat 6: e58da42d ($25.35 in chips)
afa5143c: posts small blind $0.1
ba032eea: posts big blind $0.25
*** HOLE CARDS ***
Dealt to 2b4254fb 
Dealt to afa5143c 
Dealt to ba032eea 
Dealt to Hero [Ts 6c]
Dealt to 7cc6a901 
Dealt to e58da42d 
Hero: folds
7cc6a901: folds
e58da42d: raises $0.38 to $0.63
2b4254fb: raises $1.12 to $1.75
afa5143c: folds
ba032eea: folds
e58da42d: folds
Uncalled bet ($1.12) returned to 2b4254fb
*** SHOWDOWN ***
2b4254fb collected $1.61 from pot
*** SUMMARY ***
Total pot $1.61
Seat 1: 2b4254fb (button) collected ($1.61)
Seat 2: afa5143c (small blind) folded before Flop
Seat 3: ba032eea (big blind) folded before Flop
Seat 4: Hero folded before Flop (didn't bet)
Seat 5: 7cc6a901 folded before Flop (didn't bet)
Seat 6: e58da42d folded before Flop


Poker Hand #RC94790387: Hold'em No Limit ($0.1/$0.25) - 2020/04/06 23:17:44
Table 'RushAndCash318686' 6-max Seat #1 is the button
Seat 1: f99bdf7f ($19.8 in chips)
Seat 2: d7bbc6af ($25.57 in chips)
Seat 3: eeae3d7 ($14.73 in chips)
Seat 4: Hero ($26.3 in chips)
Seat 5: 7532b9bc ($15.38 in chips)
Seat 6: b00dbb18 ($25 in chips)
d7bbc6af: posts small blind $0.1
eeae3d7: posts big blind $0.25
*** HOLE CARDS ***
Dealt to f99bdf7f 
Dealt to d7bbc6af 
Dealt to eeae3d7 
Dealt to Hero [7d 6c]
Dealt to 7532b9bc 
Dealt to b00dbb18 
Hero: folds
7532b9bc: raises $0.5 to $0.75
b00dbb18: calls $0.75
f99bdf7f: folds
d7bbc6af: folds
eeae3d7: folds
*** FLOP *** [5h 9d Kd]
7532b9bc: checks
b00dbb18: bets $1
7532b9bc: folds
Uncalled bet ($1) returned to b00dbb18
*** SHOWDOWN ***
b00dbb18 collected $1.85 from pot
*** SUMMARY ***
Total pot $1.85
Board [5h 9d Kd]
Seat 1: f99bdf7f (button) folded before Flop (didn't bet)
Seat 2: d7bbc6af (small blind) folded before Flop
Seat 3: eeae3d7 (big blind) folded before Flop
Seat 4: Hero folded before Flop (didn't bet)
Seat 5: 7532b9bc folded on the Flop
Seat 6: b00dbb18 won ($1.85)


Poker Hand #RC94790410: Hold'em No Limit ($0.1/$0.25) - 2020/04/06 23:17:48
Table 'RushAndCash318689' 6-max Seat #1 is the button
Seat 1: 5e03da34 ($42.52 in chips)
Seat 2: 2467bb49 ($33.65 in chips)
Seat 3: dfab8c76 ($32.58 in chips)
Seat 4: 7cc6a901 ($31.21 in chips)
Seat 5: f99bdf7f ($19.8 in chips)
Seat 6: Hero ($26.3 in chips)
2467bb49: posts small blind $0.1
dfab8c76: posts big blind $0.25
*** HOLE CARDS ***
Dealt to 5e03da34 
Dealt to 2467bb49 
Dealt to dfab8c76 
Dealt to 7cc6a901 
Dealt to f99bdf7f 
Dealt to Hero [Th Tc]
7cc6a901: raises $0.38 to $0.63
f99bdf7f: folds
Hero: raises $1.49 to $2.12
5e03da34: folds
2467bb49: folds
dfab8c76: folds
7cc6a901: folds
Uncalled bet ($1.49) returned to Hero
*** SHOWDOWN ***
Hero collected $1.61 from pot
*** SUMMARY ***
Total pot $1.61
Seat 1: 5e03da34 (button) folded before Flop (didn't bet)
Seat 2: 2467bb49 (small blind) folded before Flop
Seat 3: dfab8c76 (big blind) folded before Flop
Seat 4: 7cc6a901 folded before Flop
Seat 5: f99bdf7f folded before Flop (didn't bet)
Seat 6: Hero collected ($1.61)


Poker Hand #RC94790546: Hold'em No Limit ($0.1/$0.25) - 2020/04/06 23:18:14
Table 'RushAndCash318710' 6-max Seat #1 is the button
Seat 1: 2258ad9f ($57.02 in chips)
Seat 2: 8b344141 ($7.17 in chips)
Seat 3: 8ef8832c ($25.35 in chips)
Seat 4: Hero ($27.2 in chips)
Seat 5: 9c511c89 ($12.85 in chips)
Seat 6: f8b1513e ($26.61 in chips)
8b344141: posts small blind $0.1
8ef8832c: posts big blind $0.25
*** HOLE CARDS ***
Dealt to 2258ad9f 
Dealt to 8b344141 
Dealt to 8ef8832c 
Dealt to Hero [Ks Qh]
Dealt to 9c511c89 
Dealt to f8b1513e 
Hero: raises $0.38 to $0.63
9c511c89: folds
f8b1513e: folds
2258ad9f: folds
8b344141: folds
8ef8832c: calls $0.38
*** FLOP *** [6h Qs 4s]
8ef8832c: checks
Hero: bets $0.75
8ef8832c: folds
Uncalled bet ($0.75) returned to Hero
*** SHOWDOWN ***
Hero collected $1.36 from pot
*** SUMMARY ***
Total pot $1.36
Board [6h Qs 4s]
Seat 1: 2258ad9f (button) folded before Flop (didn't bet)
Seat 2: 8b344141 (small blind) folded before Flop
Seat 3: 8ef8832c (big blind) folded on the Flop
Seat 4: Hero won ($1.36)
Seat 5: 9c511c89 folded before Flop (didn't bet)
Seat 6: f8b1513e folded before Flop (didn't bet)


Poker Hand #RC94790659: Hold'em No Limit ($0.1/$0.25) - 2020/04/06 23:18:38
Table 'RushAndCash318731' 6-max Seat #1 is the button
Seat 1: cce649b7 ($24.96 in chips)
Seat 2: 8ef8832c ($25 in chips)
Seat 3: dfcfe0b3 ($25.88 in chips)
Seat 4: 7532b9bc ($14.28 in chips)
Seat 5: Hero ($27.87 in chips)
Seat 6: b9bbf733 ($32.66 in chips)
8ef8832c: posts small blind $0.1
dfcfe0b3: posts big blind $0.25
*** HOLE CARDS ***
Dealt to cce649b7 
Dealt to 8ef8832c 
Dealt to dfcfe0b3 
Dealt to 7532b9bc 
Dealt to Hero [6h 3d]
Dealt to b9bbf733 
7532b9bc: raises $0.5 to $0.75
Hero: folds
b9bbf733: folds
cce649b7: folds
8ef8832c: folds
dfcfe0b3: calls $0.5
*** FLOP *** [8c 5h Ts]
dfcfe0b3: checks
7532b9bc: bets $0.8
dfcfe0b3: folds
Uncalled bet ($0.8) returned to 7532b9bc
*** SHOWDOWN ***
7532b9bc collected $1.6 from pot
*** SUMMARY ***
Total pot $1.6
Board [8c 5h Ts]
Seat 1: cce649b7 (button) folded before Flop (didn't bet)
Seat 2: 8ef8832c (small blind) folded before Flop
Seat 3: dfcfe0b3 (big blind) folded on the Flop
Seat 4: 7532b9bc won ($1.6)
Seat 5: Hero folded before Flop (didn't bet)
Seat 6: b9bbf733 folded before Flop (didn't bet)


Poker Hand #RC94790691: Hold'em No Limit ($0.1/$0.25) - 2020/04/06 23:18:44
Table 'RushAndCash318737' 6-max Seat #1 is the button
Seat 1: Hero ($27.87 in chips)
Seat 2: ff501d94 ($12.5 in chips)
Seat 3: ca69da65 ($41.52 in chips)
Seat 4: 17480666 ($102.53 in chips)
Seat 5: eeae3d7 ($14.38 in chips)
Seat 6: c9cb3e58 ($92.07 in chips)
ff501d94: posts small blind $0.1
ca69da65: posts big blind $0.25
*** HOLE CARDS ***
Dealt to Hero [Td 8c]
Dealt to ff501d94 
Dealt to ca69da65 
Dealt to 17480666 
Dealt to eeae3d7 
Dealt to c9cb3e58 
17480666: folds
eeae3d7: folds
c9cb3e58: folds
Hero: folds
ff501d94: folds
Uncalled bet ($0.15) returned to ca69da65
*** SHOWDOWN ***
ca69da65 collected $0.2 from pot
*** SUMMARY ***
Total pot $0.2
Seat 1: Hero (button) folded before Flop (didn't bet)
Seat 2: ff501d94 (small blind) folded before Flop
Seat 3: ca69da65 (big blind) collected ($0.2)
Seat 4: 17480666 folded before Flop (didn't bet)
Seat 5: eeae3d7 folded before Flop (didn't bet)
Seat 6: c9cb3e58 folded before Flop (didn't bet)


Poker Hand #RC94790715: Hold'em No Limit ($0.1/$0.25) - 2020/04/06 23:18:48
Table 'RushAndCash318741' 6-max Seat #1 is the button
Seat 1: ff501d94 ($12.5 in chips)
Seat 2: Hero ($27.87 in chips)
Seat 3: 17480666 ($102.53 in chips)
Seat 4: 7bb17d1 ($12.46 in chips)
Seat 5: 6b202021 ($9.04 in chips)
Seat 6: 9c511c89 ($13.2 in chips)
Hero: posts small blind $0.1
17480666: posts big blind $0.25
*** HOLE CARDS ***
Dealt to ff501d94 
Dealt to Hero [Th 2d]
Dealt to 17480666 
Dealt to 7bb17d1 
Dealt to 6b202021 
Dealt to 9c511c89 
7bb17d1: folds
6b202021: folds
9c511c89: folds
ff501d94: folds
Hero: folds
Uncalled bet ($0.15) returned to 17480666
*** SHOWDOWN ***
17480666 collected $0.2 from pot
*** SUMMARY ***
Total pot $0.2
Seat 1: ff501d94 (button) folded before Flop (didn't bet)
Seat 2: Hero (small blind) folded before Flop
Seat 3: 17480666 (big blind) collected ($0.2)
Seat 4: 7bb17d1 folded before Flop (didn't bet)
Seat 5: 6b202021 folded before Flop (didn't bet)
Seat 6: 9c511c89 folded before Flop (didn't bet)


Poker Hand #RC94790748: Hold'em No Limit ($0.1/$0.25) - 2020/04/06 23:18:54
Table 'RushAndCash318746' 6-max Seat #1 is the button
Seat 1: ca69da65 ($41.62 in chips)
Seat 2: 8f3ae91b ($25 in chips)
Seat 3: Hero ($27.77 in chips)
Seat 4: c9cb3e58 ($92.07 in chips)
Seat 5: e44fce1a ($21.91 in chips)
Seat 6: afc178f9 ($29.89 in chips)
8f3ae91b: posts small blind $0.1
Hero: posts big blind $0.25
*** HOLE CARDS ***
Dealt to ca69da65 
Dealt to 8f3ae91b 
Dealt to Hero [Th 5d]
Dealt to c9cb3e58 
Dealt to e44fce1a 
Dealt to afc178f9 
c9cb3e58: raises $0.5 to $0.75
e44fce1a: folds
afc178f9: folds
ca69da65: folds
8f3ae91b: folds
Hero: folds
Uncalled bet ($0.5) returned to c9cb3e58
*** SHOWDOWN ***
c9cb3e58 collected $0.6 from pot
*** SUMMARY ***
Total pot $0.6
Seat 1: ca69da65 (button) folded before Flop (didn't bet)
Seat 2: 8f3ae91b (small blind) folded before Flop
Seat 3: Hero (big blind) folded before Flop
Seat 4: c9cb3e58 collected ($0.6)
Seat 5: e44fce1a folded before Flop (didn't bet)
Seat 6: afc178f9 folded before Flop (didn't bet)


Poker Hand #RC94790785: Hold'em No Limit ($0.1/$0.25) - 2020/04/06 23:19:01
Table 'RushAndCash318752' 6-max Seat #1 is the button
Seat 1: f83dd98d ($25 in chips)
Seat 2: 17480666 ($102.63 in chips)
Seat 3: 92c8c82d ($26.78 in chips)
Seat 4: 8cda51b0 ($87.81 in chips)
Seat 5: Hero ($27.52 in chips)
Seat 6: 8ef8832c ($25 in chips)
17480666: posts small blind $0.1
92c8c82d: posts big blind $0.25
*** HOLE CARDS ***
Dealt to f83dd98d 
Dealt to 17480666 
Dealt to 92c8c82d 
Dealt to 8cda51b0 
Dealt to Hero [As Tc]
Dealt to 8ef8832c 
8cda51b0: folds
Hero: raises $0.38 to $0.63
8ef8832c: folds
f83dd98d: raises $1.63 to $2.26
17480666: folds
92c8c82d: folds
Hero: folds
Uncalled bet ($1.63) returned to f83dd98d
*** SHOWDOWN ***
f83dd98d collected $1.61 from pot
*** SUMMARY ***
Total pot $1.61
Seat 1: f83dd98d (button) collected ($1.61)
Seat 2: 17480666 (small blind) folded before Flop
Seat 3: 92c8c82d (big blind) folded before Flop
Seat 4: 8cda51b0 folded before Flop (didn't bet)
Seat 5: Hero folded before Flop
Seat 6: 8ef8832c folded before Flop (didn't bet)


Poker Hand #RC94790888: Hold'em No Limit ($0.1/$0.25) - 2020/04/06 23:19:23
Table 'RushAndCash318766' 6-max Seat #1 is the button
Seat 1: 36ac4586 ($25 in chips)
Seat 2: 6b202021 ($9.58 in chips)
Seat 3: ba032eea ($60.32 in chips)
Seat 4: 92c8c82d ($26.53 in chips)
Seat 5: Hero ($26.89 in chips)
Seat 6: b215699c ($38.82 in chips)
6b202021: posts small blind $0.1
ba032eea: posts big blind $0.25
*** HOLE CARDS ***
Dealt to 36ac4586 
Dealt to 6b202021 
Dealt to ba032eea 
Dealt to 92c8c82d 
Dealt to Hero [4s 3s]
Dealt to b215699c 
92c8c82d: folds
Hero: folds
b215699c: raises $0.45 to $0.7
36ac4586: raises $1.5 to $2.2
6b202021: raises $7.38 to $9.58 and is all-in
ba032eea: folds
b215699c: folds
36ac4586: calls $7.38
6b202021: shows [5c 5s]
36ac4586: shows [Ac Ks]
*** FLOP *** [Jd Ad 7c]
*** TURN *** [Jd Ad 7c] [9s]
*** RIVER *** [Jd Ad 7c 9s] [Js]
*** SHOWDOWN ***
36ac4586 collected $20.11 from pot
*** SUMMARY ***
Total pot $20.11
Board [Jd Ad 7c 9s Js]
Seat 1: 36ac4586 (button) showed [Ac Ks] and won ($20.11) with Pair of Aces and Pair of Jacks
Seat 2: 6b202021 (small blind) showed [5s 5c] and lost with Pair of Jacks and Pair of Fives
Seat 3: ba032eea (big blind) folded before Flop
Seat 4: 92c8c82d folded before Flop (didn't bet)
Seat 5: Hero folded before Flop (didn't bet)
Seat 6: b215699c folded before Flop


Poker Hand #RC94790907: Hold'em No Limit ($0.1/$0.25) - 2020/04/06 23:19:27
Table 'RushAndCash318769' 6-max Seat #1 is the button
Seat 1: 5e03da34 ($41.92 in chips)
Seat 2: d13258d2 ($9.72 in chips)
Seat 3: bd6eeaf3 ($47.54 in chips)
Seat 4: 38359122 ($14.26 in chips)
Seat 5: Hero ($26.89 in chips)
Seat 6: 92c8c82d ($26.53 in chips)
d13258d2: posts small blind $0.1
bd6eeaf3: posts big blind $0.25
*** HOLE CARDS ***
Dealt to 5e03da34 
Dealt to d13258d2 
Dealt to bd6eeaf3 
Dealt to 38359122 
Dealt to Hero [Js 5h]
Dealt to 92c8c82d 
38359122: folds
Hero: folds
92c8c82d: folds
5e03da34: raises $0.25 to $0.5
d13258d2: raises $1.5 to $2
bd6eeaf3: folds
5e03da34: folds
Uncalled bet ($1.5) returned to d13258d2
*** SHOWDOWN ***
d13258d2 collected $1.25 from pot
*** SUMMARY ***
Total pot $1.25
Seat 1: 5e03da34 (button) folded before Flop
Seat 2: d13258d2 (small blind) collected ($1.25)
Seat 3: bd6eeaf3 (big blind) folded before Flop
Seat 4: 38359122 folded before Flop (didn't bet)
Seat 5: Hero folded before Flop (didn't bet)
Seat 6: 92c8c82d folded before Flop (didn't bet)


Poker Hand #RC94790924: Hold'em No Limit ($0.1/$0.25) - 2020/04/06 23:19:31
Table 'RushAndCash318772' 6-max Seat #1 is the button
Seat 1: 8b344141 ($7.52 in chips)
Seat 2: f99bdf7f ($19.17 in chips)
Seat 3: Hero ($26.89 in chips)
Seat 4: b9bbf733 ($32.41 in chips)
Seat 5: 8f3ae91b ($25.35 in chips)
Seat 6: bc19997 ($27.17 in chips)
Cash Drop to Pot : total $2.5 
f99bdf7f: posts small blind $0.1
Hero: posts big blind $0.25
*** HOLE CARDS ***
Dealt to 8b344141 
Dealt to f99bdf7f 
Dealt to Hero [7c 5d]
Dealt to b9bbf733 
Dealt to 8f3ae91b 
Dealt to bc19997 
b9bbf733: folds
8f3ae91b: folds
bc19997: folds
8b344141: raises $7.27 to $7.52 and is all-in
f99bdf7f: raises $11.65 to $19.17 and is all-in
Hero: folds
Uncalled bet ($11.65) returned to f99bdf7f
f99bdf7f: shows [Ah 6c]
8b344141: shows [Qs 6s]
*** FLOP *** [Jh Jd 8d]
*** TURN *** [Jh Jd 8d] [Js]
*** RIVER *** [Jh Jd 8d Js] [5c]
*** SHOWDOWN ***
f99bdf7f collected $17.79 from pot
*** SUMMARY ***
Total pot $17.79
Board [Jh Jd 8d Js 5c]
Seat 1: 8b344141 (button) showed [Qs 6s] and lost with Three Jacks
Seat 2: f99bdf7f (small blind) showed [Ah 6c] and won ($17.79) with Three Jacks
Seat 3: Hero (big blind) folded before Flop
Seat 4: b9bbf733 folded before Flop (didn't bet)
Seat 5: 8f3ae91b folded before Flop (didn't bet)
Seat 6: bc19997 folded before Flop (didn't bet)


Poker Hand #RC94790966: Hold'em No Limit ($0.1/$0.25) - 2020/04/06 23:19:40
Table 'RushAndCash318778' 6-max Seat #1 is the button
Seat 1: 92c8c82d ($26.53 in chips)
Seat 2: Hero ($26.64 in chips)
Seat 3: 58b04451 ($61.63 in chips)
Seat 4: eeae3d7 ($14.38 in chips)
Seat 5: f83dd98d ($25.9 in chips)
Seat 6: f8b1513e ($27.18 in chips)
Hero: posts small blind $0.1
58b04451: posts big blind $0.25
*** HOLE CARDS ***
Dealt to 92c8c82d 
Dealt to Hero [9s 5d]
Dealt to 58b04451 
Dealt to eeae3d7 
Dealt to f83dd98d 
Dealt to f8b1513e 
eeae3d7: folds
f83dd98d: raises $0.5 to $0.75
f8b1513e: folds
92c8c82d: folds
Hero: folds
58b04451: folds
Uncalled bet ($0.5) returned to f83dd98d
*** SHOWDOWN ***
f83dd98d collected $0.6 from pot
*** SUMMARY ***
Total pot $0.6
Seat 1: 92c8c82d (button) folded before Flop (didn't bet)
Seat 2: Hero (small blind) folded before Flop
Seat 3: 58b04451 (big blind) folded before Flop
Seat 4: eeae3d7 folded before Flop (didn't bet)
Seat 5: f83dd98d collected ($0.6)
Seat 6: f8b1513e folded before Flop (didn't bet)


Poker Hand #RC94790991: Hold'em No Limit ($0.1/$0.25) - 2020/04/06 23:19:46
Table 'RushAndCash318781' 6-max Seat #1 is the button
Seat 1: d7f99a39 ($6.9 in chips)
Seat 2: f38f7769 ($24.6 in chips)
Seat 3: 38359122 ($14.16 in chips)
Seat 4: 72fa991e ($30.65 in chips)
Seat 5: 41cf19d5 ($68.86 in chips)
Seat 6: Hero ($26.54 in chips)
f38f7769: posts small blind $0.1
38359122: posts big blind $0.25
*** HOLE CARDS ***
Dealt to d7f99a39 
Dealt to f38f7769 
Dealt to 38359122 
Dealt to 72fa991e 
Dealt to 41cf19d5 
Dealt to Hero [8c 4s]
72fa991e: folds
41cf19d5: folds
Hero: folds
d7f99a39: folds
f38f7769: folds
Uncalled bet ($0.15) returned to 38359122
*** SHOWDOWN ***
38359122 collected $0.2 from pot
*** SUMMARY ***
Total pot $0.2
Seat 1: d7f99a39 (button) folded before Flop (didn't bet)
Seat 2: f38f7769 (small blind) folded before Flop
Seat 3: 38359122 (big blind) collected ($0.2)
Seat 4: 72fa991e folded before Flop (didn't bet)
Seat 5: 41cf19d5 folded before Flop (didn't bet)
Seat 6: Hero folded before Flop (didn't bet)


Poker Hand #RC94791007: Hold'em No Limit ($0.1/$0.25) - 2020/04/06 23:19:49
Table 'RushAndCash318783' 6-max Seat #1 is the button
Seat 1: Hero ($26.54 in chips)
Seat 2: 2b4254fb ($69.19 in chips)
Seat 3: 9876d8db ($104.68 in chips)
Seat 4: 2467bb49 ($32.2 in chips)
Seat 5: ab0e58dd ($25.35 in chips)
Seat 6: d7bbc6af ($25.82 in chips)
2b4254fb: posts small blind $0.1
9876d8db: posts big blind $0.25
*** HOLE CARDS ***
Dealt to Hero [Qh 4c]
Dealt to 2b4254fb 
Dealt to 9876d8db 
Dealt to 2467bb49 
Dealt to ab0e58dd 
Dealt to d7bbc6af 
2467bb49: folds
ab0e58dd: folds
d7bbc6af: raises $0.38 to $0.63
Hero: folds
2b4254fb: folds
9876d8db: folds
Uncalled bet ($0.38) returned to d7bbc6af
*** SHOWDOWN ***
d7bbc6af collected $0.6 from pot
*** SUMMARY ***
Total pot $0.6
Seat 1: Hero (button) folded before Flop (didn't bet)
Seat 2: 2b4254fb (small blind) folded before Flop
Seat 3: 9876d8db (big blind) folded before Flop
Seat 4: 2467bb49 folded before Flop (didn't bet)
Seat 5: ab0e58dd folded before Flop (didn't bet)
Seat 6: d7bbc6af collected ($0.6)


Poker Hand #RC94791029: Hold'em No Limit ($0.1/$0.25) - 2020/04/06 23:19:54
Table 'RushAndCash318787' 6-max Seat #1 is the button
Seat 1: 2467bb49 ($32.2 in chips)
Seat 2: 1b4ad4ae ($27.29 in chips)
Seat 3: dc09684b ($25 in chips)
Seat 4: Hero ($26.54 in chips)
Seat 5: 2b4254fb ($69.09 in chips)
Seat 6: d7f99a39 ($6.9 in chips)
1b4ad4ae: posts small blind $0.1
dc09684b: posts big blind $0.25
*** HOLE CARDS ***
Dealt to 2467bb49 
Dealt to 1b4ad4ae 
Dealt to dc09684b 
Dealt to Hero [Qd Ts]
Dealt to 2b4254fb 
Dealt to d7f99a39 
Hero: folds
2b4254fb: folds
d7f99a39: folds
2467bb49: folds
1b4ad4ae: raises $0.5 to $0.75
dc09684b: folds
Uncalled bet ($0.5) returned to 1b4ad4ae
*** SHOWDOWN ***
1b4ad4ae collected $0.5 from pot
*** SUMMARY ***
Total pot $0.5
Seat 1: 2467bb49 (button) folded before Flop (didn't bet)
Seat 2: 1b4ad4ae (small blind) collected ($0.5)
Seat 3: dc09684b (big blind) folded before Flop
Seat 4: Hero folded before Flop (didn't bet)
Seat 5: 2b4254fb folded before Flop (didn't bet)
Seat 6: d7f99a39 folded before Flop (didn't bet)


Poker Hand #RC94791048: Hold'em No Limit ($0.1/$0.25) - 2020/04/06 23:19:57
Table 'RushAndCash318790' 6-max Seat #1 is the button
Seat 1: afa5143c ($27.96 in chips)
Seat 2: 2904eaa2 ($27.2 in chips)
Seat 3: ab0e58dd ($25.35 in chips)
Seat 4: bc19997 ($27.17 in chips)
Seat 5: 9876d8db ($104.43 in chips)
Seat 6: Hero ($26.54 in chips)
2904eaa2: posts small blind $0.1
ab0e58dd: posts big blind $0.25
*** HOLE CARDS ***
Dealt to afa5143c 
Dealt to 2904eaa2 
Dealt to ab0e58dd 
Dealt to bc19997 
Dealt to 9876d8db 
Dealt to Hero [Kd 3h]
bc19997: folds
9876d8db: folds
Hero: folds
afa5143c: folds
2904eaa2: folds
Uncalled bet ($0.15) returned to ab0e58dd
*** SHOWDOWN ***
ab0e58dd collected $0.2 from pot
*** SUMMARY ***
Total pot $0.2
Seat 1: afa5143c (button) folded before Flop (didn't bet)
Seat 2: 2904eaa2 (small blind) folded before Flop
Seat 3: ab0e58dd (big blind) collected ($0.2)
Seat 4: bc19997 folded before Flop (didn't bet)
Seat 5: 9876d8db folded before Flop (didn't bet)
Seat 6: Hero folded before Flop (didn't bet)


Poker Hand #RC94791073: Hold'em No Limit ($0.1/$0.25) - 2020/04/06 23:20:02
Table 'RushAndCash318793' 6-max Seat #1 is the button
Seat 1: 2b4254fb ($68.84 in chips)
Seat 2: Hero ($26.54 in chips)
Seat 3: bd6eeaf3 ($47.19 in chips)
Seat 4: afa5143c ($27.96 in chips)
Seat 5: d7f99a39 ($6.9 in chips)
Seat 6: fd369e31 ($53.42 in chips)
Hero: posts small blind $0.1
bd6eeaf3: posts big blind $0.25
*** HOLE CARDS ***
Dealt to 2b4254fb 
Dealt to Hero [Ad Kd]
Dealt to bd6eeaf3 
Dealt to afa5143c 
Dealt to d7f99a39 
Dealt to fd369e31 
afa5143c: folds
d7f99a39: folds
fd369e31: folds
2b4254fb: folds
Hero: raises $0.5 to $0.75
bd6eeaf3: calls $0.5
*** FLOP *** [3h Js 9h]
Hero: bets $0.82
bd6eeaf3: folds
Uncalled bet ($0.82) returned to Hero
*** SHOWDOWN ***
Hero collected $1.5 from pot
*** SUMMARY ***
Total pot $1.5
Board [3h Js 9h]
Seat 1: 2b4254fb (button) folded before Flop (didn't bet)
Seat 2: Hero (small blind) won ($1.5)
Seat 3: bd6eeaf3 (big blind) folded on the Flop
Seat 4: afa5143c folded before Flop (didn't bet)
Seat 5: d7f99a39 folded before Flop (didn't bet)
Seat 6: fd369e31 folded before Flop (didn't bet)


Poker Hand #RC94791211: Hold'em No Limit ($0.1/$0.25) - 2020/04/06 23:20:32
Table 'RushAndCash318815' 6-max Seat #1 is the button
Seat 1: e64b2cd5 ($12.92 in chips)
Seat 2: dfcfe0b3 ($25.03 in chips)
Seat 3: 7bb17d1 ($9.93 in chips)
Seat 4: Hero ($27.22 in chips)
Seat 5: b215699c ($38.12 in chips)
Seat 6: 2467bb49 ($32.1 in chips)
dfcfe0b3: posts small blind $0.1
7bb17d1: posts big blind $0.25
*** HOLE CARDS ***
Dealt to e64b2cd5 
Dealt to dfcfe0b3 
Dealt to 7bb17d1 
Dealt to Hero [8s 7d]
Dealt to b215699c 
Dealt to 2467bb49 
Hero: folds
b215699c: folds
2467bb49: raises $0.38 to $0.63
e64b2cd5: calls $0.63
dfcfe0b3: folds
7bb17d1: calls $0.38
*** FLOP *** [6d Ah Qd]
7bb17d1: checks
2467bb49: bets $1.5
e64b2cd5: folds
7bb17d1: folds
Uncalled bet ($1.5) returned to 2467bb49
*** SHOWDOWN ***
2467bb49 collected $1.99 from pot
*** SUMMARY ***
Total pot $1.99
Board [6d Ah Qd]
Seat 1: e64b2cd5 (button) folded on the Flop
Seat 2: dfcfe0b3 (small blind) folded before Flop
Seat 3: 7bb17d1 (big blind) folded on the Flop
Seat 4: Hero folded before Flop (didn't bet)
Seat 5: b215699c folded before Flop (didn't bet)
Seat 6: 2467bb49 won ($1.99)


Poker Hand #RC94791239: Hold'em No Limit ($0.1/$0.25) - 2020/04/06 23:20:37
Table 'RushAndCash318819' 6-max Seat #1 is the button
Seat 1: Hero ($27.22 in chips)
Seat 2: f4e2b370 ($12.5 in chips)
Seat 3: dc09684b ($25 in chips)
Seat 4: d7bbc6af ($26.72 in chips)
Seat 5: eeae3d7 ($14.03 in chips)
Seat 6: 1b4ad4ae ($27.64 in chips)
f4e2b370: posts small blind $0.1
dc09684b: posts big blind $0.25
*** HOLE CARDS ***
Dealt to Hero [4s 2s]
Dealt to f4e2b370 
Dealt to dc09684b 
Dealt to d7bbc6af 
Dealt to eeae3d7 
Dealt to 1b4ad4ae 
d7bbc6af: folds
eeae3d7: folds
1b4ad4ae: folds
Hero: folds
f4e2b370: raises $0.5 to $0.75
dc09684b: calls $0.5
*** FLOP *** [5s 9s 9c]
f4e2b370: bets $1.2
dc09684b: folds
Uncalled bet ($1.2) returned to f4e2b370
*** SHOWDOWN ***
f4e2b370 collected $1.5 from pot
*** SUMMARY ***
Total pot $1.5
Board [5s 9s 9c]
Seat 1: Hero (button) folded before Flop (didn't bet)
Seat 2: f4e2b370 (small blind) won ($1.5)
Seat 3: dc09684b (big blind) folded on the Flop
Seat 4: d7bbc6af folded before Flop (didn't bet)
Seat 5: eeae3d7 folded before Flop (didn't bet)
Seat 6: 1b4ad4ae folded before Flop (didn't bet)


Poker Hand #RC94791268: Hold'em No Limit ($0.1/$0.25) - 2020/04/06 23:20:43
Table 'RushAndCash318823' 6-max Seat #1 is the button
Seat 1: 2258ad9f ($64.77 in chips)
Seat 2: d7bbc6af ($26.72 in chips)
Seat 3: Hero ($27.22 in chips)
Seat 4: ca69da65 ($44.42 in chips)
Seat 5: 8ef8832c ($25 in chips)
Seat 6: 58b04451 ($59.28 in chips)
d7bbc6af: posts small blind $0.1
Hero: posts big blind $0.25
*** HOLE CARDS ***
Dealt to 2258ad9f 
Dealt to d7bbc6af 
Dealt to Hero [4h 4c]
Dealt to ca69da65 
Dealt to 8ef8832c 
Dealt to 58b04451 
ca69da65: folds
8ef8832c: raises $0.38 to $0.63
58b04451: folds
2258ad9f: folds
d7bbc6af: folds
Hero: calls $0.38
*** FLOP *** [Ah Qc Ac]
Hero: checks
8ef8832c: checks
*** TURN *** [Ah Qc Ac] [2s]
Hero: checks
8ef8832c: checks
*** RIVER *** [Ah Qc Ac 2s] [Kd]
Hero: checks
8ef8832c: checks
Hero: shows [4h 4c] (Pair of Aces and Pair of Fours)
8ef8832c: shows [9c 9h] (Pair of Aces and Pair of Nines)
*** SHOWDOWN ***
8ef8832c collected $1.36 from pot
*** SUMMARY ***
Total pot $1.36
Board [Ah Qc Ac 2s Kd]
Seat 1: 2258ad9f (button) folded before Flop (didn't bet)
Seat 2: d7bbc6af (small blind) folded before Flop
Seat 3: Hero (big blind) showed [4h 4c] and lost with Pair of Aces and Pair of Fours
Seat 4: ca69da65 folded before Flop (didn't bet)
Seat 5: 8ef8832c showed [9h 9c] and won ($1.36) with Pair of Aces and Pair of Nines
Seat 6: 58b04451 folded before Flop (didn't bet)


Poker Hand #RC94791544: Hold'em No Limit ($0.1/$0.25) - 2020/04/06 23:21:39
Table 'RushAndCash318859' 6-max Seat #1 is the button
Seat 1: d7f99a39 ($4.72 in chips)
Seat 2: d8a224aa ($33.06 in chips)
Seat 3: 8a31aea7 ($70.74 in chips)
Seat 4: b00dbb18 ($25 in chips)
Seat 5: Hero ($26.59 in chips)
Seat 6: 8ef8832c ($25.67 in chips)
d8a224aa: posts small blind $0.1
8a31aea7: posts big blind $0.25
*** HOLE CARDS ***
Dealt to d7f99a39 
Dealt to d8a224aa 
Dealt to 8a31aea7 
Dealt to b00dbb18 
Dealt to Hero [Qs Qc]
Dealt to 8ef8832c 
b00dbb18: folds
Hero: raises $0.38 to $0.63
8ef8832c: folds
d7f99a39: folds
d8a224aa: folds
8a31aea7: folds
Uncalled bet ($0.38) returned to Hero
*** SHOWDOWN ***
Hero collected $0.6 from pot
*** SUMMARY ***
Total pot $0.6
Seat 1: d7f99a39 (button) folded before Flop (didn't bet)
Seat 2: d8a224aa (small blind) folded before Flop
Seat 3: 8a31aea7 (big blind) folded before Flop
Seat 4: b00dbb18 folded before Flop (didn't bet)
Seat 5: Hero collected ($0.6)
Seat 6: 8ef8832c folded before Flop (didn't bet)


Poker Hand #RC94791758: Hold'em No Limit ($0.1/$0.25) - 2020/04/06 23:22:24
Table 'RushAndCash318892' 6-max Seat #1 is the button
Seat 1: d7bbc6af ($26.19 in chips)
Seat 2: Hero ($26.94 in chips)
Seat 3: 107baea2 ($10.82 in chips)
Seat 4: 5543ad42 ($25 in chips)
Seat 5: 7bb17d1 ($9.9 in chips)
Seat 6: ea5eba95 ($98.36 in chips)
Hero: posts small blind $0.1
107baea2: posts big blind $0.25
*** HOLE CARDS ***
Dealt to d7bbc6af 
Dealt to Hero [7h 5d]
Dealt to 107baea2 
Dealt to 5543ad42 
Dealt to 7bb17d1 
Dealt to ea5eba95 
5543ad42: folds
7bb17d1: folds
ea5eba95: folds
d7bbc6af: folds
Hero: folds
Uncalled bet ($0.15) returned to 107baea2
*** SHOWDOWN ***
107baea2 collected $0.2 from pot
*** SUMMARY ***
Total pot $0.2
Seat 1: d7bbc6af (button) folded before Flop (didn't bet)
Seat 2: Hero (small blind) folded before Flop
Seat 3: 107baea2 (big blind) collected ($0.2)
Seat 4: 5543ad42 folded before Flop (didn't bet)
Seat 5: 7bb17d1 folded before Flop (didn't bet)
Seat 6: ea5eba95 folded before Flop (didn't bet)


Poker Hand #RC94791778: Hold'em No Limit ($0.1/$0.25) - 2020/04/06 23:22:28
Table 'RushAndCash318895' 6-max Seat #1 is the button
Seat 1: Hero ($26.84 in chips)
Seat 2: 1b4ad4ae ($25 in chips)
Seat 3: 8f2f88a4 ($43.72 in chips)
Seat 4: 5543ad42 ($25 in chips)
Seat 5: 22aa740d ($32.3 in chips)
Seat 6: 7357eb2f ($28.33 in chips)
1b4ad4ae: posts small blind $0.1
8f2f88a4: posts big blind $0.25
*** HOLE CARDS ***
Dealt to Hero [7c 4d]
Dealt to 1b4ad4ae 
Dealt to 8f2f88a4 
Dealt to 5543ad42 
Dealt to 22aa740d 
Dealt to 7357eb2f 
5543ad42: folds
22aa740d: folds
7357eb2f: folds
Hero: folds
1b4ad4ae: raises $0.5 to $0.75
8f2f88a4: calls $0.5
*** FLOP *** [9h Jh 8h]
1b4ad4ae: checks
8f2f88a4: checks
*** TURN *** [9h Jh 8h] [5s]
1b4ad4ae: checks
8f2f88a4: checks
*** RIVER *** [9h Jh 8h 5s] [Ah]
1b4ad4ae: checks
8f2f88a4: checks
1b4ad4ae: shows [Kc 9d] (Pair of Nines)
8f2f88a4: shows [Tc Ks] (Ace-High)
*** SHOWDOWN ***
1b4ad4ae collected $1.5 from pot
*** SUMMARY ***
Total pot $1.5
Board [9h Jh 8h 5s Ah]
Seat 1: Hero (button) folded before Flop (didn't bet)
Seat 2: 1b4ad4ae (small blind) showed [Kc 9d] and won ($1.5) with Pair of Nines
Seat 3: 8f2f88a4 (big blind) showed [Ks Tc] and lost with Ace-High
Seat 4: 5543ad42 folded before Flop (didn't bet)
Seat 5: 22aa740d folded before Flop (didn't bet)
Seat 6: 7357eb2f folded before Flop (didn't bet)


Poker Hand #RC94791815: Hold'em No Limit ($0.1/$0.25) - 2020/04/06 23:22:36
Table 'RushAndCash318900' 6-max Seat #1 is the button
Seat 1: ea5eba95 ($98.36 in chips)
Seat 2: e64b2cd5 ($12.6 in chips)
Seat 3: Hero ($26.84 in chips)
Seat 4: eeae3d7 ($13.3 in chips)
Seat 5: 22aa740d ($32.3 in chips)
Seat 6: 8ef8832c ($25.32 in chips)
e64b2cd5: posts small blind $0.1
Hero: posts big blind $0.25
*** HOLE CARDS ***
Dealt to ea5eba95 
Dealt to e64b2cd5 
Dealt to Hero [7s 7c]
Dealt to eeae3d7 
Dealt to 22aa740d 
Dealt to 8ef8832c 
eeae3d7: folds
22aa740d: folds
8ef8832c: folds
ea5eba95: raises $0.38 to $0.63
e64b2cd5: folds
Hero: calls $0.38
*** FLOP *** [4c 8d 4d]
Hero: checks
ea5eba95: checks
*** TURN *** [4c 8d 4d] [9d]
Hero: checks
ea5eba95: checks
*** RIVER *** [4c 8d 4d 9d] [6d]
Hero: checks
ea5eba95: checks
Hero: shows [7c 7s] (Pair of Sevens and Pair of Fours)
ea5eba95: shows [Qh 9c] (Pair of Nines and Pair of Fours)
*** SHOWDOWN ***
ea5eba95 collected $1.36 from pot
*** SUMMARY ***
Total pot $1.36
Board [4c 8d 4d 9d 6d]
Seat 1: ea5eba95 (button) showed [Qh 9c] and won ($1.36) with Pair of Nines and Pair of Fours
Seat 2: e64b2cd5 (small blind) folded before Flop
Seat 3: Hero (big blind) showed [7s 7c] and lost with Pair of Sevens and Pair of Fours
Seat 4: eeae3d7 folded before Flop (didn't bet)
Seat 5: 22aa740d folded before Flop (didn't bet)
Seat 6: 8ef8832c folded before Flop (didn't bet)


Poker Hand #RC94792073: Hold'em No Limit ($0.1/$0.25) - 2020/04/06 23:23:27
Table 'RushAndCash318931' 6-max Seat #1 is the button
Seat 1: cc4afcf8 ($13.49 in chips)
Seat 2: 2258ad9f ($69.51 in chips)
Seat 3: dfcfe0b3 ($25 in chips)
Seat 4: ea5eba95 ($99.03 in chips)
Seat 5: Hero ($26.21 in chips)
Seat 6: 2405da23 ($28.94 in chips)
2258ad9f: posts small blind $0.1
dfcfe0b3: posts big blind $0.25
*** HOLE CARDS ***
Dealt to cc4afcf8 
Dealt to 2258ad9f 
Dealt to dfcfe0b3 
Dealt to ea5eba95 
Dealt to Hero [Jc 3s]
Dealt to 2405da23 
ea5eba95: folds
Hero: folds
2405da23: raises $0.5 to $0.75
cc4afcf8: folds
2258ad9f: calls $0.65
dfcfe0b3: calls $0.5
*** FLOP *** [Qd 4s Qs]
2258ad9f: checks
dfcfe0b3: checks
2405da23: checks
*** TURN *** [Qd 4s Qs] [8h]
2258ad9f: bets $1
dfcfe0b3: folds
2405da23: raises $3.2 to $4.2
2258ad9f: folds
Uncalled bet ($3.2) returned to 2405da23
*** SHOWDOWN ***
2405da23 collected $4.25 from pot
*** SUMMARY ***
Total pot $4.25
Board [Qd 4s Qs 8h]
Seat 1: cc4afcf8 (button) folded before Flop (didn't bet)
Seat 2: 2258ad9f (small blind) folded on the Turn
Seat 3: dfcfe0b3 (big blind) folded on the Turn
Seat 4: ea5eba95 folded before Flop (didn't bet)
Seat 5: Hero folded before Flop (didn't bet)
Seat 6: 2405da23 won ($4.25)


Poker Hand #RC94792098: Hold'em No Limit ($0.1/$0.25) - 2020/04/06 23:23:33
Table 'RushAndCash318936' 6-max Seat #1 is the button
Seat 1: 969ce17 ($25.25 in chips)
Seat 2: 8b344141 ($14.35 in chips)
Seat 3: 93b71bcb ($38.53 in chips)
Seat 4: 928a94bb ($30.8 in chips)
Seat 5: 8ef8832c ($25 in chips)
Seat 6: Hero ($26.21 in chips)
8b344141: posts small blind $0.1
93b71bcb: posts big blind $0.25
*** HOLE CARDS ***
Dealt to 969ce17 
Dealt to 8b344141 
Dealt to 93b71bcb 
Dealt to 928a94bb 
Dealt to 8ef8832c 
Dealt to Hero [Qd 6s]
928a94bb: raises $0.38 to $0.63
8ef8832c: folds
Hero: folds
969ce17: calls $0.63
8b344141: raises $2.17 to $2.8
93b71bcb: folds
928a94bb: calls $2.17
969ce17: folds
*** FLOP *** [9h Ad Kd]
8b344141: checks
928a94bb: checks
*** TURN *** [9h Ad Kd] [6h]
8b344141: bets $2.2
928a94bb: folds
Uncalled bet ($2.2) returned to 8b344141
*** SHOWDOWN ***
8b344141 collected $6.48 from pot
*** SUMMARY ***
Total pot $6.48
Board [9h Ad Kd 6h]
Seat 1: 969ce17 (button) folded before Flop
Seat 2: 8b344141 (small blind) won ($6.48)
Seat 3: 93b71bcb (big blind) folded before Flop
Seat 4: 928a94bb folded on the Turn
Seat 5: 8ef8832c folded before Flop (didn't bet)
Seat 6: Hero folded before Flop (didn't bet)


Poker Hand #RC94792113: Hold'em No Limit ($0.1/$0.25) - 2020/04/06 23:23:36
Table 'RushAndCash318939' 6-max Seat #1 is the button
Seat 1: cce649b7 ($23.65 in chips)
Seat 2: 8f2f88a4 ($42.97 in chips)
Seat 3: c63a382b ($25 in chips)
Seat 4: 8e166af5 ($25 in chips)
Seat 5: Hero ($26.21 in chips)
Seat 6: bc200877 ($12.67 in chips)
8f2f88a4: posts small blind $0.1
c63a382b: posts big blind $0.25
*** HOLE CARDS ***
Dealt to cce649b7 
Dealt to 8f2f88a4 
Dealt to c63a382b 
Dealt to 8e166af5 
Dealt to Hero [As Ts]
Dealt to bc200877 
8e166af5: folds
Hero: raises $0.38 to $0.63
bc200877: folds
cce649b7: folds
8f2f88a4: folds
c63a382b: folds
Uncalled bet ($0.38) returned to Hero
*** SHOWDOWN ***
Hero collected $0.6 from pot
*** SUMMARY ***
Total pot $0.6
Seat 1: cce649b7 (button) folded before Flop (didn't bet)
Seat 2: 8f2f88a4 (small blind) folded before Flop
Seat 3: c63a382b (big blind) folded before Flop
Seat 4: 8e166af5 folded before Flop (didn't bet)
Seat 5: Hero collected ($0.6)
Seat 6: bc200877 folded before Flop (didn't bet)


Poker Hand #RC94792194: Hold'em No Limit ($0.1/$0.25) - 2020/04/06 23:23:52
Table 'RushAndCash318951' 6-max Seat #1 is the button
Seat 1: Hero ($26.56 in chips)
Seat 2: ff501d94 ($17.39 in chips)
Seat 3: afa5143c ($29.32 in chips)
Seat 4: 99d6d386 ($25.25 in chips)
Seat 5: 7532b9bc ($12.5 in chips)
Seat 6: 5543ad42 ($26.15 in chips)
ff501d94: posts small blind $0.1
afa5143c: posts big blind $0.25
*** HOLE CARDS ***
Dealt to Hero [As 6s]
Dealt to ff501d94 
Dealt to afa5143c 
Dealt to 99d6d386 
Dealt to 7532b9bc 
Dealt to 5543ad42 
99d6d386: folds
7532b9bc: raises $0.5 to $0.75
5543ad42: raises $1.25 to $2
Hero: folds
ff501d94: folds
afa5143c: folds
7532b9bc: raises $10.5 to $12.5 and is all-in
5543ad42: calls $10.5
7532b9bc: shows [Ac Kc]
5543ad42: shows [Js Jh]
*** FIRST FLOP *** [Ah Ts 8h]
*** FIRST TURN *** [Ah Ts 8h] [5h]
*** FIRST RIVER *** [Ah Ts 8h 5h] [Ks]
*** SECOND FLOP *** [3c Tc 4h]
*** SECOND TURN *** [3c Tc 4h] [5c]
*** SECOND RIVER *** [3c Tc 4h 5c] [Qd]
*** FIRST SHOWDOWN ***
7532b9bc collected $12.67 from pot
*** SECOND SHOWDOWN ***
7532b9bc collected $12.67 from pot
*** SUMMARY ***
Total pot $25.35
Hand was run two times
FIRST Board [Ah Ts 8h 5h Ks]
SECOND Board [3c Tc 4h 5c Qd]
Seat 1: Hero (button) folded before Flop (didn't bet)
Seat 2: ff501d94 (small blind) folded before Flop
Seat 3: afa5143c (big blind) folded before Flop
Seat 4: 99d6d386 folded before Flop (didn't bet)
Seat 5: 7532b9bc showed [Ac Kc] and won ($12.67) with Pair of Aces and Pair of Kings, and won ($12.67) with Ace High Flush
Seat 6: 5543ad42 showed [Js Jh] and lost with Pair of Jacks, and lost with Pair of Jacks


Poker Hand #RC94792267: Hold'em No Limit ($0.1/$0.25) - 2020/04/06 23:24:06
Table 'RushAndCash318959' 6-max Seat #1 is the button
Seat 1: ea5eba95 ($98.78 in chips)
Seat 2: 2467bb49 ($49 in chips)
Seat 3: e58da42d ($36.39 in chips)
Seat 4: Hero ($26.56 in chips)
Seat 5: 8fb93df3 ($34.8 in chips)
Seat 6: c5fcb0d3 ($25.66 in chips)
2467bb49: posts small blind $0.1
e58da42d: posts big blind $0.25
*** HOLE CARDS ***
Dealt to ea5eba95 
Dealt to 2467bb49 
Dealt to e58da42d 
Dealt to Hero [Jd 6h]
Dealt to 8fb93df3 
Dealt to c5fcb0d3 
Hero: folds
8fb93df3: folds
c5fcb0d3: folds
ea5eba95: folds
2467bb49: folds
Uncalled bet ($0.15) returned to e58da42d
*** SHOWDOWN ***
e58da42d collected $0.2 from pot
*** SUMMARY ***
Total pot $0.2
Seat 1: ea5eba95 (button) folded before Flop (didn't bet)
Seat 2: 2467bb49 (small blind) folded before Flop
Seat 3: e58da42d (big blind) collected ($0.2)
Seat 4: Hero folded before Flop (didn't bet)
Seat 5: 8fb93df3 folded before Flop (didn't bet)
Seat 6: c5fcb0d3 folded before Flop (didn't bet)


Poker Hand #RC94792286: Hold'em No Limit ($0.1/$0.25) - 2020/04/06 23:24:10
Table 'RushAndCash318962' 6-max Seat #1 is the button
Seat 1: d8a224aa ($32.36 in chips)
Seat 2: 99d6d386 ($25 in chips)
Seat 3: e64b2cd5 ($12.5 in chips)
Seat 4: c5fcb0d3 ($25.66 in chips)
Seat 5: Hero ($26.56 in chips)
Seat 6: cce649b7 ($25.35 in chips)
99d6d386: posts small blind $0.1
e64b2cd5: posts big blind $0.25
*** HOLE CARDS ***
Dealt to d8a224aa 
Dealt to 99d6d386 
Dealt to e64b2cd5 
Dealt to c5fcb0d3 
Dealt to Hero [Ad 8s]
Dealt to cce649b7 
c5fcb0d3: folds
Hero: folds
cce649b7: folds
d8a224aa: raises $0.38 to $0.63
99d6d386: folds
e64b2cd5: calls $0.38
*** FLOP *** [9d 7d 3d]
e64b2cd5: checks
d8a224aa: checks
*** TURN *** [9d 7d 3d] [As]
e64b2cd5: bets $1.1
d8a224aa: calls $1.1
*** RIVER *** [9d 7d 3d As] [5c]
e64b2cd5: checks
d8a224aa: bets $2.7
e64b2cd5: folds
Uncalled bet ($2.7) returned to d8a224aa
*** SHOWDOWN ***
d8a224aa collected $3.56 from pot
*** SUMMARY ***
Total pot $3.56
Board [9d 7d 3d As 5c]
Seat 1: d8a224aa (button) won ($3.56)
Seat 2: 99d6d386 (small blind) folded before Flop
Seat 3: e64b2cd5 (big blind) folded on the River
Seat 4: c5fcb0d3 folded before Flop (didn't bet)
Seat 5: Hero folded before Flop (didn't bet)
Seat 6: cce649b7 folded before Flop (didn't bet)


Poker Hand #RC94792304: Hold'em No Limit ($0.1/$0.25) - 2020/04/06 23:24:13
Table 'RushAndCash318965' 6-max Seat #1 is the button
Seat 1: e44fce1a ($27.02 in chips)
Seat 2: ba032eea ($58.84 in chips)
Seat 3: bc200877 ($12.67 in chips)
Seat 4: 8a31aea7 ($98.51 in chips)
Seat 5: Hero ($26.56 in chips)
Seat 6: f83dd98d ($25 in chips)
ba032eea: posts small blind $0.1
bc200877: posts big blind $0.25
*** HOLE CARDS ***
Dealt to e44fce1a 
Dealt to ba032eea 
Dealt to bc200877 
Dealt to 8a31aea7 
Dealt to Hero [Ac 9c]
Dealt to f83dd98d 
8a31aea7: raises $0.38 to $0.63
Hero: folds
f83dd98d: folds
e44fce1a: folds
ba032eea: folds
bc200877: folds
Uncalled bet ($0.38) returned to 8a31aea7
*** SHOWDOWN ***
8a31aea7 collected $0.6 from pot
*** SUMMARY ***
Total pot $0.6
Seat 1: e44fce1a (button) folded before Flop (didn't bet)
Seat 2: ba032eea (small blind) folded before Flop
Seat 3: bc200877 (big blind) folded before Flop
Seat 4: 8a31aea7 collected ($0.6)
Seat 5: Hero folded before Flop (didn't bet)
Seat 6: f83dd98d folded before Flop (didn't bet)


Poker Hand #RC94792342: Hold'em No Limit ($0.1/$0.25) - 2020/04/06 23:24:21
Table 'RushAndCash318973' 6-max Seat #1 is the button
Seat 1: 41ab7510 ($25 in chips)
Seat 2: 522e695b ($12.55 in chips)
Seat 3: 970d5bb4 ($12.5 in chips)
Seat 4: 22449dd4 ($32.3 in chips)
Seat 5: Hero ($26.56 in chips)
Seat 6: ff501d94 ($17.29 in chips)
522e695b: posts small blind $0.1
970d5bb4: posts big blind $0.25
*** HOLE CARDS ***
Dealt to 41ab7510 
Dealt to 522e695b 
Dealt to 970d5bb4 
Dealt to 22449dd4 
Dealt to Hero [As Kh]
Dealt to ff501d94 
22449dd4: folds
Hero: raises $0.38 to $0.63
ff501d94: calls $0.63
41ab7510: folds
522e695b: folds
970d5bb4: folds
*** FLOP *** [7d 7s 4s]
Hero: checks
ff501d94: checks
*** TURN *** [7d 7s 4s] [3d]
Hero: bets $1.3
ff501d94: calls $1.3
*** RIVER *** [7d 7s 4s 3d] [Ah]
Hero: checks
ff501d94: bets $1.4
Hero: calls $1.4
ff501d94: shows [4c Ac] (Pair of Aces and Pair of Sevens)
Hero: shows [As Kh] (Pair of Aces and Pair of Sevens)
*** SHOWDOWN ***
Hero collected $7.01 from pot
*** SUMMARY ***
Total pot $7.01
Board [7d 7s 4s 3d Ah]
Seat 1: 41ab7510 (button) folded before Flop (didn't bet)
Seat 2: 522e695b (small blind) folded before Flop
Seat 3: 970d5bb4 (big blind) folded before Flop
Seat 4: 22449dd4 folded before Flop (didn't bet)
Seat 5: Hero showed [As Kh] and won ($7.01) with Pair of Aces and Pair of Sevens
Seat 6: ff501d94 showed [Ac 4c] and lost with Pair of Aces and Pair of Sevens


Poker Hand #RC94792562: Hold'em No Limit ($0.1/$0.25) - 2020/04/06 23:25:06
Table 'RushAndCash319008' 6-max Seat #1 is the button
Seat 1: Hero ($29.89 in chips)
Seat 2: f83dd98d ($25 in chips)
Seat 3: ff501d94 ($13.96 in chips)
Seat 4: 99d6d386 ($25 in chips)
Seat 5: 17480666 ($102.53 in chips)
Seat 6: 58b04451 ($34.62 in chips)
f83dd98d: posts small blind $0.1
ff501d94: posts big blind $0.25
*** HOLE CARDS ***
Dealt to Hero [Jd 4s]
Dealt to f83dd98d 
Dealt to ff501d94 
Dealt to 99d6d386 
Dealt to 17480666 
Dealt to 58b04451 
99d6d386: folds
17480666: folds
58b04451: folds
Hero: folds
f83dd98d: raises $0.5 to $0.75
ff501d94: calls $0.5
*** FLOP *** [9s 2c Kc]
f83dd98d: checks
ff501d94: checks
*** TURN *** [9s 2c Kc] [4h]
f83dd98d: checks
ff501d94: checks
*** RIVER *** [9s 2c Kc 4h] [Qd]
f83dd98d: checks
ff501d94: checks
f83dd98d: shows [5c 5h] (Pair of Fives)
ff501d94: shows [8c As] (Ace-High)
*** SHOWDOWN ***
f83dd98d collected $1.5 from pot
*** SUMMARY ***
Total pot $1.5
Board [9s 2c Kc 4h Qd]
Seat 1: Hero (button) folded before Flop (didn't bet)
Seat 2: f83dd98d (small blind) showed [5h 5c] and won ($1.5) with Pair of Fives
Seat 3: ff501d94 (big blind) showed [As 8c] and lost with Ace-High
Seat 4: 99d6d386 folded before Flop (didn't bet)
Seat 5: 17480666 folded before Flop (didn't bet)
Seat 6: 58b04451 folded before Flop (didn't bet)


Poker Hand #RC94792581: Hold'em No Limit ($0.1/$0.25) - 2020/04/06 23:25:10
Table 'RushAndCash319012' 6-max Seat #1 is the button
Seat 1: 522e695b ($11.92 in chips)
Seat 2: afa5143c ($29.32 in chips)
Seat 3: Hero ($29.89 in chips)
Seat 4: 92c8c82d ($25.25 in chips)
Seat 5: 9c511c89 ($12.5 in chips)
Seat 6: 99d6d386 ($25 in chips)
afa5143c: posts small blind $0.1
Hero: posts big blind $0.25
*** HOLE CARDS ***
Dealt to 522e695b 
Dealt to afa5143c 
Dealt to Hero [8d 2c]
Dealt to 92c8c82d 
Dealt to 9c511c89 
Dealt to 99d6d386 
92c8c82d: folds
9c511c89: folds
99d6d386: folds
522e695b: folds
afa5143c: folds
Uncalled bet ($0.15) returned to Hero
*** SHOWDOWN ***
Hero collected $0.2 from pot
*** SUMMARY ***
Total pot $0.2
Seat 1: 522e695b (button) folded before Flop (didn't bet)
Seat 2: afa5143c (small blind) folded before Flop
Seat 3: Hero (big blind) collected ($0.2)
Seat 4: 92c8c82d folded before Flop (didn't bet)
Seat 5: 9c511c89 folded before Flop (didn't bet)
Seat 6: 99d6d386 folded before Flop (didn't bet)


Poker Hand #RC94792597: Hold'em No Limit ($0.1/$0.25) - 2020/04/06 23:25:13
Table 'RushAndCash319014' 6-max Seat #1 is the button
Seat 1: 8e166af5 ($25 in chips)
Seat 2: Hero ($29.64 in chips)
Seat 3: 58b04451 ($34.62 in chips)
Seat 4: 604f36f0 ($18.19 in chips)
Seat 5: cce649b7 ($24.65 in chips)
Seat 6: e44fce1a ($27.02 in chips)
Hero: posts small blind $0.1
58b04451: posts big blind $0.25
*** HOLE CARDS ***
Dealt to 8e166af5 
Dealt to Hero [Ks Kc]
Dealt to 58b04451 
Dealt to 604f36f0 
Dealt to cce649b7 
Dealt to e44fce1a 
604f36f0: raises $0.5 to $0.75
cce649b7: folds
e44fce1a: folds
8e166af5: folds
Hero: raises $2 to $2.75
58b04451: folds
604f36f0: folds
Uncalled bet ($2) returned to Hero
*** SHOWDOWN ***
Hero collected $1.75 from pot
*** SUMMARY ***
Total pot $1.75
Seat 1: 8e166af5 (button) folded before Flop (didn't bet)
Seat 2: Hero (small blind) collected ($1.75)
Seat 3: 58b04451 (big blind) folded before Flop
Seat 4: 604f36f0 folded before Flop
Seat 5: cce649b7 folded before Flop (didn't bet)
Seat 6: e44fce1a folded before Flop (didn't bet)


Poker Hand #RC94792721: Hold'em No Limit ($0.1/$0.25) - 2020/04/06 23:25:39
Table 'RushAndCash319033' 6-max Seat #1 is the button
Seat 1: e58da42d ($35.24 in chips)
Seat 2: 8f2f88a4 ($43.89 in chips)
Seat 3: afa5143c ($29.57 in chips)
Seat 4: e767af3b ($25 in chips)
Seat 5: Hero ($30.91 in chips)
Seat 6: 94efc628 ($29.49 in chips)
8f2f88a4: posts small blind $0.1
afa5143c: posts big blind $0.25
*** HOLE CARDS ***
Dealt to e58da42d 
Dealt to 8f2f88a4 
Dealt to afa5143c 
Dealt to e767af3b 
Dealt to Hero [9d 8c]
Dealt to 94efc628 
e767af3b: folds
Hero: folds
94efc628: folds
e58da42d: raises $0.38 to $0.63
8f2f88a4: folds
afa5143c: calls $0.38
*** FLOP *** [2d Jd 9s]
afa5143c: checks
e58da42d: checks
*** TURN *** [2d Jd 9s] [9h]
afa5143c: checks
e58da42d: checks
*** RIVER *** [2d Jd 9s 9h] [7c]
afa5143c: bets $1.1
e58da42d: folds
Uncalled bet ($1.1) returned to afa5143c
*** SHOWDOWN ***
afa5143c collected $1.36 from pot
*** SUMMARY ***
Total pot $1.36
Board [2d Jd 9s 9h 7c]
Seat 1: e58da42d (button) folded on the River
Seat 2: 8f2f88a4 (small blind) folded before Flop
Seat 3: afa5143c (big blind) won ($1.36)
Seat 4: e767af3b folded before Flop (didn't bet)
Seat 5: Hero folded before Flop (didn't bet)
Seat 6: 94efc628 folded before Flop (didn't bet)


Poker Hand #RC94792751: Hold'em No Limit ($0.1/$0.25) - 2020/04/06 23:25:45
Table 'RushAndCash319037' 6-max Seat #1 is the button
Seat 1: 94efc628 ($29.49 in chips)
Seat 2: 9c511c89 ($12.5 in chips)
Seat 3: Hero ($30.91 in chips)
Seat 4: 2467bb49 ($55.05 in chips)
Seat 5: 8f3ae91b ($25 in chips)
Seat 6: e767af3b ($25 in chips)
9c511c89: posts small blind $0.1
Hero: posts big blind $0.25
*** HOLE CARDS ***
Dealt to 94efc628 
Dealt to 9c511c89 
Dealt to Hero [As 5h]
Dealt to 2467bb49 
Dealt to 8f3ae91b 
Dealt to e767af3b 
2467bb49: folds
8f3ae91b: raises $0.5 to $0.75
e767af3b: folds
94efc628: folds
9c511c89: folds
Hero: folds
Uncalled bet ($0.5) returned to 8f3ae91b
*** SHOWDOWN ***
8f3ae91b collected $0.6 from pot
*** SUMMARY ***
Total pot $0.6
Seat 1: 94efc628 (button) folded before Flop (didn't bet)
Seat 2: 9c511c89 (small blind) folded before Flop
Seat 3: Hero (big blind) folded before Flop
Seat 4: 2467bb49 folded before Flop (didn't bet)
Seat 5: 8f3ae91b collected ($0.6)
Seat 6: e767af3b folded before Flop (didn't bet)


Poker Hand #RC94792776: Hold'em No Limit ($0.1/$0.25) - 2020/04/06 23:25:50
Table 'RushAndCash319042' 6-max Seat #1 is the button
Seat 1: ea5eba95 ($98.38 in chips)
Seat 2: e767af3b ($25 in chips)
Seat 3: 522e695b ($11.92 in chips)
Seat 4: 5543ad42 ($26.61 in chips)
Seat 5: Hero ($30.66 in chips)
Seat 6: d8a224aa ($33.27 in chips)
e767af3b: posts small blind $0.1
522e695b: posts big blind $0.25
*** HOLE CARDS ***
Dealt to ea5eba95 
Dealt to e767af3b 
Dealt to 522e695b 
Dealt to 5543ad42 
Dealt to Hero [8h 6h]
Dealt to d8a224aa 
5543ad42: raises $0.38 to $0.63
Hero: folds
d8a224aa: folds
ea5eba95: folds
e767af3b: folds
522e695b: folds
Uncalled bet ($0.38) returned to 5543ad42
*** SHOWDOWN ***
5543ad42 collected $0.6 from pot
*** SUMMARY ***
Total pot $0.6
Seat 1: ea5eba95 (button) folded before Flop (didn't bet)
Seat 2: e767af3b (small blind) folded before Flop
Seat 3: 522e695b (big blind) folded before Flop
Seat 4: 5543ad42 collected ($0.6)
Seat 5: Hero folded before Flop (didn't bet)
Seat 6: d8a224aa folded before Flop (didn't bet)


Poker Hand #RC94792804: Hold'em No Limit ($0.1/$0.25) - 2020/04/06 23:25:55
Table 'RushAndCash319047' 6-max Seat #1 is the button
Seat 1: 970d5bb4 ($12.5 in chips)
Seat 2: Hero ($30.66 in chips)
Seat 3: e767af3b ($25 in chips)
Seat 4: cce649b7 ($24.3 in chips)
Seat 5: cc4afcf8 ($13.84 in chips)
Seat 6: 7357eb2f ($27.57 in chips)
Hero: posts small blind $0.1
e767af3b: posts big blind $0.25
*** HOLE CARDS ***
Dealt to 970d5bb4 
Dealt to Hero [7d 2s]
Dealt to e767af3b 
Dealt to cce649b7 
Dealt to cc4afcf8 
Dealt to 7357eb2f 
cce649b7: folds
cc4afcf8: folds
7357eb2f: folds
970d5bb4: folds
Hero: folds
Uncalled bet ($0.15) returned to e767af3b
*** SHOWDOWN ***
e767af3b collected $0.2 from pot
*** SUMMARY ***
Total pot $0.2
Seat 1: 970d5bb4 (button) folded before Flop (didn't bet)
Seat 2: Hero (small blind) folded before Flop
Seat 3: e767af3b (big blind) collected ($0.2)
Seat 4: cce649b7 folded before Flop (didn't bet)
Seat 5: cc4afcf8 folded before Flop (didn't bet)
Seat 6: 7357eb2f folded before Flop (didn't bet)


Poker Hand #RC94792838: Hold'em No Limit ($0.1/$0.25) - 2020/04/06 23:26:02
Table 'RushAndCash319055' 6-max Seat #1 is the button
Seat 1: Hero ($30.56 in chips)
Seat 2: 94efc628 ($29.49 in chips)
Seat 3: cc4afcf8 ($13.84 in chips)
Seat 4: 92c8c82d ($25.35 in chips)
Seat 5: 38359122 ($12.98 in chips)
Seat 6: 90609fad ($25 in chips)
94efc628: posts small blind $0.1
cc4afcf8: posts big blind $0.25
*** HOLE CARDS ***
Dealt to Hero [6s 4c]
Dealt to 94efc628 
Dealt to cc4afcf8 
Dealt to 92c8c82d 
Dealt to 38359122 
Dealt to 90609fad 
92c8c82d: folds
38359122: folds
90609fad: folds
Hero: folds
94efc628: folds
Uncalled bet ($0.15) returned to cc4afcf8
*** SHOWDOWN ***
cc4afcf8 collected $0.2 from pot
*** SUMMARY ***
Total pot $0.2
Seat 1: Hero (button) folded before Flop (didn't bet)
Seat 2: 94efc628 (small blind) folded before Flop
Seat 3: cc4afcf8 (big blind) collected ($0.2)
Seat 4: 92c8c82d folded before Flop (didn't bet)
Seat 5: 38359122 folded before Flop (didn't bet)
Seat 6: 90609fad folded before Flop (didn't bet)


Poker Hand #RC94792860: Hold'em No Limit ($0.1/$0.25) - 2020/04/06 23:26:07
Table 'RushAndCash319058' 6-max Seat #1 is the button
Seat 1: bd6eeaf3 ($50.73 in chips)
Seat 2: Hero ($30.56 in chips)
Seat 3: d8a224aa ($33.27 in chips)
Seat 4: 970d5bb4 ($12.5 in chips)
Seat 5: 8e166af5 ($29.45 in chips)
Seat 6: ea5eba95 ($98.38 in chips)
Hero: posts small blind $0.1
d8a224aa: posts big blind $0.25
*** HOLE CARDS ***
Dealt to bd6eeaf3 
Dealt to Hero [Td 7d]
Dealt to d8a224aa 
Dealt to 970d5bb4 
Dealt to 8e166af5 
Dealt to ea5eba95 
970d5bb4: folds
8e166af5: folds
ea5eba95: folds
bd6eeaf3: raises $0.38 to $0.63
Hero: folds
d8a224aa: calls $0.38
*** FLOP *** [5d 6d 6s]
d8a224aa: checks
bd6eeaf3: checks
*** TURN *** [5d 6d 6s] [8d]
d8a224aa: checks
bd6eeaf3: bets $0.7
d8a224aa: folds
Uncalled bet ($0.7) returned to bd6eeaf3
*** SHOWDOWN ***
bd6eeaf3 collected $1.36 from pot
*** SUMMARY ***
Total pot $1.36
Board [5d 6d 6s 8d]
Seat 1: bd6eeaf3 (button) won ($1.36)
Seat 2: Hero (small blind) folded before Flop
Seat 3: d8a224aa (big blind) folded on the Turn
Seat 4: 970d5bb4 folded before Flop (didn't bet)
Seat 5: 8e166af5 folded before Flop (didn't bet)
Seat 6: ea5eba95 folded before Flop (didn't bet)


Poker Hand #RC94792881: Hold'em No Limit ($0.1/$0.25) - 2020/04/06 23:26:12
Table 'RushAndCash319063' 6-max Seat #1 is the button
Seat 1: 107baea2 ($9.9 in chips)
Seat 2: 970d5bb4 ($12.5 in chips)
Seat 3: eeae3d7 ($12.45 in chips)
Seat 4: Hero ($30.46 in chips)
Seat 5: 969ce17 ($26.73 in chips)
Seat 6: 2258ad9f ($68.02 in chips)
970d5bb4: posts small blind $0.1
eeae3d7: posts big blind $0.25
*** HOLE CARDS ***
Dealt to 107baea2 
Dealt to 970d5bb4 
Dealt to eeae3d7 
Dealt to Hero [Ah Td]
Dealt to 969ce17 
Dealt to 2258ad9f 
Hero: folds
969ce17: raises $0.5 to $0.75
2258ad9f: calls $0.75
107baea2: calls $0.75
970d5bb4: raises $11.75 to $12.5 and is all-in
eeae3d7: folds
969ce17: folds
2258ad9f: folds
107baea2: calls $9.15 and is all-in
Uncalled bet ($2.6) returned to 970d5bb4
970d5bb4: shows [As Kd]
107baea2: shows [3d 3h]
*** FIRST FLOP *** [2c 7h 6s]
*** FIRST TURN *** [2c 7h 6s] [5h]
*** FIRST RIVER *** [2c 7h 6s 5h] [Qd]
*** SECOND FLOP *** [6c Tc Qc]
*** SECOND TURN *** [6c Tc Qc] [4c]
*** SECOND RIVER *** [6c Tc Qc 4c] [3s]
*** FIRST SHOWDOWN ***
107baea2 collected $10.77 from pot
*** SECOND SHOWDOWN ***
107baea2 collected $10.77 from pot
*** SUMMARY ***
Total pot $21.55
Hand was run two times
FIRST Board [2c 7h 6s 5h Qd]
SECOND Board [6c Tc Qc 4c 3s]
Seat 1: 107baea2 (button) showed [3h 3d] and won ($10.77) with Pair of Treys, and won ($10.77) with Three Treys
Seat 2: 970d5bb4 (small blind) showed [As Kd] and lost with Ace-High, and lost with Ace-High
Seat 3: eeae3d7 (big blind) folded before Flop
Seat 4: Hero folded before Flop (didn't bet)
Seat 5: 969ce17 folded before Flop
Seat 6: 2258ad9f folded before Flop


Poker Hand #RC94792907: Hold'em No Limit ($0.1/$0.25) - 2020/04/06 23:26:17
Table 'RushAndCash319066' 6-max Seat #1 is the button
Seat 1: f99bdf7f ($27.51 in chips)
Seat 2: cc4afcf8 ($13.94 in chips)
Seat 3: 41ab7510 ($25 in chips)
Seat 4: Hero ($30.46 in chips)
Seat 5: 90609fad ($25 in chips)
Seat 6: 22449dd4 ($33.56 in chips)
cc4afcf8: posts small blind $0.1
41ab7510: posts big blind $0.25
*** HOLE CARDS ***
Dealt to f99bdf7f 
Dealt to cc4afcf8 
Dealt to 41ab7510 
Dealt to Hero [9d 2d]
Dealt to 90609fad 
Dealt to 22449dd4 
Hero: folds
90609fad: raises $0.5 to $0.75
22449dd4: folds
f99bdf7f: folds
cc4afcf8: folds
41ab7510: folds
Uncalled bet ($0.5) returned to 90609fad
*** SHOWDOWN ***
90609fad collected $0.6 from pot
*** SUMMARY ***
Total pot $0.6
Seat 1: f99bdf7f (button) folded before Flop (didn't bet)
Seat 2: cc4afcf8 (small blind) folded before Flop
Seat 3: 41ab7510 (big blind) folded before Flop
Seat 4: Hero folded before Flop (didn't bet)
Seat 5: 90609fad collected ($0.6)
Seat 6: 22449dd4 folded before Flop (didn't bet)


Poker Hand #RC94792922: Hold'em No Limit ($0.1/$0.25) - 2020/04/06 23:26:20
Table 'RushAndCash319068' 6-max Seat #1 is the button
Seat 1: 9c511c89 ($12.5 in chips)
Seat 2: c5fcb0d3 ($25 in chips)
Seat 3: Hero ($30.46 in chips)
Seat 4: e767af3b ($25.1 in chips)
Seat 5: ba032eea ($56.03 in chips)
Seat 6: bc200877 ($11.97 in chips)
c5fcb0d3: posts small blind $0.1
Hero: posts big blind $0.25
*** HOLE CARDS ***
Dealt to 9c511c89 
Dealt to c5fcb0d3 
Dealt to Hero [Jd 6c]
Dealt to e767af3b 
Dealt to ba032eea 
Dealt to bc200877 
e767af3b: folds
ba032eea: folds
bc200877: folds
9c511c89: folds
c5fcb0d3: folds
Uncalled bet ($0.15) returned to Hero
*** SHOWDOWN ***
Hero collected $0.2 from pot
*** SUMMARY ***
Total pot $0.2
Seat 1: 9c511c89 (button) folded before Flop (didn't bet)
Seat 2: c5fcb0d3 (small blind) folded before Flop
Seat 3: Hero (big blind) collected ($0.2)
Seat 4: e767af3b folded before Flop (didn't bet)
Seat 5: ba032eea folded before Flop (didn't bet)
Seat 6: bc200877 folded before Flop (didn't bet)


Poker Hand #RC94792947: Hold'em No Limit ($0.1/$0.25) - 2020/04/06 23:26:25
Table 'RushAndCash319072' 6-max Seat #1 is the button
Seat 1: eeae3d7 ($12.2 in chips)
Seat 2: 8fb93df3 ($35.82 in chips)
Seat 3: 5543ad42 ($27.31 in chips)
Seat 4: Hero ($30.21 in chips)
Seat 5: afa5143c ($30.24 in chips)
Seat 6: 9c511c89 ($12.5 in chips)
8fb93df3: posts small blind $0.1
5543ad42: posts big blind $0.25
*** HOLE CARDS ***
Dealt to eeae3d7 
Dealt to 8fb93df3 
Dealt to 5543ad42 
Dealt to Hero [5h 4c]
Dealt to afa5143c 
Dealt to 9c511c89 
Hero: folds
afa5143c: folds
9c511c89: raises $0.5 to $0.75
eeae3d7: folds
8fb93df3: folds
5543ad42: folds
Uncalled bet ($0.5) returned to 9c511c89
*** SHOWDOWN ***
9c511c89 collected $0.6 from pot
*** SUMMARY ***
Total pot $0.6
Seat 1: eeae3d7 (button) folded before Flop (didn't bet)
Seat 2: 8fb93df3 (small blind) folded before Flop
Seat 3: 5543ad42 (big blind) folded before Flop
Seat 4: Hero folded before Flop (didn't bet)
Seat 5: afa5143c folded before Flop (didn't bet)
Seat 6: 9c511c89 collected ($0.6)


Poker Hand #RC94792965: Hold'em No Limit ($0.1/$0.25) - 2020/04/06 23:26:29
Table 'RushAndCash319074' 6-max Seat #1 is the button
Seat 1: d13258d2 ($6.16 in chips)
Seat 2: f99bdf7f ($27.26 in chips)
Seat 3: 99d6d386 ($25.7 in chips)
Seat 4: 1b4ad4ae ($25.25 in chips)
Seat 5: Hero ($30.21 in chips)
Seat 6: fd369e31 ($52.76 in chips)
f99bdf7f: posts small blind $0.1
99d6d386: posts big blind $0.25
*** HOLE CARDS ***
Dealt to d13258d2 
Dealt to f99bdf7f 
Dealt to 99d6d386 
Dealt to 1b4ad4ae 
Dealt to Hero [Qc 8h]
Dealt to fd369e31 
1b4ad4ae: raises $0.5 to $0.75
Hero: folds
fd369e31: folds
d13258d2: folds
f99bdf7f: folds
99d6d386: folds
Uncalled bet ($0.5) returned to 1b4ad4ae
*** SHOWDOWN ***
1b4ad4ae collected $0.6 from pot
*** SUMMARY ***
Total pot $0.6
Seat 1: d13258d2 (button) folded before Flop (didn't bet)
Seat 2: f99bdf7f (small blind) folded before Flop
Seat 3: 99d6d386 (big blind) folded before Flop
Seat 4: 1b4ad4ae collected ($0.6)
Seat 5: Hero folded before Flop (didn't bet)
Seat 6: fd369e31 folded before Flop (didn't bet)


Poker Hand #RC94792990: Hold'em No Limit ($0.1/$0.25) - 2020/04/06 23:26:34
Table 'RushAndCash319077' 6-max Seat #1 is the button
Seat 1: cc4afcf8 ($13.84 in chips)
Seat 2: Hero ($30.21 in chips)
Seat 3: 38359122 ($12.63 in chips)
Seat 4: 8fb93df3 ($35.72 in chips)
Seat 5: f99bdf7f ($27.16 in chips)
Seat 6: 2904eaa2 ($25 in chips)
Hero: posts small blind $0.1
38359122: posts big blind $0.25
*** HOLE CARDS ***
Dealt to cc4afcf8 
Dealt to Hero [As 3h]
Dealt to 38359122 
Dealt to 8fb93df3 
Dealt to f99bdf7f 
Dealt to 2904eaa2 
8fb93df3: folds
f99bdf7f: folds
2904eaa2: folds
cc4afcf8: raises $0.25 to $0.5
Hero: folds
38359122: raises $3.5 to $4
cc4afcf8: folds
Uncalled bet ($3.5) returned to 38359122
*** SHOWDOWN ***
38359122 collected $1.1 from pot
*** SUMMARY ***
Total pot $1.1
Seat 1: cc4afcf8 (button) folded before Flop
Seat 2: Hero (small blind) folded before Flop
Seat 3: 38359122 (big blind) collected ($1.1)
Seat 4: 8fb93df3 folded before Flop (didn't bet)
Seat 5: f99bdf7f folded before Flop (didn't bet)
Seat 6: 2904eaa2 folded before Flop (didn't bet)


Poker Hand #RC94793007: Hold'em No Limit ($0.1/$0.25) - 2020/04/06 23:26:37
Table 'RushAndCash319079' 6-max Seat #1 is the button
Seat 1: bc200877 ($11.97 in chips)
Seat 2: 3f7e31d ($23.82 in chips)
Seat 3: e767af3b ($25.1 in chips)
Seat 4: Hero ($30.11 in chips)
Seat 5: 8fb93df3 ($35.72 in chips)
Seat 6: 22449dd4 ($33.91 in chips)
3f7e31d: posts small blind $0.1
e767af3b: posts big blind $0.25
*** HOLE CARDS ***
Dealt to bc200877 
Dealt to 3f7e31d 
Dealt to e767af3b 
Dealt to Hero [Ks 6c]
Dealt to 8fb93df3 
Dealt to 22449dd4 
Hero: folds
8fb93df3: raises $0.38 to $0.63
22449dd4: folds
bc200877: folds
3f7e31d: folds
e767af3b: calls $0.38
*** FLOP *** [9d Qs 6d]
e767af3b: checks
8fb93df3: checks
*** TURN *** [9d Qs 6d] [5c]
e767af3b: checks
8fb93df3: checks
*** RIVER *** [9d Qs 6d 5c] [7c]
e767af3b: checks
8fb93df3: checks
e767af3b: shows [4h 4d] (Pair of Fours)
8fb93df3: shows [Kc As] (Ace-High)
*** SHOWDOWN ***
e767af3b collected $1.36 from pot
*** SUMMARY ***
Total pot $1.36
Board [9d Qs 6d 5c 7c]
Seat 1: bc200877 (button) folded before Flop (didn't bet)
Seat 2: 3f7e31d (small blind) folded before Flop
Seat 3: e767af3b (big blind) showed [4h 4d] and won ($1.36) with Pair of Fours
Seat 4: Hero folded before Flop (didn't bet)
Seat 5: 8fb93df3 showed [As Kc] and lost with Ace-High
Seat 6: 22449dd4 folded before Flop (didn't bet)


Poker Hand #RC94793024: Hold'em No Limit ($0.1/$0.25) - 2020/04/06 23:26:41
Table 'RushAndCash319081' 6-max Seat #1 is the button
Seat 1: Hero ($30.46 in chips)
Seat 2: 2904eaa2 ($25 in chips)
Seat 3: fe7c9e7a ($25.6 in chips)
Seat 4: 7f427d6f ($6.52 in chips)
Seat 5: afa5143c ($30.24 in chips)
Seat 6: 9c511c89 ($12.85 in chips)
2904eaa2: posts small blind $0.1
fe7c9e7a: posts big blind $0.25
*** HOLE CARDS ***
Dealt to Hero [Td Tc]
Dealt to 2904eaa2 
Dealt to fe7c9e7a 
Dealt to 7f427d6f 
Dealt to afa5143c 
Dealt to 9c511c89 
7f427d6f: folds
afa5143c: folds
9c511c89: folds
Hero: raises $0.38 to $0.63
2904eaa2: calls $0.53
fe7c9e7a: folds
*** FLOP *** [6c 4d Jh]
2904eaa2: checks
Hero: bets $0.5
2904eaa2: calls $0.5
*** TURN *** [6c 4d Jh] [Kc]
2904eaa2: checks
Hero: bets $1.9
2904eaa2: folds
Uncalled bet ($1.9) returned to Hero
*** SHOWDOWN ***
Hero collected $2.51 from pot
*** SUMMARY ***
Total pot $2.51
Board [6c 4d Jh Kc]
Seat 1: Hero (button) won ($2.51)
Seat 2: 2904eaa2 (small blind) folded on the Turn
Seat 3: fe7c9e7a (big blind) folded before Flop
Seat 4: 7f427d6f folded before Flop (didn't bet)
Seat 5: afa5143c folded before Flop (didn't bet)
Seat 6: 9c511c89 folded before Flop (didn't bet)


Poker Hand #RC94793316: Hold'em No Limit ($0.1/$0.25) - 2020/04/06 23:27:42
Table 'RushAndCash319125' 6-max Seat #1 is the button
Seat 1: 5543ad42 ($25.98 in chips)
Seat 2: eeae3d7 ($12.3 in chips)
Seat 3: 3f7e31d ($24.07 in chips)
Seat 4: ff501d94 ($14.12 in chips)
Seat 5: Hero ($31.72 in chips)
Seat 6: 8f2f88a4 ($43.61 in chips)
eeae3d7: posts small blind $0.1
3f7e31d: posts big blind $0.25
*** HOLE CARDS ***
Dealt to 5543ad42 
Dealt to eeae3d7 
Dealt to 3f7e31d 
Dealt to ff501d94 
Dealt to Hero [Ad 4c]
Dealt to 8f2f88a4 
ff501d94: folds
Hero: folds
8f2f88a4: folds
5543ad42: raises $0.38 to $0.63
eeae3d7: folds
3f7e31d: folds
Uncalled bet ($0.38) returned to 5543ad42
*** SHOWDOWN ***
5543ad42 collected $0.6 from pot
*** SUMMARY ***
Total pot $0.6
Seat 1: 5543ad42 (button) collected ($0.6)
Seat 2: eeae3d7 (small blind) folded before Flop
Seat 3: 3f7e31d (big blind) folded before Flop
Seat 4: ff501d94 folded before Flop (didn't bet)
Seat 5: Hero folded before Flop (didn't bet)
Seat 6: 8f2f88a4 folded before Flop (didn't bet)


Poker Hand #RC94793337: Hold'em No Limit ($0.1/$0.25) - 2020/04/06 23:27:45
Table 'RushAndCash319129' 6-max Seat #1 is the button
Seat 1: 969ce17 ($27 in chips)
Seat 2: b3d703ab ($14.2 in chips)
Seat 3: ff501d94 ($14.12 in chips)
Seat 4: 8466ae26 ($25 in chips)
Seat 5: 58b04451 ($30.12 in chips)
Seat 6: Hero ($31.72 in chips)
b3d703ab: posts small blind $0.1
ff501d94: posts big blind $0.25
*** HOLE CARDS ***
Dealt to 969ce17 
Dealt to b3d703ab 
Dealt to ff501d94 
Dealt to 8466ae26 
Dealt to 58b04451 
Dealt to Hero [Ts 3s]
8466ae26: folds
58b04451: folds
Hero: folds
969ce17: folds
b3d703ab: folds
Uncalled bet ($0.15) returned to ff501d94
*** SHOWDOWN ***
ff501d94 collected $0.2 from pot
*** SUMMARY ***
Total pot $0.2
Seat 1: 969ce17 (button) folded before Flop (didn't bet)
Seat 2: b3d703ab (small blind) folded before Flop
Seat 3: ff501d94 (big blind) collected ($0.2)
Seat 4: 8466ae26 folded before Flop (didn't bet)
Seat 5: 58b04451 folded before Flop (didn't bet)
Seat 6: Hero folded before Flop (didn't bet)


Poker Hand #RC94793351: Hold'em No Limit ($0.1/$0.25) - 2020/04/06 23:27:48
Table 'RushAndCash319131' 6-max Seat #1 is the button
Seat 1: 72fa991e ($29.81 in chips)
Seat 2: 8f2f88a4 ($43.61 in chips)
Seat 3: fe7c9e7a ($25.25 in chips)
Seat 4: 1d6fff9c ($25 in chips)
Seat 5: Hero ($31.72 in chips)
Seat 6: 8abd2614 ($12.5 in chips)
8f2f88a4: posts small blind $0.1
fe7c9e7a: posts big blind $0.25
*** HOLE CARDS ***
Dealt to 72fa991e 
Dealt to 8f2f88a4 
Dealt to fe7c9e7a 
Dealt to 1d6fff9c 
Dealt to Hero [9s 7h]
Dealt to 8abd2614 
1d6fff9c: folds
Hero: folds
8abd2614: folds
72fa991e: raises $0.38 to $0.63
8f2f88a4: folds
fe7c9e7a: folds
Uncalled bet ($0.38) returned to 72fa991e
*** SHOWDOWN ***
72fa991e collected $0.6 from pot
*** SUMMARY ***
Total pot $0.6
Seat 1: 72fa991e (button) collected ($0.6)
Seat 2: 8f2f88a4 (small blind) folded before Flop
Seat 3: fe7c9e7a (big blind) folded before Flop
Seat 4: 1d6fff9c folded before Flop (didn't bet)
Seat 5: Hero folded before Flop (didn't bet)
Seat 6: 8abd2614 folded before Flop (didn't bet)


Poker Hand #RC94793436: Hold'em No Limit ($0.1/$0.25) - 2020/04/06 23:28:04
Table 'RushAndCash319144' 6-max Seat #1 is the button
Seat 1: a3949718 ($11.65 in chips)
Seat 2: f83dd98d ($26.69 in chips)
Seat 3: Hero ($31.72 in chips)
Seat 4: bd6eeaf3 ($50.42 in chips)
Seat 5: dfcfe0b3 ($25 in chips)
Seat 6: 8fb93df3 ($35.19 in chips)
f83dd98d: posts small blind $0.1
Hero: posts big blind $0.25
*** HOLE CARDS ***
Dealt to a3949718 
Dealt to f83dd98d 
Dealt to Hero [Kd 8c]
Dealt to bd6eeaf3 
Dealt to dfcfe0b3 
Dealt to 8fb93df3 
bd6eeaf3: folds
dfcfe0b3: folds
8fb93df3: folds
a3949718: raises $0.25 to $0.5
f83dd98d: folds
Hero: folds
Uncalled bet ($0.25) returned to a3949718
*** SHOWDOWN ***
a3949718 collected $0.6 from pot
*** SUMMARY ***
Total pot $0.6
Seat 1: a3949718 (button) collected ($0.6)
Seat 2: f83dd98d (small blind) folded before Flop
Seat 3: Hero (big blind) folded before Flop
Seat 4: bd6eeaf3 folded before Flop (didn't bet)
Seat 5: dfcfe0b3 folded before Flop (didn't bet)
Seat 6: 8fb93df3 folded before Flop (didn't bet)


Poker Hand #RC94793461: Hold'em No Limit ($0.1/$0.25) - 2020/04/06 23:28:09
Table 'RushAndCash319148' 6-max Seat #1 is the button
Seat 1: ca69da65 ($38.31 in chips)
Seat 2: b9bbf733 ($32.77 in chips)
Seat 3: d13258d2 ($6.41 in chips)
Seat 4: Hero ($31.47 in chips)
Seat 5: 17480666 ($102.63 in chips)
Seat 6: dfcfe0b3 ($25 in chips)
b9bbf733: posts small blind $0.1
d13258d2: posts big blind $0.25
*** HOLE CARDS ***
Dealt to ca69da65 
Dealt to b9bbf733 
Dealt to d13258d2 
Dealt to Hero [Ts 7d]
Dealt to 17480666 
Dealt to dfcfe0b3 
Hero: folds
17480666: folds
dfcfe0b3: folds
ca69da65: folds
b9bbf733: folds
Uncalled bet ($0.15) returned to d13258d2
*** SHOWDOWN ***
d13258d2 collected $0.2 from pot
*** SUMMARY ***
Total pot $0.2
Seat 1: ca69da65 (button) folded before Flop (didn't bet)
Seat 2: b9bbf733 (small blind) folded before Flop
Seat 3: d13258d2 (big blind) collected ($0.2)
Seat 4: Hero folded before Flop (didn't bet)
Seat 5: 17480666 folded before Flop (didn't bet)
Seat 6: dfcfe0b3 folded before Flop (didn't bet)


Poker Hand #RC94793480: Hold'em No Limit ($0.1/$0.25) - 2020/04/06 23:28:12
Table 'RushAndCash319151' 6-max Seat #1 is the button
Seat 1: 99d6d386 ($25 in chips)
Seat 2: 9c511c89 ($12.5 in chips)
Seat 3: Hero ($31.47 in chips)
Seat 4: d7f99a39 ($2.26 in chips)
Seat 5: f38f7769 ($28.97 in chips)
Seat 6: dfcfe0b3 ($25 in chips)
9c511c89: posts small blind $0.1
Hero: posts big blind $0.25
*** HOLE CARDS ***
Dealt to 99d6d386 
Dealt to 9c511c89 
Dealt to Hero [9d 4s]
Dealt to d7f99a39 
Dealt to f38f7769 
Dealt to dfcfe0b3 
d7f99a39: folds
f38f7769: folds
dfcfe0b3: raises $0.38 to $0.63
99d6d386: folds
9c511c89: folds
Hero: folds
Uncalled bet ($0.38) returned to dfcfe0b3
*** SHOWDOWN ***
dfcfe0b3 collected $0.6 from pot
*** SUMMARY ***
Total pot $0.6
Seat 1: 99d6d386 (button) folded before Flop (didn't bet)
Seat 2: 9c511c89 (small blind) folded before Flop
Seat 3: Hero (big blind) folded before Flop
Seat 4: d7f99a39 folded before Flop (didn't bet)
Seat 5: f38f7769 folded before Flop (didn't bet)
Seat 6: dfcfe0b3 collected ($0.6)


Poker Hand #RC94793520: Hold'em No Limit ($0.1/$0.25) - 2020/04/06 23:28:20
Table 'RushAndCash319157' 6-max Seat #1 is the button
Seat 1: b9bbf733 ($32.67 in chips)
Seat 2: Hero ($31.22 in chips)
Seat 3: b3d703ab ($13.6 in chips)
Seat 4: 99d6d386 ($25 in chips)
Seat 5: e58da42d ($34.33 in chips)
Seat 6: a82639fc ($25.35 in chips)
Hero: posts small blind $0.1
b3d703ab: posts big blind $0.25
*** HOLE CARDS ***
Dealt to b9bbf733 
Dealt to Hero [Kc 6c]
Dealt to b3d703ab 
Dealt to 99d6d386 
Dealt to e58da42d 
Dealt to a82639fc 
99d6d386: folds
e58da42d: folds
a82639fc: folds
b9bbf733: raises $0.25 to $0.5
Hero: folds
b3d703ab: folds
Uncalled bet ($0.25) returned to b9bbf733
*** SHOWDOWN ***
b9bbf733 collected $0.6 from pot
*** SUMMARY ***
Total pot $0.6
Seat 1: b9bbf733 (button) collected ($0.6)
Seat 2: Hero (small blind) folded before Flop
Seat 3: b3d703ab (big blind) folded before Flop
Seat 4: 99d6d386 folded before Flop (didn't bet)
Seat 5: e58da42d folded before Flop (didn't bet)
Seat 6: a82639fc folded before Flop (didn't bet)


Poker Hand #RC94793542: Hold'em No Limit ($0.1/$0.25) - 2020/04/06 23:28:24
Table 'RushAndCash319161' 6-max Seat #1 is the button
Seat 1: Hero ($31.12 in chips)
Seat 2: 22449dd4 ($34.59 in chips)
Seat 3: f4e2b370 ($14.28 in chips)
Seat 4: d13258d2 ($6.51 in chips)
Seat 5: 41459cc9 ($27.5 in chips)
Seat 6: e58da42d ($34.33 in chips)
22449dd4: posts small blind $0.1
f4e2b370: posts big blind $0.25
*** HOLE CARDS ***
Dealt to Hero [Ah 8s]
Dealt to 22449dd4 
Dealt to f4e2b370 
Dealt to d13258d2 
Dealt to 41459cc9 
Dealt to e58da42d 
d13258d2: folds
41459cc9: folds
e58da42d: folds
Hero: folds
22449dd4: folds
Uncalled bet ($0.15) returned to f4e2b370
*** SHOWDOWN ***
f4e2b370 collected $0.2 from pot
*** SUMMARY ***
Total pot $0.2
Seat 1: Hero (button) folded before Flop (didn't bet)
Seat 2: 22449dd4 (small blind) folded before Flop
Seat 3: f4e2b370 (big blind) collected ($0.2)
Seat 4: d13258d2 folded before Flop (didn't bet)
Seat 5: 41459cc9 folded before Flop (didn't bet)
Seat 6: e58da42d folded before Flop (didn't bet)


Poker Hand #RC94793560: Hold'em No Limit ($0.1/$0.25) - 2020/04/06 23:28:27
Table 'RushAndCash319164' 6-max Seat #1 is the button
Seat 1: Hero ($31.12 in chips)
Seat 2: ca69da65 ($38.31 in chips)
Seat 3: d13258d2 ($6.51 in chips)
Seat 4: 8e166af5 ($25 in chips)
Seat 5: ff501d94 ($14.47 in chips)
Seat 6: f83dd98d ($26.59 in chips)
ca69da65: posts small blind $0.1
d13258d2: posts big blind $0.25
*** HOLE CARDS ***
Dealt to Hero [9h 5s]
Dealt to ca69da65 
Dealt to d13258d2 
Dealt to 8e166af5 
Dealt to ff501d94 
Dealt to f83dd98d 
8e166af5: raises $0.5 to $0.75
ff501d94: folds
f83dd98d: folds
Hero: folds
ca69da65: folds
d13258d2: raises $5.76 to $6.51 and is all-in
8e166af5: folds
Uncalled bet ($5.76) returned to d13258d2
*** SHOWDOWN ***
d13258d2 collected $1.6 from pot
*** SUMMARY ***
Total pot $1.6
Seat 1: Hero (button) folded before Flop (didn't bet)
Seat 2: ca69da65 (small blind) folded before Flop
Seat 3: d13258d2 (big blind) collected ($1.6)
Seat 4: 8e166af5 folded before Flop
Seat 5: ff501d94 folded before Flop (didn't bet)
Seat 6: f83dd98d folded before Flop (didn't bet)


Poker Hand #RC94793576: Hold'em No Limit ($0.1/$0.25) - 2020/04/06 23:28:32
Table 'RushAndCash319166' 6-max Seat #1 is the button
Seat 1: Hero ($31.12 in chips)
Seat 2: 8a31aea7 ($101.69 in chips)
Seat 3: bd6eeaf3 ($50.52 in chips)
Seat 4: 7bb17d1 ($7.06 in chips)
Seat 5: ff501d94 ($14.47 in chips)
Seat 6: 41459cc9 ($27.5 in chips)
8a31aea7: posts small blind $0.1
bd6eeaf3: posts big blind $0.25
*** HOLE CARDS ***
Dealt to Hero [Tc 8c]
Dealt to 8a31aea7 
Dealt to bd6eeaf3 
Dealt to 7bb17d1 
Dealt to ff501d94 
Dealt to 41459cc9 
7bb17d1: folds
ff501d94: folds
41459cc9: folds
Hero: raises $0.38 to $0.63
8a31aea7: folds
bd6eeaf3: folds
Uncalled bet ($0.38) returned to Hero
*** SHOWDOWN ***
Hero collected $0.6 from pot
*** SUMMARY ***
Total pot $0.6
Seat 1: Hero (button) collected ($0.6)
Seat 2: 8a31aea7 (small blind) folded before Flop
Seat 3: bd6eeaf3 (big blind) folded before Flop
Seat 4: 7bb17d1 folded before Flop (didn't bet)
Seat 5: ff501d94 folded before Flop (didn't bet)
Seat 6: 41459cc9 folded before Flop (didn't bet)


Poker Hand #RC94793685: Hold'em No Limit ($0.1/$0.25) - 2020/04/06 23:28:56
Table 'RushAndCash319183' 6-max Seat #1 is the button
Seat 1: ea5eba95 ($98.48 in chips)
Seat 2: 72fa991e ($29.91 in chips)
Seat 3: 17480666 ($103.54 in chips)
Seat 4: 2467bb49 ($55.24 in chips)
Seat 5: Hero ($31.47 in chips)
Seat 6: ff501d94 ($14.12 in chips)
72fa991e: posts small blind $0.1
17480666: posts big blind $0.25
*** HOLE CARDS ***
Dealt to ea5eba95 
Dealt to 72fa991e 
Dealt to 17480666 
Dealt to 2467bb49 
Dealt to Hero [Ts 7h]
Dealt to ff501d94 
2467bb49: folds
Hero: folds
ff501d94: folds
ea5eba95: folds
72fa991e: folds
Uncalled bet ($0.15) returned to 17480666
*** SHOWDOWN ***
17480666 collected $0.2 from pot
*** SUMMARY ***
Total pot $0.2
Seat 1: ea5eba95 (button) folded before Flop (didn't bet)
Seat 2: 72fa991e (small blind) folded before Flop
Seat 3: 17480666 (big blind) collected ($0.2)
Seat 4: 2467bb49 folded before Flop (didn't bet)
Seat 5: Hero folded before Flop (didn't bet)
Seat 6: ff501d94 folded before Flop (didn't bet)


Poker Hand #RC94793698: Hold'em No Limit ($0.1/$0.25) - 2020/04/06 23:28:59
Table 'RushAndCash319185' 6-max Seat #1 is the button
Seat 1: dfcfe0b3 ($25 in chips)
Seat 2: Hero ($31.47 in chips)
Seat 3: 604f36f0 ($18.02 in chips)
Seat 4: 9d598a03 ($53.39 in chips)
Seat 5: a3949718 ($12.35 in chips)
Seat 6: 969ce17 ($25 in chips)
Hero: posts small blind $0.1
604f36f0: posts big blind $0.25
*** HOLE CARDS ***
Dealt to dfcfe0b3 
Dealt to Hero [Jd 2d]
Dealt to 604f36f0 
Dealt to 9d598a03 
Dealt to a3949718 
Dealt to 969ce17 
9d598a03: folds
a3949718: folds
969ce17: folds
dfcfe0b3: folds
Hero: folds
Uncalled bet ($0.15) returned to 604f36f0
*** SHOWDOWN ***
604f36f0 collected $0.2 from pot
*** SUMMARY ***
Total pot $0.2
Seat 1: dfcfe0b3 (button) folded before Flop (didn't bet)
Seat 2: Hero (small blind) folded before Flop
Seat 3: 604f36f0 (big blind) collected ($0.2)
Seat 4: 9d598a03 folded before Flop (didn't bet)
Seat 5: a3949718 folded before Flop (didn't bet)
Seat 6: 969ce17 folded before Flop (didn't bet)


Poker Hand #RC94793757: Hold'em No Limit ($0.1/$0.25) - 2020/04/06 23:29:10
Table 'RushAndCash319199' 6-max Seat #1 is the button
Seat 1: 9d598a03 ($53.29 in chips)
Seat 2: bd6eeaf3 ($50.27 in chips)
Seat 3: Hero ($31.37 in chips)
Seat 4: 7f427d6f ($7.76 in chips)
Seat 5: dfcfe0b3 ($25 in chips)
Seat 6: 9c511c89 ($12.5 in chips)
bd6eeaf3: posts small blind $0.1
Hero: posts big blind $0.25
*** HOLE CARDS ***
Dealt to 9d598a03 
Dealt to bd6eeaf3 
Dealt to Hero [9c 5h]
Dealt to 7f427d6f 
Dealt to dfcfe0b3 
Dealt to 9c511c89 
7f427d6f: calls $0.25
dfcfe0b3: folds
9c511c89: folds
9d598a03: folds
bd6eeaf3: raises $1 to $1.25
Hero: folds
7f427d6f: folds
Uncalled bet ($1) returned to bd6eeaf3
*** SHOWDOWN ***
bd6eeaf3 collected $0.75 from pot
*** SUMMARY ***
Total pot $0.75
Seat 1: 9d598a03 (button) folded before Flop (didn't bet)
Seat 2: bd6eeaf3 (small blind) collected ($0.75)
Seat 3: Hero (big blind) folded before Flop
Seat 4: 7f427d6f folded before Flop
Seat 5: dfcfe0b3 folded before Flop (didn't bet)
Seat 6: 9c511c89 folded before Flop (didn't bet)


Poker Hand #RC94793776: Hold'em No Limit ($0.1/$0.25) - 2020/04/06 23:29:14
Table 'RushAndCash319203' 6-max Seat #1 is the button
Seat 1: 604f36f0 ($18.12 in chips)
Seat 2: dfcfe0b3 ($25 in chips)
Seat 3: 5e03da34 ($58.41 in chips)
Seat 4: Hero ($31.12 in chips)
Seat 5: fd369e31 ($57.15 in chips)
Seat 6: 522e695b ($10.09 in chips)
dfcfe0b3: posts small blind $0.1
5e03da34: posts big blind $0.25
*** HOLE CARDS ***
Dealt to 604f36f0 
Dealt to dfcfe0b3 
Dealt to 5e03da34 
Dealt to Hero [7d 6h]
Dealt to fd369e31 
Dealt to 522e695b 
Hero: folds
fd369e31: raises $0.38 to $0.63
522e695b: folds
604f36f0: folds
dfcfe0b3: folds
5e03da34: folds
Uncalled bet ($0.38) returned to fd369e31
*** SHOWDOWN ***
fd369e31 collected $0.6 from pot
*** SUMMARY ***
Total pot $0.6
Seat 1: 604f36f0 (button) folded before Flop (didn't bet)
Seat 2: dfcfe0b3 (small blind) folded before Flop
Seat 3: 5e03da34 (big blind) folded before Flop
Seat 4: Hero folded before Flop (didn't bet)
Seat 5: fd369e31 collected ($0.6)
Seat 6: 522e695b folded before Flop (didn't bet)


Poker Hand #RC94793825: Hold'em No Limit ($0.1/$0.25) - 2020/04/06 23:29:23
Table 'RushAndCash319212' 6-max Seat #1 is the button
Seat 1: Hero ($31.12 in chips)
Seat 2: d7f99a39 ($5.09 in chips)
Seat 3: 9afeb2a7 ($28.52 in chips)
Seat 4: 8466ae26 ($25.7 in chips)
Seat 5: 969ce17 ($25 in chips)
Seat 6: c5fcb0d3 ($28.48 in chips)
d7f99a39: posts small blind $0.1
9afeb2a7: posts big blind $0.25
*** HOLE CARDS ***
Dealt to Hero [3h 2d]
Dealt to d7f99a39 
Dealt to 9afeb2a7 
Dealt to 8466ae26 
Dealt to 969ce17 
Dealt to c5fcb0d3 
8466ae26: folds
969ce17: folds
c5fcb0d3: folds
Hero: folds
d7f99a39: folds
Uncalled bet ($0.15) returned to 9afeb2a7
*** SHOWDOWN ***
9afeb2a7 collected $0.2 from pot
*** SUMMARY ***
Total pot $0.2
Seat 1: Hero (button) folded before Flop (didn't bet)
Seat 2: d7f99a39 (small blind) folded before Flop
Seat 3: 9afeb2a7 (big blind) collected ($0.2)
Seat 4: 8466ae26 folded before Flop (didn't bet)
Seat 5: 969ce17 folded before Flop (didn't bet)
Seat 6: c5fcb0d3 folded before Flop (didn't bet)


Poker Hand #RC94793841: Hold'em No Limit ($0.1/$0.25) - 2020/04/06 23:29:26
Table 'RushAndCash319215' 6-max Seat #1 is the button
Seat 1: 8a31aea7 ($101.24 in chips)
Seat 2: Hero ($31.12 in chips)
Seat 3: 41ab7510 ($25 in chips)
Seat 4: f4e2b370 ($13.43 in chips)
Seat 5: cc4afcf8 ($13.28 in chips)
Seat 6: 7357eb2f ($26.82 in chips)
Hero: posts small blind $0.1
41ab7510: posts big blind $0.25
*** HOLE CARDS ***
Dealt to 8a31aea7 
Dealt to Hero [Jh 2c]
Dealt to 41ab7510 
Dealt to f4e2b370 
Dealt to cc4afcf8 
Dealt to 7357eb2f 
f4e2b370: folds
cc4afcf8: folds
7357eb2f: raises $0.38 to $0.63
8a31aea7: raises $1.38 to $2.01
Hero: folds
41ab7510: folds
7357eb2f: calls $1.38
*** FLOP *** [5c Ac Td]
7357eb2f: checks
8a31aea7: bets $1.5
7357eb2f: calls $1.5
*** TURN *** [5c Ac Td] [8d]
7357eb2f: checks
8a31aea7: bets $5.6
7357eb2f: calls $5.6
*** RIVER *** [5c Ac Td 8d] [6h]
7357eb2f: checks
8a31aea7: bets $24
7357eb2f: calls $17.71 and is all-in
Uncalled bet ($6.29) returned to 8a31aea7
8a31aea7: shows [Ks Qs] (Ace-High)
7357eb2f: shows [Tc Kc] (Pair of Tens)
*** SHOWDOWN ***
7357eb2f collected $53.99 from pot
*** SUMMARY ***
Total pot $53.99
Board [5c Ac Td 8d 6h]
Seat 1: 8a31aea7 (button) showed [Ks Qs] and lost with Ace-High
Seat 2: Hero (small blind) folded before Flop
Seat 3: 41ab7510 (big blind) folded before Flop
Seat 4: f4e2b370 folded before Flop (didn't bet)
Seat 5: cc4afcf8 folded before Flop (didn't bet)
Seat 6: 7357eb2f showed [Kc Tc] and won ($53.99) with Pair of Tens


Poker Hand #RC94793891: Hold'em No Limit ($0.1/$0.25) - 2020/04/06 23:29:36
Table 'RushAndCash319222' 6-max Seat #1 is the button
Seat 1: a82639fc ($25 in chips)
Seat 2: 969ce17 ($25 in chips)
Seat 3: 22449dd4 ($35.79 in chips)
Seat 4: d7f99a39 ($4.99 in chips)
Seat 5: Hero ($31.02 in chips)
Seat 6: 604f36f0 ($18.02 in chips)
969ce17: posts small blind $0.1
22449dd4: posts big blind $0.25
*** HOLE CARDS ***
Dealt to a82639fc 
Dealt to 969ce17 
Dealt to 22449dd4 
Dealt to d7f99a39 
Dealt to Hero [Ts 5s]
Dealt to 604f36f0 
d7f99a39: folds
Hero: folds
604f36f0: raises $0.5 to $0.75
a82639fc: raises $1.65 to $2.4
969ce17: folds
22449dd4: folds
604f36f0: folds
Uncalled bet ($1.65) returned to a82639fc
*** SHOWDOWN ***
a82639fc collected $1.85 from pot
*** SUMMARY ***
Total pot $1.85
Seat 1: a82639fc (button) collected ($1.85)
Seat 2: 969ce17 (small blind) folded before Flop
Seat 3: 22449dd4 (big blind) folded before Flop
Seat 4: d7f99a39 folded before Flop (didn't bet)
Seat 5: Hero folded before Flop (didn't bet)
Seat 6: 604f36f0 folded before Flop


Poker Hand #RC94793913: Hold'em No Limit ($0.1/$0.25) - 2020/04/06 23:29:40
Table 'RushAndCash319225' 6-max Seat #1 is the button
Seat 1: fd369e31 ($57.5 in chips)
Seat 2: eeae3d7 ($11.45 in chips)
Seat 3: Hero ($31.02 in chips)
Seat 4: b00dbb18 ($30.68 in chips)
Seat 5: 99d6d386 ($25.93 in chips)
Seat 6: d8a224aa ($33.6 in chips)
eeae3d7: posts small blind $0.1
Hero: posts big blind $0.25
*** HOLE CARDS ***
Dealt to fd369e31 
Dealt to eeae3d7 
Dealt to Hero [Ac Jc]
Dealt to b00dbb18 
Dealt to 99d6d386 
Dealt to d8a224aa 
b00dbb18: folds
99d6d386: folds
d8a224aa: folds
fd369e31: folds
eeae3d7: folds
Uncalled bet ($0.15) returned to Hero
*** SHOWDOWN ***
Hero collected $0.2 from pot
*** SUMMARY ***
Total pot $0.2
Seat 1: fd369e31 (button) folded before Flop (didn't bet)
Seat 2: eeae3d7 (small blind) folded before Flop
Seat 3: Hero (big blind) collected ($0.2)
Seat 4: b00dbb18 folded before Flop (didn't bet)
Seat 5: 99d6d386 folded before Flop (didn't bet)
Seat 6: d8a224aa folded before Flop (didn't bet)


Poker Hand #RC94793999: Hold'em No Limit ($0.1/$0.25) - 2020/04/06 23:29:58
Table 'RushAndCash319239' 6-max Seat #1 is the button
Seat 1: b215699c ($65.23 in chips)
Seat 2: d13258d2 ($13.43 in chips)
Seat 3: 22449dd4 ($35.54 in chips)
Seat 4: 312f6846 ($25 in chips)
Seat 5: 969ce17 ($25 in chips)
Seat 6: Hero ($31.12 in chips)
d13258d2: posts small blind $0.1
22449dd4: posts big blind $0.25
*** HOLE CARDS ***
Dealt to b215699c 
Dealt to d13258d2 
Dealt to 22449dd4 
Dealt to 312f6846 
Dealt to 969ce17 
Dealt to Hero [Kc Th]
312f6846: folds
969ce17: raises $0.5 to $0.75
Hero: folds
b215699c: folds
d13258d2: folds
22449dd4: folds
Uncalled bet ($0.5) returned to 969ce17
*** SHOWDOWN ***
969ce17 collected $0.6 from pot
*** SUMMARY ***
Total pot $0.6
Seat 1: b215699c (button) folded before Flop (didn't bet)
Seat 2: d13258d2 (small blind) folded before Flop
Seat 3: 22449dd4 (big blind) folded before Flop
Seat 4: 312f6846 folded before Flop (didn't bet)
Seat 5: 969ce17 collected ($0.6)
Seat 6: Hero folded before Flop (didn't bet)


Poker Hand #RC94794032: Hold'em No Limit ($0.1/$0.25) - 2020/04/06 23:30:05
Table 'RushAndCash319244' 6-max Seat #1 is the button
Seat 1: fe7c9e7a ($25 in chips)
Seat 2: b215699c ($65.23 in chips)
Seat 3: bc200877 ($12.71 in chips)
Seat 4: Hero ($31.12 in chips)
Seat 5: 312f6846 ($25 in chips)
Seat 6: 604f36f0 ($17.27 in chips)
b215699c: posts small blind $0.1
bc200877: posts big blind $0.25
*** HOLE CARDS ***
Dealt to fe7c9e7a 
Dealt to b215699c 
Dealt to bc200877 
Dealt to Hero [4s 2s]
Dealt to 312f6846 
Dealt to 604f36f0 
Hero: folds
312f6846: folds
604f36f0: folds
fe7c9e7a: raises $0.5 to $0.75
b215699c: folds
bc200877: folds
Uncalled bet ($0.5) returned to fe7c9e7a
*** SHOWDOWN ***
fe7c9e7a collected $0.6 from pot
*** SUMMARY ***
Total pot $0.6
Seat 1: fe7c9e7a (button) collected ($0.6)
Seat 2: b215699c (small blind) folded before Flop
Seat 3: bc200877 (big blind) folded before Flop
Seat 4: Hero folded before Flop (didn't bet)
Seat 5: 312f6846 folded before Flop (didn't bet)
Seat 6: 604f36f0 folded before Flop (didn't bet)


Poker Hand #RC94794050: Hold'em No Limit ($0.1/$0.25) - 2020/04/06 23:30:09
Table 'RushAndCash319248' 6-max Seat #1 is the button
Seat 1: b9bbf733 ($32.67 in chips)
Seat 2: Hero ($31.12 in chips)
Seat 3: 604f36f0 ($17.27 in chips)
Seat 4: d7bbc6af ($27.87 in chips)
Seat 5: dfcfe0b3 ($25 in chips)
Seat 6: a82639fc ($26.01 in chips)
Hero: posts small blind $0.1
604f36f0: posts big blind $0.25
*** HOLE CARDS ***
Dealt to b9bbf733 
Dealt to Hero [6c 2d]
Dealt to 604f36f0 
Dealt to d7bbc6af 
Dealt to dfcfe0b3 
Dealt to a82639fc 
d7bbc6af: folds
dfcfe0b3: folds
a82639fc: folds
b9bbf733: raises $0.25 to $0.5
Hero: folds
604f36f0: folds
Uncalled bet ($0.25) returned to b9bbf733
*** SHOWDOWN ***
b9bbf733 collected $0.6 from pot
*** SUMMARY ***
Total pot $0.6
Seat 1: b9bbf733 (button) collected ($0.6)
Seat 2: Hero (small blind) folded before Flop
Seat 3: 604f36f0 (big blind) folded before Flop
Seat 4: d7bbc6af folded before Flop (didn't bet)
Seat 5: dfcfe0b3 folded before Flop (didn't bet)
Seat 6: a82639fc folded before Flop (didn't bet)


Poker Hand #RC94794076: Hold'em No Limit ($0.1/$0.25) - 2020/04/06 23:30:13
Table 'RushAndCash319253' 6-max Seat #1 is the button
Seat 1: 72fa991e ($30.71 in chips)
Seat 2: 107baea2 ($22.28 in chips)
Seat 3: 9c511c89 ($13.19 in chips)
Seat 4: 94efc628 ($28.94 in chips)
Seat 5: Hero ($31.02 in chips)
Seat 6: a82639fc ($26.01 in chips)
107baea2: posts small blind $0.1
9c511c89: posts big blind $0.25
*** HOLE CARDS ***
Dealt to 72fa991e 
Dealt to 107baea2 
Dealt to 9c511c89 
Dealt to 94efc628 
Dealt to Hero [9s 5d]
Dealt to a82639fc 
94efc628: raises $0.38 to $0.63
Hero: folds
a82639fc: folds
72fa991e: folds
107baea2: calls $0.53
9c511c89: folds
*** FLOP *** [Kc 6d Qd]
107baea2: checks
94efc628: bets $0.8
107baea2: calls $0.8
*** TURN *** [Kc 6d Qd] [4d]
107baea2: bets $1.6
94efc628: calls $1.6
*** RIVER *** [Kc 6d Qd 4d] [7h]
107baea2: bets $4.8
94efc628: calls $4.8
107baea2: shows [Ts Ks] (Pair of Kings)
94efc628: shows [Qh Qs] (Three Queens)
*** SHOWDOWN ***
94efc628 collected $15.91 from pot
*** SUMMARY ***
Total pot $15.91
Board [Kc 6d Qd 4d 7h]
Seat 1: 72fa991e (button) folded before Flop (didn't bet)
Seat 2: 107baea2 (small blind) showed [Ks Ts] and lost with Pair of Kings
Seat 3: 9c511c89 (big blind) folded before Flop
Seat 4: 94efc628 showed [Qs Qh] and won ($15.91) with Three Queens
Seat 5: Hero folded before Flop (didn't bet)
Seat 6: a82639fc folded before Flop (didn't bet)


Poker Hand #RC94794104: Hold'em No Limit ($0.1/$0.25) - 2020/04/06 23:30:19
Table 'RushAndCash319258' 6-max Seat #1 is the button
Seat 1: 41ab7510 ($25.1 in chips)
Seat 2: 8466ae26 ($25.1 in chips)
Seat 3: 99d6d386 ($26.28 in chips)
Seat 4: 8abd2614 ($12.85 in chips)
Seat 5: d7f99a39 ($4.36 in chips)
Seat 6: Hero ($31.02 in chips)
8466ae26: posts small blind $0.1
99d6d386: posts big blind $0.25
*** HOLE CARDS ***
Dealt to 41ab7510 
Dealt to 8466ae26 
Dealt to 99d6d386 
Dealt to 8abd2614 
Dealt to d7f99a39 
Dealt to Hero [Qc 4s]
8abd2614: folds
d7f99a39: folds
Hero: folds
41ab7510: raises $0.38 to $0.63
8466ae26: folds
99d6d386: folds
Uncalled bet ($0.38) returned to 41ab7510
*** SHOWDOWN ***
41ab7510 collected $0.6 from pot
*** SUMMARY ***
Total pot $0.6
Seat 1: 41ab7510 (button) collected ($0.6)
Seat 2: 8466ae26 (small blind) folded before Flop
Seat 3: 99d6d386 (big blind) folded before Flop
Seat 4: 8abd2614 folded before Flop (didn't bet)
Seat 5: d7f99a39 folded before Flop (didn't bet)
Seat 6: Hero folded before Flop (didn't bet)


Poker Hand #RC94794121: Hold'em No Limit ($0.1/$0.25) - 2020/04/06 23:30:23
Table 'RushAndCash319261' 6-max Seat #1 is the button
Seat 1: 9d598a03 ($52.41 in chips)
Seat 2: 8f2f88a4 ($44.06 in chips)
Seat 3: cf8c7400 ($25 in chips)
Seat 4: d13258d2 ($13.33 in chips)
Seat 5: 969ce17 ($25.35 in chips)
Seat 6: Hero ($31.02 in chips)
8f2f88a4: posts small blind $0.1
cf8c7400: posts big blind $0.25
*** HOLE CARDS ***
Dealt to 9d598a03 
Dealt to 8f2f88a4 
Dealt to cf8c7400 
Dealt to d13258d2 
Dealt to 969ce17 
Dealt to Hero [9c 4h]
d13258d2: folds
969ce17: folds
Hero: folds
9d598a03: folds
8f2f88a4: raises $0.5 to $0.75
cf8c7400: calls $0.5
*** FLOP *** [7d 5c 4c]
8f2f88a4: checks
cf8c7400: bets $0.8
8f2f88a4: calls $0.8
*** TURN *** [7d 5c 4c] [Kd]
8f2f88a4: checks
cf8c7400: bets $2
8f2f88a4: calls $2
*** RIVER *** [7d 5c 4c Kd] [Qs]
8f2f88a4: checks
cf8c7400: bets $3.8
8f2f88a4: calls $3.8
cf8c7400: shows [Ad 6h] (Ace-High)
8f2f88a4: shows [Kc 9s] (Pair of Kings)
*** SHOWDOWN ***
8f2f88a4 collected $14.7 from pot
*** SUMMARY ***
Total pot $14.7
Board [7d 5c 4c Kd Qs]
Seat 1: 9d598a03 (button) folded before Flop (didn't bet)
Seat 2: 8f2f88a4 (small blind) showed [Kc 9s] and won ($14.7) with Pair of Kings
Seat 3: cf8c7400 (big blind) showed [Ad 6h] and lost with Ace-High
Seat 4: d13258d2 folded before Flop (didn't bet)
Seat 5: 969ce17 folded before Flop (didn't bet)
Seat 6: Hero folded before Flop (didn't bet)


Poker Hand #RC94794143: Hold'em No Limit ($0.1/$0.25) - 2020/04/06 23:30:27
Table 'RushAndCash319265' 6-max Seat #1 is the button
Seat 1: d7bbc6af ($27.87 in chips)
Seat 2: e64b2cd5 ($12.5 in chips)
Seat 3: d7f99a39 ($4.36 in chips)
Seat 4: 9d598a03 ($52.41 in chips)
Seat 5: Hero ($31.02 in chips)
Seat 6: 969ce17 ($25.35 in chips)
e64b2cd5: posts small blind $0.1
d7f99a39: posts big blind $0.25
*** HOLE CARDS ***
Dealt to d7bbc6af 
Dealt to e64b2cd5 
Dealt to d7f99a39 
Dealt to 9d598a03 
Dealt to Hero [Jc 8h]
Dealt to 969ce17 
9d598a03: folds
Hero: folds
969ce17: folds
d7bbc6af: folds
e64b2cd5: folds
Uncalled bet ($0.15) returned to d7f99a39
*** SHOWDOWN ***
d7f99a39 collected $0.2 from pot
*** SUMMARY ***
Total pot $0.2
Seat 1: d7bbc6af (button) folded before Flop (didn't bet)
Seat 2: e64b2cd5 (small blind) folded before Flop
Seat 3: d7f99a39 (big blind) collected ($0.2)
Seat 4: 9d598a03 folded before Flop (didn't bet)
Seat 5: Hero folded before Flop (didn't bet)
Seat 6: 969ce17 folded before Flop (didn't bet)


Poker Hand #RC94794164: Hold'em No Limit ($0.1/$0.25) - 2020/04/06 23:30:32
Table 'RushAndCash319268' 6-max Seat #1 is the button
Seat 1: 5e03da34 ($59.32 in chips)
Seat 2: 8fb93df3 ($36.19 in chips)
Seat 3: d7bbc6af ($27.87 in chips)
Seat 4: e64b2cd5 ($12.5 in chips)
Seat 5: Hero ($31.02 in chips)
Seat 6: e767af3b ($30.29 in chips)
8fb93df3: posts small blind $0.1
d7bbc6af: posts big blind $0.25
*** HOLE CARDS ***
Dealt to 5e03da34 
Dealt to 8fb93df3 
Dealt to d7bbc6af 
Dealt to e64b2cd5 
Dealt to Hero [8s 7h]
Dealt to e767af3b 
e64b2cd5: folds
Hero: folds
e767af3b: raises $0.5 to $0.75
5e03da34: folds
8fb93df3: folds
d7bbc6af: folds
Uncalled bet ($0.5) returned to e767af3b
*** SHOWDOWN ***
e767af3b collected $0.6 from pot
*** SUMMARY ***
Total pot $0.6
Seat 1: 5e03da34 (button) folded before Flop (didn't bet)
Seat 2: 8fb93df3 (small blind) folded before Flop
Seat 3: d7bbc6af (big blind) folded before Flop
Seat 4: e64b2cd5 folded before Flop (didn't bet)
Seat 5: Hero folded before Flop (didn't bet)
Seat 6: e767af3b collected ($0.6)


Poker Hand #RC94794184: Hold'em No Limit ($0.1/$0.25) - 2020/04/06 23:30:36
Table 'RushAndCash319271' 6-max Seat #1 is the button
Seat 1: 8abd2614 ($12.85 in chips)
Seat 2: 2467bb49 ($57.61 in chips)
Seat 3: Hero ($31.02 in chips)
Seat 4: e64b2cd5 ($12.5 in chips)
Seat 5: b3d703ab ($15.61 in chips)
Seat 6: 99d6d386 ($25.93 in chips)
2467bb49: posts small blind $0.1
Hero: posts big blind $0.25
*** HOLE CARDS ***
Dealt to 8abd2614 
Dealt to 2467bb49 
Dealt to Hero [Th 9d]
Dealt to e64b2cd5 
Dealt to b3d703ab 
Dealt to 99d6d386 
e64b2cd5: raises $0.5 to $0.75
b3d703ab: folds
99d6d386: folds
8abd2614: folds
2467bb49: folds
Hero: folds
Uncalled bet ($0.5) returned to e64b2cd5
*** SHOWDOWN ***
e64b2cd5 collected $0.6 from pot
*** SUMMARY ***
Total pot $0.6
Seat 1: 8abd2614 (button) folded before Flop (didn't bet)
Seat 2: 2467bb49 (small blind) folded before Flop
Seat 3: Hero (big blind) folded before Flop
Seat 4: e64b2cd5 collected ($0.6)
Seat 5: b3d703ab folded before Flop (didn't bet)
Seat 6: 99d6d386 folded before Flop (didn't bet)


Poker Hand #RC94794206: Hold'em No Limit ($0.1/$0.25) - 2020/04/06 23:30:41
Table 'RushAndCash319273' 6-max Seat #1 is the button
Seat 1: Hero ($30.77 in chips)
Seat 2: d13258d2 ($13.33 in chips)
Seat 3: 7f427d6f ($7.16 in chips)
Seat 4: ff501d94 ($13.42 in chips)
Seat 5: 38359122 ($15.13 in chips)
Seat 6: 99d6d386 ($25.93 in chips)
d13258d2: posts small blind $0.1
7f427d6f: posts big blind $0.25
*** HOLE CARDS ***
Dealt to Hero [Qc 4c]
Dealt to d13258d2 
Dealt to 7f427d6f 
Dealt to ff501d94 
Dealt to 38359122 
Dealt to 99d6d386 
ff501d94: folds
38359122: folds
99d6d386: folds
Hero: folds
d13258d2: folds
Uncalled bet ($0.15) returned to 7f427d6f
*** SHOWDOWN ***
7f427d6f collected $0.2 from pot
*** SUMMARY ***
Total pot $0.2
Seat 1: Hero (button) folded before Flop (didn't bet)
Seat 2: d13258d2 (small blind) folded before Flop
Seat 3: 7f427d6f (big blind) collected ($0.2)
Seat 4: ff501d94 folded before Flop (didn't bet)
Seat 5: 38359122 folded before Flop (didn't bet)
Seat 6: 99d6d386 folded before Flop (didn't bet)


Poker Hand #RC94794222: Hold'em No Limit ($0.1/$0.25) - 2020/04/06 23:30:45
Table 'RushAndCash319276' 6-max Seat #1 is the button
Seat 1: c0959605 ($12.5 in chips)
Seat 2: b3d703ab ($15.61 in chips)
Seat 3: fe7c9e7a ($26.76 in chips)
Seat 4: Hero ($30.77 in chips)
Seat 5: dfcfe0b3 ($25 in chips)
Seat 6: ca69da65 ($37.96 in chips)
b3d703ab: posts small blind $0.1
fe7c9e7a: posts big blind $0.25
*** HOLE CARDS ***
Dealt to c0959605 
Dealt to b3d703ab 
Dealt to fe7c9e7a 
Dealt to Hero [6d 2c]
Dealt to dfcfe0b3 
Dealt to ca69da65 
Hero: folds
dfcfe0b3: folds
ca69da65: folds
c0959605: folds
b3d703ab: folds
Uncalled bet ($0.15) returned to fe7c9e7a
*** SHOWDOWN ***
fe7c9e7a collected $0.2 from pot
*** SUMMARY ***
Total pot $0.2
Seat 1: c0959605 (button) folded before Flop (didn't bet)
Seat 2: b3d703ab (small blind) folded before Flop
Seat 3: fe7c9e7a (big blind) collected ($0.2)
Seat 4: Hero folded before Flop (didn't bet)
Seat 5: dfcfe0b3 folded before Flop (didn't bet)
Seat 6: ca69da65 folded before Flop (didn't bet)


Poker Hand #RC94794243: Hold'em No Limit ($0.1/$0.25) - 2020/04/06 23:30:49
Table 'RushAndCash319279' 6-max Seat #1 is the button
Seat 1: ba032eea ($58.2 in chips)
Seat 2: 8abd2614 ($12.6 in chips)
Seat 3: 99d6d386 ($25.93 in chips)
Seat 4: 72fa991e ($30.46 in chips)
Seat 5: Hero ($30.77 in chips)
Seat 6: d13258d2 ($13.23 in chips)
8abd2614: posts small blind $0.1
99d6d386: posts big blind $0.25
*** HOLE CARDS ***
Dealt to ba032eea 
Dealt to 8abd2614 
Dealt to 99d6d386 
Dealt to 72fa991e 
Dealt to Hero [8s 7c]
Dealt to d13258d2 
72fa991e: folds
Hero: folds
d13258d2: raises $0.38 to $0.63
ba032eea: folds
8abd2614: folds
99d6d386: calls $0.38
*** FLOP *** [Kd 8c 8d]
99d6d386: checks
d13258d2: bets $0.5
99d6d386: folds
Uncalled bet ($0.5) returned to d13258d2
*** SHOWDOWN ***
d13258d2 collected $1.36 from pot
*** SUMMARY ***
Total pot $1.36
Board [Kd 8c 8d]
Seat 1: ba032eea (button) folded before Flop (didn't bet)
Seat 2: 8abd2614 (small blind) folded before Flop
Seat 3: 99d6d386 (big blind) folded on the Flop
Seat 4: 72fa991e folded before Flop (didn't bet)
Seat 5: Hero folded before Flop (didn't bet)
Seat 6: d13258d2 won ($1.36)


Poker Hand #RC94794264: Hold'em No Limit ($0.1/$0.25) - 2020/04/06 23:30:54
Table 'RushAndCash319283' 6-max Seat #1 is the button
Seat 1: 1d6fff9c ($25.25 in chips)
Seat 2: Hero ($30.77 in chips)
Seat 3: b3d703ab ($15.51 in chips)
Seat 4: e0680a48 ($72.06 in chips)
Seat 5: 5e03da34 ($59.32 in chips)
Seat 6: 41ab7510 ($25.35 in chips)
Hero: posts small blind $0.1
b3d703ab: posts big blind $0.25
*** HOLE CARDS ***
Dealt to 1d6fff9c 
Dealt to Hero [9c 4c]
Dealt to b3d703ab 
Dealt to e0680a48 
Dealt to 5e03da34 
Dealt to 41ab7510 
e0680a48: raises $0.5 to $0.75
5e03da34: folds
41ab7510: folds
1d6fff9c: folds
Hero: folds
b3d703ab: folds
Uncalled bet ($0.5) returned to e0680a48
*** SHOWDOWN ***
e0680a48 collected $0.6 from pot
*** SUMMARY ***
Total pot $0.6
Seat 1: 1d6fff9c (button) folded before Flop (didn't bet)
Seat 2: Hero (small blind) folded before Flop
Seat 3: b3d703ab (big blind) folded before Flop
Seat 4: e0680a48 collected ($0.6)
Seat 5: 5e03da34 folded before Flop (didn't bet)
Seat 6: 41ab7510 folded before Flop (didn't bet)


Poker Hand #RC94794287: Hold'em No Limit ($0.1/$0.25) - 2020/04/06 23:30:59
Table 'RushAndCash319286' 6-max Seat #1 is the button
Seat 1: 90609fad ($25 in chips)
Seat 2: ba032eea ($58.2 in chips)
Seat 3: Hero ($30.67 in chips)
Seat 4: d8a224aa ($32.62 in chips)
Seat 5: cce649b7 ($24.96 in chips)
Seat 6: c63a382b ($26.92 in chips)
ba032eea: posts small blind $0.1
Hero: posts big blind $0.25
*** HOLE CARDS ***
Dealt to 90609fad 
Dealt to ba032eea 
Dealt to Hero [8h 6s]
Dealt to d8a224aa 
Dealt to cce649b7 
Dealt to c63a382b 
d8a224aa: folds
cce649b7: folds
c63a382b: folds
90609fad: folds
ba032eea: folds
Uncalled bet ($0.15) returned to Hero
*** SHOWDOWN ***
Hero collected $0.2 from pot
*** SUMMARY ***
Total pot $0.2
Seat 1: 90609fad (button) folded before Flop (didn't bet)
Seat 2: ba032eea (small blind) folded before Flop
Seat 3: Hero (big blind) collected ($0.2)
Seat 4: d8a224aa folded before Flop (didn't bet)
Seat 5: cce649b7 folded before Flop (didn't bet)
Seat 6: c63a382b folded before Flop (didn't bet)


Poker Hand #RC94794306: Hold'em No Limit ($0.1/$0.25) - 2020/04/06 23:31:03
Table 'RushAndCash319289' 6-max Seat #1 is the button
Seat 1: cce649b7 ($24.96 in chips)
Seat 2: bd6eeaf3 ($51.77 in chips)
Seat 3: e767af3b ($30.64 in chips)
Seat 4: bc200877 ($12.36 in chips)
Seat 5: Hero ($30.42 in chips)
Seat 6: d8a224aa ($32.62 in chips)
bd6eeaf3: posts small blind $0.1
e767af3b: posts big blind $0.25
*** HOLE CARDS ***
Dealt to cce649b7 
Dealt to bd6eeaf3 
Dealt to e767af3b 
Dealt to bc200877 
Dealt to Hero [Tc 7c]
Dealt to d8a224aa 
bc200877: raises $0.63 to $0.88
Hero: folds
d8a224aa: raises $1.62 to $2.5
cce649b7: folds
bd6eeaf3: folds
e767af3b: folds
bc200877: raises $1.62 to $4.12
d8a224aa: raises $28.5 to $32.62 and is all-in
bc200877: folds
Uncalled bet ($28.5) returned to d8a224aa
*** SHOWDOWN ***
d8a224aa collected $8.59 from pot
*** SUMMARY ***
Total pot $8.59
Seat 1: cce649b7 (button) folded before Flop (didn't bet)
Seat 2: bd6eeaf3 (small blind) folded before Flop
Seat 3: e767af3b (big blind) folded before Flop
Seat 4: bc200877 folded before Flop
Seat 5: Hero folded before Flop (didn't bet)
Seat 6: d8a224aa collected ($8.59)


Poker Hand #RC94794324: Hold'em No Limit ($0.1/$0.25) - 2020/04/06 23:31:06
Table 'RushAndCash319292' 6-max Seat #1 is the button
Seat 1: f4e2b370 ($17.21 in chips)
Seat 2: b9bbf733 ($33.02 in chips)
Seat 3: 41ab7510 ($25.35 in chips)
Seat 4: Hero ($30.42 in chips)
Seat 5: fe7c9e7a ($26.86 in chips)
Seat 6: 522e695b ($10.09 in chips)
b9bbf733: posts small blind $0.1
41ab7510: posts big blind $0.25
*** HOLE CARDS ***
Dealt to f4e2b370 
Dealt to b9bbf733 
Dealt to 41ab7510 
Dealt to Hero [8d 3d]
Dealt to fe7c9e7a 
Dealt to 522e695b 
Hero: folds
fe7c9e7a: folds
522e695b: raises $0.5 to $0.75
f4e2b370: folds
b9bbf733: folds
41ab7510: folds
Uncalled bet ($0.5) returned to 522e695b
*** SHOWDOWN ***
522e695b collected $0.6 from pot
*** SUMMARY ***
Total pot $0.6
Seat 1: f4e2b370 (button) folded before Flop (didn't bet)
Seat 2: b9bbf733 (small blind) folded before Flop
Seat 3: 41ab7510 (big blind) folded before Flop
Seat 4: Hero folded before Flop (didn't bet)
Seat 5: fe7c9e7a folded before Flop (didn't bet)
Seat 6: 522e695b collected ($0.6)


Poker Hand #RC94794353: Hold'em No Limit ($0.1/$0.25) - 2020/04/06 23:31:12
Table 'RushAndCash319296' 6-max Seat #1 is the button
Seat 1: cce649b7 ($24.96 in chips)
Seat 2: f99bdf7f ($25.35 in chips)
Seat 3: Hero ($30.42 in chips)
Seat 4: eeae3d7 ($10.1 in chips)
Seat 5: 312f6846 ($25 in chips)
Seat 6: fe7c9e7a ($26.86 in chips)
f99bdf7f: posts small blind $0.1
Hero: posts big blind $0.25
*** HOLE CARDS ***
Dealt to cce649b7 
Dealt to f99bdf7f 
Dealt to Hero [Qs 6d]
Dealt to eeae3d7 
Dealt to 312f6846 
Dealt to fe7c9e7a 
eeae3d7: folds
312f6846: folds
fe7c9e7a: raises $0.5 to $0.75
cce649b7: folds
f99bdf7f: calls $0.65
Hero: folds
*** FLOP *** [9d Jh 5h]
f99bdf7f: checks
fe7c9e7a: bets $1.2
f99bdf7f: folds
Uncalled bet ($1.2) returned to fe7c9e7a
*** SHOWDOWN ***
fe7c9e7a collected $1.75 from pot
*** SUMMARY ***
Total pot $1.75
Board [9d Jh 5h]
Seat 1: cce649b7 (button) folded before Flop (didn't bet)
Seat 2: f99bdf7f (small blind) folded on the Flop
Seat 3: Hero (big blind) folded before Flop
Seat 4: eeae3d7 folded before Flop (didn't bet)
Seat 5: 312f6846 folded before Flop (didn't bet)
Seat 6: fe7c9e7a won ($1.75)


Poker Hand #RC94794370: Hold'em No Limit ($0.1/$0.25) - 2020/04/06 23:31:16
Table 'RushAndCash319298' 6-max Seat #1 is the button
Seat 1: b3d703ab ($15.26 in chips)
Seat 2: e767af3b ($30.39 in chips)
Seat 3: 5e03da34 ($59.32 in chips)
Seat 4: Hero ($30.52 in chips)
Seat 5: f4e2b370 ($17.21 in chips)
Seat 6: e58da42d ($32.07 in chips)
e767af3b: posts small blind $0.1
5e03da34: posts big blind $0.25
*** HOLE CARDS ***
Dealt to b3d703ab 
Dealt to e767af3b 
Dealt to 5e03da34 
Dealt to Hero [Ad Jc]
Dealt to f4e2b370 
Dealt to e58da42d 
Hero: raises $0.38 to $0.63
f4e2b370: calls $0.63
e58da42d: folds
b3d703ab: raises $1.87 to $2.5
e767af3b: folds
5e03da34: folds
Hero: folds
f4e2b370: folds
Uncalled bet ($1.87) returned to b3d703ab
*** SHOWDOWN ***
b3d703ab collected $2.24 from pot
*** SUMMARY ***
Total pot $2.24
Seat 1: b3d703ab (button) collected ($2.24)
Seat 2: e767af3b (small blind) folded before Flop
Seat 3: 5e03da34 (big blind) folded before Flop
Seat 4: Hero folded before Flop
Seat 5: f4e2b370 folded before Flop
Seat 6: e58da42d folded before Flop (didn't bet)


Poker Hand #RC94794535: Hold'em No Limit ($0.1/$0.25) - 2020/04/06 23:31:48
Table 'RushAndCash319317' 6-max Seat #1 is the button
Seat 1: dfcfe0b3 ($25 in chips)
Seat 2: 3780c668 ($25 in chips)
Seat 3: 9c511c89 ($13.27 in chips)
Seat 4: 8a31aea7 ($74.42 in chips)
Seat 5: Hero ($29.89 in chips)
Seat 6: 8e166af5 ($25.08 in chips)
3780c668: posts small blind $0.1
9c511c89: posts big blind $0.25
*** HOLE CARDS ***
Dealt to dfcfe0b3 
Dealt to 3780c668 
Dealt to 9c511c89 
Dealt to 8a31aea7 
Dealt to Hero [9h 9d]
Dealt to 8e166af5 
8a31aea7: folds
Hero: raises $0.38 to $0.63
8e166af5: folds
dfcfe0b3: folds
3780c668: raises $2.28 to $2.91
9c511c89: folds
Hero: calls $2.28
*** FLOP *** [2s 6d Qc]
3780c668: bets $1.5
Hero: calls $1.5
*** TURN *** [2s 6d Qc] [Ts]
3780c668: checks
Hero: checks
*** RIVER *** [2s 6d Qc Ts] [As]
3780c668: checks
Hero: checks
3780c668: shows [Jc Jd] (Pair of Jacks)
Hero: shows [9d 9h] (Pair of Nines)
*** SHOWDOWN ***
3780c668 collected $9.07 from pot
*** SUMMARY ***
Total pot $9.07
Board [2s 6d Qc Ts As]
Seat 1: dfcfe0b3 (button) folded before Flop (didn't bet)
Seat 2: 3780c668 (small blind) showed [Jd Jc] and won ($9.07) with Pair of Jacks
Seat 3: 9c511c89 (big blind) folded before Flop
Seat 4: 8a31aea7 folded before Flop (didn't bet)
Seat 5: Hero showed [9h 9d] and lost with Pair of Nines
Seat 6: 8e166af5 folded before Flop (didn't bet)


Poker Hand #RC94794919: Hold'em No Limit ($0.1/$0.25) - 2020/04/06 23:33:10
Table 'RushAndCash319367' 6-max Seat #1 is the button
Seat 1: cce649b7 ($36.16 in chips)
Seat 2: Hero ($25.48 in chips)
Seat 3: 7bb17d1 ($5.36 in chips)
Seat 4: 312f6846 ($25 in chips)
Seat 5: b215699c ($63.99 in chips)
Seat 6: 9c511c89 ($14.88 in chips)
Hero: posts small blind $0.1
7bb17d1: posts big blind $0.25
*** HOLE CARDS ***
Dealt to cce649b7 
Dealt to Hero [Ah Tc]
Dealt to 7bb17d1 
Dealt to 312f6846 
Dealt to b215699c 
Dealt to 9c511c89 
312f6846: folds
b215699c: folds
9c511c89: raises $0.5 to $0.75
cce649b7: folds
Hero: folds
7bb17d1: folds
Uncalled bet ($0.5) returned to 9c511c89
*** SHOWDOWN ***
9c511c89 collected $0.6 from pot
*** SUMMARY ***
Total pot $0.6
Seat 1: cce649b7 (button) folded before Flop (didn't bet)
Seat 2: Hero (small blind) folded before Flop
Seat 3: 7bb17d1 (big blind) folded before Flop
Seat 4: 312f6846 folded before Flop (didn't bet)
Seat 5: b215699c folded before Flop (didn't bet)
Seat 6: 9c511c89 collected ($0.6)


Poker Hand #RC94794941: Hold'em No Limit ($0.1/$0.25) - 2020/04/06 23:33:14
Table 'RushAndCash319370' 6-max Seat #1 is the button
Seat 1: Hero ($25.38 in chips)
Seat 2: f99bdf7f ($19.64 in chips)
Seat 3: ea5eba95 ($98.35 in chips)
Seat 4: 312f6846 ($25 in chips)
Seat 5: 3780c668 ($28.96 in chips)
Seat 6: d7bbc6af ($28.19 in chips)
f99bdf7f: posts small blind $0.1
ea5eba95: posts big blind $0.25
*** HOLE CARDS ***
Dealt to Hero [Qd 7c]
Dealt to f99bdf7f 
Dealt to ea5eba95 
Dealt to 312f6846 
Dealt to 3780c668 
Dealt to d7bbc6af 
312f6846: folds
3780c668: raises $0.38 to $0.63
d7bbc6af: folds
Hero: folds
f99bdf7f: folds
ea5eba95: calls $0.38
*** FLOP *** [9c 3c 6d]
ea5eba95: checks
3780c668: checks
*** TURN *** [9c 3c 6d] [4c]
ea5eba95: checks
3780c668: checks
*** RIVER *** [9c 3c 6d 4c] [Ah]
ea5eba95: checks
3780c668: bets $1.1
ea5eba95: calls $1.1
3780c668: shows [Kd Ac] (Pair of Aces)
ea5eba95: shows [7s As] (Pair of Aces)
*** SHOWDOWN ***
3780c668 collected $3.56 from pot
*** SUMMARY ***
Total pot $3.56
Board [9c 3c 6d 4c Ah]
Seat 1: Hero (button) folded before Flop (didn't bet)
Seat 2: f99bdf7f (small blind) folded before Flop
Seat 3: ea5eba95 (big blind) showed [As 7s] and lost with Pair of Aces
Seat 4: 312f6846 folded before Flop (didn't bet)
Seat 5: 3780c668 showed [Ac Kd] and won ($3.56) with Pair of Aces
Seat 6: d7bbc6af folded before Flop (didn't bet)


Poker Hand #RC94794966: Hold'em No Limit ($0.1/$0.25) - 2020/04/06 23:33:20
Table 'RushAndCash319374' 6-max Seat #1 is the button
Seat 1: fe7c9e7a ($29.12 in chips)
Seat 2: Hero ($25.38 in chips)
Seat 3: 8fb93df3 ($38.17 in chips)
Seat 4: 2904eaa2 ($25 in chips)
Seat 5: d8a224aa ($36.06 in chips)
Seat 6: ba032eea ($58.45 in chips)
Hero: posts small blind $0.1
8fb93df3: posts big blind $0.25
*** HOLE CARDS ***
Dealt to fe7c9e7a 
Dealt to Hero [Qh Jd]
Dealt to 8fb93df3 
Dealt to 2904eaa2 
Dealt to d8a224aa 
Dealt to ba032eea 
2904eaa2: folds
d8a224aa: folds
ba032eea: folds
fe7c9e7a: folds
Hero: folds
Uncalled bet ($0.15) returned to 8fb93df3
*** SHOWDOWN ***
8fb93df3 collected $0.2 from pot
*** SUMMARY ***
Total pot $0.2
Seat 1: fe7c9e7a (button) folded before Flop (didn't bet)
Seat 2: Hero (small blind) folded before Flop
Seat 3: 8fb93df3 (big blind) collected ($0.2)
Seat 4: 2904eaa2 folded before Flop (didn't bet)
Seat 5: d8a224aa folded before Flop (didn't bet)
Seat 6: ba032eea folded before Flop (didn't bet)


Poker Hand #RC94794979: Hold'em No Limit ($0.1/$0.25) - 2020/04/06 23:33:24
Table 'RushAndCash319377' 6-max Seat #1 is the button
Seat 1: Hero ($25.28 in chips)
Seat 2: 94efc628 ($36.38 in chips)
Seat 3: ff501d94 ($14.41 in chips)
Seat 4: d8a224aa ($36.06 in chips)
Seat 5: bc200877 ($7.89 in chips)
Seat 6: f4e2b370 ($20.09 in chips)
94efc628: posts small blind $0.1
ff501d94: posts big blind $0.25
*** HOLE CARDS ***
Dealt to Hero [Kd Qc]
Dealt to 94efc628 
Dealt to ff501d94 
Dealt to d8a224aa 
Dealt to bc200877 
Dealt to f4e2b370 
d8a224aa: folds
bc200877: folds
f4e2b370: folds
Hero: raises $0.38 to $0.63
94efc628: folds
ff501d94: calls $0.38
*** FLOP *** [9d Js 4h]
ff501d94: checks
Hero: bets $0.5
ff501d94: calls $0.5
*** TURN *** [9d Js 4h] [9c]
ff501d94: checks
Hero: checks
*** RIVER *** [9d Js 4h 9c] [Qs]
ff501d94: checks
Hero: bets $1.8
ff501d94: calls $1.8
Hero: shows [Qc Kd] (Pair of Queens and Pair of Nines)
ff501d94: shows [Kh Jc] (Pair of Jacks and Pair of Nines)
*** SHOWDOWN ***
Hero collected $5.96 from pot
*** SUMMARY ***
Total pot $5.96
Board [9d Js 4h 9c Qs]
Seat 1: Hero (button) showed [Kd Qc] and won ($5.96) with Pair of Queens and Pair of Nines
Seat 2: 94efc628 (small blind) folded before Flop
Seat 3: ff501d94 (big blind) showed [Kh Jc] and lost with Pair of Jacks and Pair of Nines
Seat 4: d8a224aa folded before Flop (didn't bet)
Seat 5: bc200877 folded before Flop (didn't bet)
Seat 6: f4e2b370 folded before Flop (didn't bet)


Poker Hand #RC94795204: Hold'em No Limit ($0.1/$0.25) - 2020/04/06 23:34:11
Table 'RushAndCash319410' 6-max Seat #1 is the button
Seat 1: afa5143c ($34.06 in chips)
Seat 2: bc200877 ($7.64 in chips)
Seat 3: 969ce17 ($27.07 in chips)
Seat 4: Hero ($28.02 in chips)
Seat 5: ff501d94 ($11.49 in chips)
Seat 6: 1d6fff9c ($25 in chips)
bc200877: posts small blind $0.1
969ce17: posts big blind $0.25
*** HOLE CARDS ***
Dealt to afa5143c 
Dealt to bc200877 
Dealt to 969ce17 
Dealt to Hero [Js 3h]
Dealt to ff501d94 
Dealt to 1d6fff9c 
Hero: folds
ff501d94: raises $0.38 to $0.63
1d6fff9c: folds
afa5143c: folds
bc200877: folds
969ce17: folds
Uncalled bet ($0.38) returned to ff501d94
*** SHOWDOWN ***
ff501d94 collected $0.6 from pot
*** SUMMARY ***
Total pot $0.6
Seat 1: afa5143c (button) folded before Flop (didn't bet)
Seat 2: bc200877 (small blind) folded before Flop
Seat 3: 969ce17 (big blind) folded before Flop
Seat 4: Hero folded before Flop (didn't bet)
Seat 5: ff501d94 collected ($0.6)
Seat 6: 1d6fff9c folded before Flop (didn't bet)


Poker Hand #RC94795220: Hold'em No Limit ($0.1/$0.25) - 2020/04/06 23:34:14
Table 'RushAndCash319413' 6-max Seat #1 is the button
Seat 1: 38359122 ($14.78 in chips)
Seat 2: 8e166af5 ($25.1 in chips)
Seat 3: Hero ($28.02 in chips)
Seat 4: 2904eaa2 ($25 in chips)
Seat 5: 8466ae26 ($25.36 in chips)
Seat 6: a3949718 ($11.6 in chips)
8e166af5: posts small blind $0.1
Hero: posts big blind $0.25
*** HOLE CARDS ***
Dealt to 38359122 
Dealt to 8e166af5 
Dealt to Hero [9c 5c]
Dealt to 2904eaa2 
Dealt to 8466ae26 
Dealt to a3949718 
2904eaa2: folds
8466ae26: folds
a3949718: folds
38359122: raises $0.25 to $0.5
8e166af5: folds
Hero: folds
Uncalled bet ($0.25) returned to 38359122
*** SHOWDOWN ***
38359122 collected $0.6 from pot
*** SUMMARY ***
Total pot $0.6
Seat 1: 38359122 (button) collected ($0.6)
Seat 2: 8e166af5 (small blind) folded before Flop
Seat 3: Hero (big blind) folded before Flop
Seat 4: 2904eaa2 folded before Flop (didn't bet)
Seat 5: 8466ae26 folded before Flop (didn't bet)
Seat 6: a3949718 folded before Flop (didn't bet)


Poker Hand #RC94795239: Hold'em No Limit ($0.1/$0.25) - 2020/04/06 23:34:18
Table 'RushAndCash319416' 6-max Seat #1 is the button
Seat 1: 7357eb2f ($52.66 in chips)
Seat 2: 8abd2614 ($13.1 in chips)
Seat 3: fe7c9e7a ($29.37 in chips)
Seat 4: Hero ($27.77 in chips)
Seat 5: e44fce1a ($26.66 in chips)
Seat 6: b00dbb18 ($36.93 in chips)
8abd2614: posts small blind $0.1
fe7c9e7a: posts big blind $0.25
*** HOLE CARDS ***
Dealt to 7357eb2f 
Dealt to 8abd2614 
Dealt to fe7c9e7a 
Dealt to Hero [2s 2d]
Dealt to e44fce1a 
Dealt to b00dbb18 
Hero: folds
e44fce1a: folds
b00dbb18: folds
7357eb2f: folds
8abd2614: raises $0.5 to $0.75
fe7c9e7a: folds
Uncalled bet ($0.5) returned to 8abd2614
*** SHOWDOWN ***
8abd2614 collected $0.5 from pot
*** SUMMARY ***
Total pot $0.5
Seat 1: 7357eb2f (button) folded before Flop (didn't bet)
Seat 2: 8abd2614 (small blind) collected ($0.5)
Seat 3: fe7c9e7a (big blind) folded before Flop
Seat 4: Hero folded before Flop (didn't bet)
Seat 5: e44fce1a folded before Flop (didn't bet)
Seat 6: b00dbb18 folded before Flop (didn't bet)


Poker Hand #RC94795271: Hold'em No Limit ($0.1/$0.25) - 2020/04/06 23:34:25
Table 'RushAndCash319418' 6-max Seat #1 is the button
Seat 1: 8e166af5 ($25 in chips)
Seat 2: 604f36f0 ($16.77 in chips)
Seat 3: 9d598a03 ($51.01 in chips)
Seat 4: eeae3d7 ($10.1 in chips)
Seat 5: e64b2cd5 ($13.2 in chips)
Seat 6: Hero ($27.77 in chips)
604f36f0: posts small blind $0.1
9d598a03: posts big blind $0.25
*** HOLE CARDS ***
Dealt to 8e166af5 
Dealt to 604f36f0 
Dealt to 9d598a03 
Dealt to eeae3d7 
Dealt to e64b2cd5 
Dealt to Hero [Th 3s]
eeae3d7: folds
e64b2cd5: folds
Hero: folds
8e166af5: raises $0.25 to $0.5
604f36f0: folds
9d598a03: folds
Uncalled bet ($0.25) returned to 8e166af5
*** SHOWDOWN ***
8e166af5 collected $0.6 from pot
*** SUMMARY ***
Total pot $0.6
Seat 1: 8e166af5 (button) collected ($0.6)
Seat 2: 604f36f0 (small blind) folded before Flop
Seat 3: 9d598a03 (big blind) folded before Flop
Seat 4: eeae3d7 folded before Flop (didn't bet)
Seat 5: e64b2cd5 folded before Flop (didn't bet)
Seat 6: Hero folded before Flop (didn't bet)


Poker Hand #RC94795296: Hold'em No Limit ($0.1/$0.25) - 2020/04/06 23:34:30
Table 'RushAndCash319422' 6-max Seat #1 is the button
Seat 1: Hero ($27.77 in chips)
Seat 2: ff501d94 ($11.84 in chips)
Seat 3: 17480666 ($103.54 in chips)
Seat 4: b215699c ($63.14 in chips)
Seat 5: 23cd8de ($12.5 in chips)
Seat 6: 8466ae26 ($25.36 in chips)
ff501d94: posts small blind $0.1
17480666: posts big blind $0.25
*** HOLE CARDS ***
Dealt to Hero [As 4c]
Dealt to ff501d94 
Dealt to 17480666 
Dealt to b215699c 
Dealt to 23cd8de 
Dealt to 8466ae26 
b215699c: folds
23cd8de: folds
8466ae26: raises $0.38 to $0.63
Hero: folds
ff501d94: folds
17480666: folds
Uncalled bet ($0.38) returned to 8466ae26
*** SHOWDOWN ***
8466ae26 collected $0.6 from pot
*** SUMMARY ***
Total pot $0.6
Seat 1: Hero (button) folded before Flop (didn't bet)
Seat 2: ff501d94 (small blind) folded before Flop
Seat 3: 17480666 (big blind) folded before Flop
Seat 4: b215699c folded before Flop (didn't bet)
Seat 5: 23cd8de folded before Flop (didn't bet)
Seat 6: 8466ae26 collected ($0.6)


Poker Hand #RC94795317: Hold'em No Limit ($0.1/$0.25) - 2020/04/06 23:34:35
Table 'RushAndCash319425' 6-max Seat #1 is the button
Seat 1: 5e03da34 ($63.09 in chips)
Seat 2: 7357eb2f ($52.66 in chips)
Seat 3: d8a224aa ($31.86 in chips)
Seat 4: bc200877 ($7.54 in chips)
Seat 5: 23cd8de ($12.5 in chips)
Seat 6: Hero ($27.77 in chips)
7357eb2f: posts small blind $0.1
d8a224aa: posts big blind $0.25
*** HOLE CARDS ***
Dealt to 5e03da34 
Dealt to 7357eb2f 
Dealt to d8a224aa 
Dealt to bc200877 
Dealt to 23cd8de 
Dealt to Hero [Ah 3d]
bc200877: raises $0.63 to $0.88
23cd8de: folds
Hero: folds
5e03da34: folds
7357eb2f: calls $0.78
d8a224aa: folds
*** FLOP *** [7s 7d 7c]
7357eb2f: checks
bc200877: bets $0.7
7357eb2f: folds
Uncalled bet ($0.7) returned to bc200877
*** SHOWDOWN ***
bc200877 collected $2.01 from pot
*** SUMMARY ***
Total pot $2.01
Board [7s 7d 7c]
Seat 1: 5e03da34 (button) folded before Flop (didn't bet)
Seat 2: 7357eb2f (small blind) folded on the Flop
Seat 3: d8a224aa (big blind) folded before Flop
Seat 4: bc200877 won ($2.01)
Seat 5: 23cd8de folded before Flop (didn't bet)
Seat 6: Hero folded before Flop (didn't bet)


Poker Hand #RC94795342: Hold'em No Limit ($0.1/$0.25) - 2020/04/06 23:34:39
Table 'RushAndCash319428' 6-max Seat #1 is the button
Seat 1: fe7c9e7a ($29.12 in chips)
Seat 2: cf8c7400 ($25 in chips)
Seat 3: 8abd2614 ($13.35 in chips)
Seat 4: a3949718 ($11.6 in chips)
Seat 5: Hero ($27.77 in chips)
Seat 6: 2904eaa2 ($25 in chips)
cf8c7400: posts small blind $0.1
8abd2614: posts big blind $0.25
*** HOLE CARDS ***
Dealt to fe7c9e7a 
Dealt to cf8c7400 
Dealt to 8abd2614 
Dealt to a3949718 
Dealt to Hero [Qh Ts]
Dealt to 2904eaa2 
a3949718: folds
Hero: folds
2904eaa2: raises $0.5 to $0.75
fe7c9e7a: folds
cf8c7400: folds
8abd2614: folds
Uncalled bet ($0.5) returned to 2904eaa2
*** SHOWDOWN ***
2904eaa2 collected $0.6 from pot
*** SUMMARY ***
Total pot $0.6
Seat 1: fe7c9e7a (button) folded before Flop (didn't bet)
Seat 2: cf8c7400 (small blind) folded before Flop
Seat 3: 8abd2614 (big blind) folded before Flop
Seat 4: a3949718 folded before Flop (didn't bet)
Seat 5: Hero folded before Flop (didn't bet)
Seat 6: 2904eaa2 collected ($0.6)


Poker Hand #RC94795371: Hold'em No Limit ($0.1/$0.25) - 2020/04/06 23:34:45
Table 'RushAndCash319431' 6-max Seat #1 is the button
Seat 1: 8466ae26 ($25.71 in chips)
Seat 2: afa5143c ($33.81 in chips)
Seat 3: 64933f7d ($12 in chips)
Seat 4: Hero ($27.77 in chips)
Seat 5: 38359122 ($15.48 in chips)
Seat 6: 8e166af5 ($25.35 in chips)
afa5143c: posts small blind $0.1
64933f7d: posts big blind $0.25
*** HOLE CARDS ***
Dealt to 8466ae26 
Dealt to afa5143c 
Dealt to 64933f7d 
Dealt to Hero [Th 7h]
Dealt to 38359122 
Dealt to 8e166af5 
Hero: folds
38359122: folds
8e166af5: folds
8466ae26: folds
afa5143c: folds
Uncalled bet ($0.15) returned to 64933f7d
*** SHOWDOWN ***
64933f7d collected $0.2 from pot
*** SUMMARY ***
Total pot $0.2
Seat 1: 8466ae26 (button) folded before Flop (didn't bet)
Seat 2: afa5143c (small blind) folded before Flop
Seat 3: 64933f7d (big blind) collected ($0.2)
Seat 4: Hero folded before Flop (didn't bet)
Seat 5: 38359122 folded before Flop (didn't bet)
Seat 6: 8e166af5 folded before Flop (didn't bet)


Poker Hand #RC94795414: Hold'em No Limit ($0.1/$0.25) - 2020/04/06 23:34:53
Table 'RushAndCash319437' 6-max Seat #1 is the button
Seat 1: 604f36f0 ($16.67 in chips)
Seat 2: Hero ($27.77 in chips)
Seat 3: b00dbb18 ($36.93 in chips)
Seat 4: a3949718 ($11.6 in chips)
Seat 5: f99bdf7f ($19.61 in chips)
Seat 6: 38359122 ($15.48 in chips)
Hero: posts small blind $0.1
b00dbb18: posts big blind $0.25
*** HOLE CARDS ***
Dealt to 604f36f0 
Dealt to Hero [Qh 4c]
Dealt to b00dbb18 
Dealt to a3949718 
Dealt to f99bdf7f 
Dealt to 38359122 
a3949718: folds
f99bdf7f: folds
38359122: folds
604f36f0: folds
Hero: folds
Uncalled bet ($0.15) returned to b00dbb18
*** SHOWDOWN ***
b00dbb18 collected $0.2 from pot
*** SUMMARY ***
Total pot $0.2
Seat 1: 604f36f0 (button) folded before Flop (didn't bet)
Seat 2: Hero (small blind) folded before Flop
Seat 3: b00dbb18 (big blind) collected ($0.2)
Seat 4: a3949718 folded before Flop (didn't bet)
Seat 5: f99bdf7f folded before Flop (didn't bet)
Seat 6: 38359122 folded before Flop (didn't bet)


Poker Hand #RC94795431: Hold'em No Limit ($0.1/$0.25) - 2020/04/06 23:34:57
Table 'RushAndCash319440' 6-max Seat #1 is the button
Seat 1: Hero ($27.67 in chips)
Seat 2: 36ac4586 ($48.98 in chips)
Seat 3: cc4afcf8 ($3.97 in chips)
Seat 4: 604f36f0 ($16.67 in chips)
Seat 5: 38359122 ($15.48 in chips)
Seat 6: f99bdf7f ($19.61 in chips)
36ac4586: posts small blind $0.1
cc4afcf8: posts big blind $0.25
*** HOLE CARDS ***
Dealt to Hero [Qs 7s]
Dealt to 36ac4586 
Dealt to cc4afcf8 
Dealt to 604f36f0 
Dealt to 38359122 
Dealt to f99bdf7f 
604f36f0: folds
38359122: folds
f99bdf7f: folds
Hero: folds
36ac4586: folds
Uncalled bet ($0.15) returned to cc4afcf8
*** SHOWDOWN ***
cc4afcf8 collected $0.2 from pot
*** SUMMARY ***
Total pot $0.2
Seat 1: Hero (button) folded before Flop (didn't bet)
Seat 2: 36ac4586 (small blind) folded before Flop
Seat 3: cc4afcf8 (big blind) collected ($0.2)
Seat 4: 604f36f0 folded before Flop (didn't bet)
Seat 5: 38359122 folded before Flop (didn't bet)
Seat 6: f99bdf7f folded before Flop (didn't bet)


Poker Hand #RC94795453: Hold'em No Limit ($0.1/$0.25) - 2020/04/06 23:35:01
Table 'RushAndCash319444' 6-max Seat #1 is the button
Seat 1: cf8c7400 ($25 in chips)
Seat 2: 8a31aea7 ($74.61 in chips)
Seat 3: Hero ($27.67 in chips)
Seat 4: d7f99a39 ($8.12 in chips)
Seat 5: 72fa991e ($35.42 in chips)
Seat 6: f99bdf7f ($19.61 in chips)
8a31aea7: posts small blind $0.1
Hero: posts big blind $0.25
*** HOLE CARDS ***
Dealt to cf8c7400 
Dealt to 8a31aea7 
Dealt to Hero [Kh 7c]
Dealt to d7f99a39 
Dealt to 72fa991e 
Dealt to f99bdf7f 
d7f99a39: folds
72fa991e: folds
f99bdf7f: folds
cf8c7400: folds
8a31aea7: folds
Uncalled bet ($0.15) returned to Hero
*** SHOWDOWN ***
Hero collected $0.2 from pot
*** SUMMARY ***
Total pot $0.2
Seat 1: cf8c7400 (button) folded before Flop (didn't bet)
Seat 2: 8a31aea7 (small blind) folded before Flop
Seat 3: Hero (big blind) collected ($0.2)
Seat 4: d7f99a39 folded before Flop (didn't bet)
Seat 5: 72fa991e folded before Flop (didn't bet)
Seat 6: f99bdf7f folded before Flop (didn't bet)


Poker Hand #RC94795473: Hold'em No Limit ($0.1/$0.25) - 2020/04/06 23:35:05
Table 'RushAndCash319447' 6-max Seat #1 is the button
Seat 1: a82639fc ($27.48 in chips)
Seat 2: 9c584d7d ($12.1 in chips)
Seat 3: c63a382b ($29.98 in chips)
Seat 4: fe7c9e7a ($29.12 in chips)
Seat 5: f99bdf7f ($19.61 in chips)
Seat 6: Hero ($27.42 in chips)
9c584d7d: posts small blind $0.1
c63a382b: posts big blind $0.25
*** HOLE CARDS ***
Dealt to a82639fc 
Dealt to 9c584d7d 
Dealt to c63a382b 
Dealt to fe7c9e7a 
Dealt to f99bdf7f 
Dealt to Hero [9h 7s]
fe7c9e7a: raises $0.25 to $0.5
f99bdf7f: raises $0.75 to $1.25
Hero: folds
a82639fc: raises $3.25 to $4.5
9c584d7d: folds
c63a382b: folds
fe7c9e7a: folds
f99bdf7f: raises $15.11 to $19.61 and is all-in
a82639fc: calls $15.11
f99bdf7f: shows [Kd Ks]
a82639fc: shows [Ah Ac]
*** FLOP *** [3s 6d 6c]
*** TURN *** [3s 6d 6c] [3d]
*** RIVER *** [3s 6d 6c 3d] [2h]
*** SHOWDOWN ***
a82639fc collected $40.07 from pot
*** SUMMARY ***
Total pot $40.07
Board [3s 6d 6c 3d 2h]
Seat 1: a82639fc (button) showed [Ah Ac] and won ($40.07) with Pair of Aces and Pair of Sixes
Seat 2: 9c584d7d (small blind) folded before Flop
Seat 3: c63a382b (big blind) folded before Flop
Seat 4: fe7c9e7a folded before Flop
Seat 5: f99bdf7f showed [Ks Kd] and lost with Pair of Kings and Pair of Sixes
Seat 6: Hero folded before Flop (didn't bet)


Poker Hand #RC94795505: Hold'em No Limit ($0.1/$0.25) - 2020/04/06 23:35:11
Table 'RushAndCash319452' 6-max Seat #1 is the button
Seat 1: cce649b7 ($36.16 in chips)
Seat 2: 9afeb2a7 ($30.68 in chips)
Seat 3: 1bc051b2 ($12.35 in chips)
Seat 4: dfcfe0b3 ($34.03 in chips)
Seat 5: e0680a48 ($49.92 in chips)
Seat 6: Hero ($27.42 in chips)
9afeb2a7: posts small blind $0.1
1bc051b2: posts big blind $0.25
*** HOLE CARDS ***
Dealt to cce649b7 
Dealt to 9afeb2a7 
Dealt to 1bc051b2 
Dealt to dfcfe0b3 
Dealt to e0680a48 
Dealt to Hero [Kd 8s]
dfcfe0b3: folds
e0680a48: folds
Hero: folds
cce649b7: folds
9afeb2a7: raises $0.5 to $0.75
1bc051b2: folds
Uncalled bet ($0.5) returned to 9afeb2a7
*** SHOWDOWN ***
9afeb2a7 collected $0.5 from pot
*** SUMMARY ***
Total pot $0.5
Seat 1: cce649b7 (button) folded before Flop (didn't bet)
Seat 2: 9afeb2a7 (small blind) collected ($0.5)
Seat 3: 1bc051b2 (big blind) folded before Flop
Seat 4: dfcfe0b3 folded before Flop (didn't bet)
Seat 5: e0680a48 folded before Flop (didn't bet)
Seat 6: Hero folded before Flop (didn't bet)


Poker Hand #RC94795547: Hold'em No Limit ($0.1/$0.25) - 2020/04/06 23:35:20
Table 'RushAndCash319457' 6-max Seat #1 is the button
Seat 1: 17480666 ($102.94 in chips)
Seat 2: Hero ($27.77 in chips)
Seat 3: 2258ad9f ($66.88 in chips)
Seat 4: dfcfe0b3 ($34.03 in chips)
Seat 5: 8abd2614 ($13.45 in chips)
Seat 6: ff501d94 ($12.32 in chips)
Hero: posts small blind $0.1
2258ad9f: posts big blind $0.25
*** HOLE CARDS ***
Dealt to 17480666 
Dealt to Hero [9d 4d]
Dealt to 2258ad9f 
Dealt to dfcfe0b3 
Dealt to 8abd2614 
Dealt to ff501d94 
dfcfe0b3: folds
8abd2614: folds
ff501d94: folds
17480666: folds
Hero: folds
Uncalled bet ($0.15) returned to 2258ad9f
*** SHOWDOWN ***
2258ad9f collected $0.2 from pot
*** SUMMARY ***
Total pot $0.2
Seat 1: 17480666 (button) folded before Flop (didn't bet)
Seat 2: Hero (small blind) folded before Flop
Seat 3: 2258ad9f (big blind) collected ($0.2)
Seat 4: dfcfe0b3 folded before Flop (didn't bet)
Seat 5: 8abd2614 folded before Flop (didn't bet)
Seat 6: ff501d94 folded before Flop (didn't bet)


Poker Hand #RC94795565: Hold'em No Limit ($0.1/$0.25) - 2020/04/06 23:35:24
Table 'RushAndCash319459' 6-max Seat #1 is the button
Seat 1: 17480666 ($102.94 in chips)
Seat 2: 36ac4586 ($48.88 in chips)
Seat 3: Hero ($27.67 in chips)
Seat 4: 23cd8de ($12.5 in chips)
Seat 5: e44fce1a ($26.31 in chips)
Seat 6: ba032eea ($59.44 in chips)
36ac4586: posts small blind $0.1
Hero: posts big blind $0.25
*** HOLE CARDS ***
Dealt to 17480666 
Dealt to 36ac4586 
Dealt to Hero [8s 5d]
Dealt to 23cd8de 
Dealt to e44fce1a 
Dealt to ba032eea 
23cd8de: folds
e44fce1a: raises $0.5 to $0.75
ba032eea: calls $0.75
17480666: raises $2.2 to $2.95
36ac4586: folds
Hero: folds
e44fce1a: folds
ba032eea: calls $2.2
*** FLOP *** [5s Td 9c]
ba032eea: checks
17480666: bets $2.4
ba032eea: folds
Uncalled bet ($2.4) returned to 17480666
*** SHOWDOWN ***
17480666 collected $7 from pot
*** SUMMARY ***
Total pot $7
Board [5s Td 9c]
Seat 1: 17480666 (button) won ($7)
Seat 2: 36ac4586 (small blind) folded before Flop
Seat 3: Hero (big blind) folded before Flop
Seat 4: 23cd8de folded before Flop (didn't bet)
Seat 5: e44fce1a folded before Flop
Seat 6: ba032eea folded on the Flop


Poker Hand #RC94795588: Hold'em No Limit ($0.1/$0.25) - 2020/04/06 23:35:28
Table 'RushAndCash319462' 6-max Seat #1 is the button
Seat 1: 969ce17 ($30.95 in chips)
Seat 2: 2258ad9f ($66.98 in chips)
Seat 3: 1d6fff9c ($25 in chips)
Seat 4: Hero ($27.42 in chips)
Seat 5: 2467bb49 ($51.83 in chips)
Seat 6: 64933f7d ($12.5 in chips)
2258ad9f: posts small blind $0.1
1d6fff9c: posts big blind $0.25
*** HOLE CARDS ***
Dealt to 969ce17 
Dealt to 2258ad9f 
Dealt to 1d6fff9c 
Dealt to Hero [5c 3c]
Dealt to 2467bb49 
Dealt to 64933f7d 
Hero: folds
2467bb49: raises $0.38 to $0.63
64933f7d: folds
969ce17: folds
2258ad9f: folds
1d6fff9c: folds
Uncalled bet ($0.38) returned to 2467bb49
*** SHOWDOWN ***
2467bb49 collected $0.6 from pot
*** SUMMARY ***
Total pot $0.6
Seat 1: 969ce17 (button) folded before Flop (didn't bet)
Seat 2: 2258ad9f (small blind) folded before Flop
Seat 3: 1d6fff9c (big blind) folded before Flop
Seat 4: Hero folded before Flop (didn't bet)
Seat 5: 2467bb49 collected ($0.6)
Seat 6: 64933f7d folded before Flop (didn't bet)


Poker Hand #RC94795609: Hold'em No Limit ($0.1/$0.25) - 2020/04/06 23:35:33
Table 'RushAndCash319466' 6-max Seat #1 is the button
Seat 1: Hero ($27.42 in chips)
Seat 2: 41459cc9 ($25.67 in chips)
Seat 3: ce4e1e37 ($31.09 in chips)
Seat 4: ca69da65 ($33.73 in chips)
Seat 5: 8a31aea7 ($74.86 in chips)
Seat 6: 64933f7d ($12.5 in chips)
41459cc9: posts small blind $0.1
ce4e1e37: posts big blind $0.25
*** HOLE CARDS ***
Dealt to Hero [Kd 3d]
Dealt to 41459cc9 
Dealt to ce4e1e37 
Dealt to ca69da65 
Dealt to 8a31aea7 
Dealt to 64933f7d 
ca69da65: raises $0.38 to $0.63
8a31aea7: folds
64933f7d: folds
Hero: folds
41459cc9: folds
ce4e1e37: calls $0.38
*** FLOP *** [4h Tc 4s]
ce4e1e37: checks
ca69da65: checks
*** TURN *** [4h Tc 4s] [7d]
ce4e1e37: bets $0.9
ca69da65: raises $3.15 to $4.05
ce4e1e37: folds
Uncalled bet ($3.15) returned to ca69da65
*** SHOWDOWN ***
ca69da65 collected $3.16 from pot
*** SUMMARY ***
Total pot $3.16
Board [4h Tc 4s 7d]
Seat 1: Hero (button) folded before Flop (didn't bet)
Seat 2: 41459cc9 (small blind) folded before Flop
Seat 3: ce4e1e37 (big blind) folded on the Turn
Seat 4: ca69da65 won ($3.16)
Seat 5: 8a31aea7 folded before Flop (didn't bet)
Seat 6: 64933f7d folded before Flop (didn't bet)


Poker Hand #RC94795630: Hold'em No Limit ($0.1/$0.25) - 2020/04/06 23:35:37
Table 'RushAndCash319469' 6-max Seat #1 is the button
Seat 1: 2258ad9f ($66.88 in chips)
Seat 2: f4e2b370 ($20.61 in chips)
Seat 3: ff501d94 ($12.22 in chips)
Seat 4: b9bbf733 ($33.07 in chips)
Seat 5: Hero ($27.42 in chips)
Seat 6: 99d6d386 ($25.1 in chips)
f4e2b370: posts small blind $0.1
ff501d94: posts big blind $0.25
*** HOLE CARDS ***
Dealt to 2258ad9f 
Dealt to f4e2b370 
Dealt to ff501d94 
Dealt to b9bbf733 
Dealt to Hero [6s 2c]
Dealt to 99d6d386 
b9bbf733: raises $0.5 to $0.75
Hero: folds
99d6d386: folds
2258ad9f: folds
f4e2b370: folds
ff501d94: raises $1.75 to $2.5
b9bbf733: folds
Uncalled bet ($1.75) returned to ff501d94
*** SHOWDOWN ***
ff501d94 collected $1.6 from pot
*** SUMMARY ***
Total pot $1.6
Seat 1: 2258ad9f (button) folded before Flop (didn't bet)
Seat 2: f4e2b370 (small blind) folded before Flop
Seat 3: ff501d94 (big blind) collected ($1.6)
Seat 4: b9bbf733 folded before Flop
Seat 5: Hero folded before Flop (didn't bet)
Seat 6: 99d6d386 folded before Flop (didn't bet)


Poker Hand #RC94795651: Hold'em No Limit ($0.1/$0.25) - 2020/04/06 23:35:41
Table 'RushAndCash319473' 6-max Seat #1 is the button
Seat 1: c63a382b ($29.96 in chips)
Seat 2: 1d6fff9c ($25 in chips)
Seat 3: bd6eeaf3 ($55.61 in chips)
Seat 4: Hero ($27.42 in chips)
Seat 5: afa5143c ($33.46 in chips)
Seat 6: 99d6d386 ($25.1 in chips)
1d6fff9c: posts small blind $0.1
bd6eeaf3: posts big blind $0.25
*** HOLE CARDS ***
Dealt to c63a382b 
Dealt to 1d6fff9c 
Dealt to bd6eeaf3 
Dealt to Hero [Th 5h]
Dealt to afa5143c 
Dealt to 99d6d386 
Hero: folds
afa5143c: folds
99d6d386: folds
c63a382b: folds
1d6fff9c: raises $0.38 to $0.63
bd6eeaf3: folds
Uncalled bet ($0.38) returned to 1d6fff9c
*** SHOWDOWN ***
1d6fff9c collected $0.5 from pot
*** SUMMARY ***
Total pot $0.5
Seat 1: c63a382b (button) folded before Flop (didn't bet)
Seat 2: 1d6fff9c (small blind) collected ($0.5)
Seat 3: bd6eeaf3 (big blind) folded before Flop
Seat 4: Hero folded before Flop (didn't bet)
Seat 5: afa5143c folded before Flop (didn't bet)
Seat 6: 99d6d386 folded before Flop (didn't bet)


Poker Hand #RC94795670: Hold'em No Limit ($0.1/$0.25) - 2020/04/06 23:35:45
Table 'RushAndCash319477' 6-max Seat #1 is the button
Seat 1: dfcfe0b3 ($34.13 in chips)
Seat 2: cf8c7400 ($25 in chips)
Seat 3: 99d6d386 ($25.1 in chips)
Seat 4: 8fb93df3 ($37.69 in chips)
Seat 5: Hero ($27.42 in chips)
Seat 6: b9492ea1 ($21.07 in chips)
cf8c7400: posts small blind $0.1
99d6d386: posts big blind $0.25
*** HOLE CARDS ***
Dealt to dfcfe0b3 
Dealt to cf8c7400 
Dealt to 99d6d386 
Dealt to 8fb93df3 
Dealt to Hero [9c 5c]
Dealt to b9492ea1 
8fb93df3: folds
Hero: folds
b9492ea1: raises $0.5 to $0.75
dfcfe0b3: folds
cf8c7400: folds
99d6d386: folds
Uncalled bet ($0.5) returned to b9492ea1
*** SHOWDOWN ***
b9492ea1 collected $0.6 from pot
*** SUMMARY ***
Total pot $0.6
Seat 1: dfcfe0b3 (button) folded before Flop (didn't bet)
Seat 2: cf8c7400 (small blind) folded before Flop
Seat 3: 99d6d386 (big blind) folded before Flop
Seat 4: 8fb93df3 folded before Flop (didn't bet)
Seat 5: Hero folded before Flop (didn't bet)
Seat 6: b9492ea1 collected ($0.6)


Poker Hand #RC94795697: Hold'em No Limit ($0.1/$0.25) - 2020/04/06 23:35:52
Table 'RushAndCash319481' 6-max Seat #1 is the button
Seat 1: 8abd2614 ($13.1 in chips)
Seat 2: 99d6d386 ($25 in chips)
Seat 3: 8466ae26 ($25.71 in chips)
Seat 4: Hero ($27.42 in chips)
Seat 5: 94efc628 ($25 in chips)
Seat 6: 36ac4586 ($48.53 in chips)
99d6d386: posts small blind $0.1
8466ae26: posts big blind $0.25
*** HOLE CARDS ***
Dealt to 8abd2614 
Dealt to 99d6d386 
Dealt to 8466ae26 
Dealt to Hero [Ac Qc]
Dealt to 94efc628 
Dealt to 36ac4586 
Hero: raises $0.38 to $0.63
94efc628: folds
36ac4586: folds
8abd2614: folds
99d6d386: folds
8466ae26: folds
Uncalled bet ($0.38) returned to Hero
*** SHOWDOWN ***
Hero collected $0.6 from pot
*** SUMMARY ***
Total pot $0.6
Seat 1: 8abd2614 (button) folded before Flop (didn't bet)
Seat 2: 99d6d386 (small blind) folded before Flop
Seat 3: 8466ae26 (big blind) folded before Flop
Seat 4: Hero collected ($0.6)
Seat 5: 94efc628 folded before Flop (didn't bet)
Seat 6: 36ac4586 folded before Flop (didn't bet)


Poker Hand #RC94795760: Hold'em No Limit ($0.1/$0.25) - 2020/04/06 23:36:07
Table 'RushAndCash319489' 6-max Seat #1 is the button
Seat 1: e0680a48 ($50.27 in chips)
Seat 2: b9bbf733 ($32.32 in chips)
Seat 3: Hero ($27.77 in chips)
Seat 4: 604f36f0 ($17.34 in chips)
Seat 5: dfcfe0b3 ($34.03 in chips)
Seat 6: fe7c9e7a ($28.27 in chips)
b9bbf733: posts small blind $0.1
Hero: posts big blind $0.25
*** HOLE CARDS ***
Dealt to e0680a48 
Dealt to b9bbf733 
Dealt to Hero [7d 5s]
Dealt to 604f36f0 
Dealt to dfcfe0b3 
Dealt to fe7c9e7a 
604f36f0: folds
dfcfe0b3: folds
fe7c9e7a: folds
e0680a48: raises $0.5 to $0.75
b9bbf733: calls $0.65
Hero: folds
*** FLOP *** [Js 8h 8s]
b9bbf733: checks
e0680a48: bets $0.9
b9bbf733: raises $2.4 to $3.3
e0680a48: calls $2.4
*** TURN *** [Js 8h 8s] [Tc]
b9bbf733: bets $5.8
e0680a48: calls $5.8
*** RIVER *** [Js 8h 8s Tc] [Jc]
b9bbf733: checks
e0680a48: bets $15
b9bbf733: calls $15
e0680a48: shows [9s Jh] (Jacks Full over Eights)
b9bbf733: shows [6c 8c] (Eights Full over Jacks)
*** SHOWDOWN ***
e0680a48 collected $49.95 from pot
*** SUMMARY ***
Total pot $49.95
Board [Js 8h 8s Tc Jc]
Seat 1: e0680a48 (button) showed [Jh 9s] and won ($49.95) with Jacks Full over Eights
Seat 2: b9bbf733 (small blind) showed [8c 6c] and lost with Eights Full over Jacks
Seat 3: Hero (big blind) folded before Flop
Seat 4: 604f36f0 folded before Flop (didn't bet)
Seat 5: dfcfe0b3 folded before Flop (didn't bet)
Seat 6: fe7c9e7a folded before Flop (didn't bet)


Poker Hand #RC94795774: Hold'em No Limit ($0.1/$0.25) - 2020/04/06 23:36:10
Table 'RushAndCash319491' 6-max Seat #1 is the button
Seat 1: 9c584d7d ($12 in chips)
Seat 2: Hero ($27.52 in chips)
Seat 3: e64b2cd5 ($12.85 in chips)
Seat 4: 99d6d386 ($25 in chips)
Seat 5: bd6eeaf3 ($55.36 in chips)
Seat 6: 58b04451 ($22.95 in chips)
Hero: posts small blind $0.1
e64b2cd5: posts big blind $0.25
*** HOLE CARDS ***
Dealt to 9c584d7d 
Dealt to Hero [Jd 5s]
Dealt to e64b2cd5 
Dealt to 99d6d386 
Dealt to bd6eeaf3 
Dealt to 58b04451 
99d6d386: folds
bd6eeaf3: folds
58b04451: folds
9c584d7d: folds
Hero: folds
Uncalled bet ($0.15) returned to e64b2cd5
*** SHOWDOWN ***
e64b2cd5 collected $0.2 from pot
*** SUMMARY ***
Total pot $0.2
Seat 1: 9c584d7d (button) folded before Flop (didn't bet)
Seat 2: Hero (small blind) folded before Flop
Seat 3: e64b2cd5 (big blind) collected ($0.2)
Seat 4: 99d6d386 folded before Flop (didn't bet)
Seat 5: bd6eeaf3 folded before Flop (didn't bet)
Seat 6: 58b04451 folded before Flop (didn't bet)


Poker Hand #RC94795796: Hold'em No Limit ($0.1/$0.25) - 2020/04/06 23:36:15
Table 'RushAndCash319494' 6-max Seat #1 is the button
Seat 1: 969ce17 ($30.95 in chips)
Seat 2: a3949718 ($11.35 in chips)
Seat 3: Hero ($27.42 in chips)
Seat 4: 1d6fff9c ($25.25 in chips)
Seat 5: 9b358964 ($26.26 in chips)
Seat 6: 58b04451 ($22.95 in chips)
a3949718: posts small blind $0.1
Hero: posts big blind $0.25
*** HOLE CARDS ***
Dealt to 969ce17 
Dealt to a3949718 
Dealt to Hero [5c 3s]
Dealt to 1d6fff9c 
Dealt to 9b358964 
Dealt to 58b04451 
1d6fff9c: folds
9b358964: folds
58b04451: folds
969ce17: raises $0.5 to $0.75
a3949718: folds
Hero: folds
Uncalled bet ($0.5) returned to 969ce17
*** SHOWDOWN ***
969ce17 collected $0.6 from pot
*** SUMMARY ***
Total pot $0.6
Seat 1: 969ce17 (button) collected ($0.6)
Seat 2: a3949718 (small blind) folded before Flop
Seat 3: Hero (big blind) folded before Flop
Seat 4: 1d6fff9c folded before Flop (didn't bet)
Seat 5: 9b358964 folded before Flop (didn't bet)
Seat 6: 58b04451 folded before Flop (didn't bet)


Poker Hand #RC94795816: Hold'em No Limit ($0.1/$0.25) - 2020/04/06 23:36:19
Table 'RushAndCash319497' 6-max Seat #1 is the button
Seat 1: dfcfe0b3 ($34.03 in chips)
Seat 2: 9c511c89 ($12.5 in chips)
Seat 3: c63a382b ($29.71 in chips)
Seat 4: bd6eeaf3 ($55.36 in chips)
Seat 5: Hero ($27.17 in chips)
Seat 6: fe7c9e7a ($28.27 in chips)
9c511c89: posts small blind $0.1
c63a382b: posts big blind $0.25
*** HOLE CARDS ***
Dealt to dfcfe0b3 
Dealt to 9c511c89 
Dealt to c63a382b 
Dealt to bd6eeaf3 
Dealt to Hero [5d 2d]
Dealt to fe7c9e7a 
bd6eeaf3: folds
Hero: folds
fe7c9e7a: folds
dfcfe0b3: folds
9c511c89: folds
Uncalled bet ($0.15) returned to c63a382b
*** SHOWDOWN ***
c63a382b collected $0.2 from pot
*** SUMMARY ***
Total pot $0.2
Seat 1: dfcfe0b3 (button) folded before Flop (didn't bet)
Seat 2: 9c511c89 (small blind) folded before Flop
Seat 3: c63a382b (big blind) collected ($0.2)
Seat 4: bd6eeaf3 folded before Flop (didn't bet)
Seat 5: Hero folded before Flop (didn't bet)
Seat 6: fe7c9e7a folded before Flop (didn't bet)


Poker Hand #RC94795834: Hold'em No Limit ($0.1/$0.25) - 2020/04/06 23:36:22
Table 'RushAndCash319500' 6-max Seat #1 is the button
Seat 1: Hero ($27.17 in chips)
Seat 2: e64b2cd5 ($12.95 in chips)
Seat 3: fe7c9e7a ($28.27 in chips)
Seat 4: cf8c7400 ($25 in chips)
Seat 5: 8a31aea7 ($75.63 in chips)
Seat 6: dfcfe0b3 ($34.03 in chips)
e64b2cd5: posts small blind $0.1
fe7c9e7a: posts big blind $0.25
*** HOLE CARDS ***
Dealt to Hero [Td 5c]
Dealt to e64b2cd5 
Dealt to fe7c9e7a 
Dealt to cf8c7400 
Dealt to 8a31aea7 
Dealt to dfcfe0b3 
cf8c7400: folds
8a31aea7: folds
dfcfe0b3: folds
Hero: folds
e64b2cd5: raises $0.5 to $0.75
fe7c9e7a: folds
Uncalled bet ($0.5) returned to e64b2cd5
*** SHOWDOWN ***
e64b2cd5 collected $0.5 from pot
*** SUMMARY ***
Total pot $0.5
Seat 1: Hero (button) folded before Flop (didn't bet)
Seat 2: e64b2cd5 (small blind) collected ($0.5)
Seat 3: fe7c9e7a (big blind) folded before Flop
Seat 4: cf8c7400 folded before Flop (didn't bet)
Seat 5: 8a31aea7 folded before Flop (didn't bet)
Seat 6: dfcfe0b3 folded before Flop (didn't bet)


Poker Hand #RC94795848: Hold'em No Limit ($0.1/$0.25) - 2020/04/06 23:36:25
Table 'RushAndCash319502' 6-max Seat #1 is the button
Seat 1: 23cd8de ($12.5 in chips)
Seat 2: Hero ($27.17 in chips)
Seat 3: ea5eba95 ($95.77 in chips)
Seat 4: 8466ae26 ($25.36 in chips)
Seat 5: 9b358964 ($26.26 in chips)
Seat 6: 928a94bb ($25 in chips)
Hero: posts small blind $0.1
ea5eba95: posts big blind $0.25
*** HOLE CARDS ***
Dealt to 23cd8de 
Dealt to Hero [Qc 7h]
Dealt to ea5eba95 
Dealt to 8466ae26 
Dealt to 9b358964 
Dealt to 928a94bb 
8466ae26: folds
9b358964: folds
928a94bb: raises $0.38 to $0.63
23cd8de: folds
Hero: folds
ea5eba95: raises $1.97 to $2.6
928a94bb: calls $1.97
*** FLOP *** [6c Kc 7s]
ea5eba95: bets $1.8
928a94bb: calls $1.8
*** TURN *** [6c Kc 7s] [4h]
ea5eba95: checks
928a94bb: bets $3.75
ea5eba95: calls $3.75
*** RIVER *** [6c Kc 7s 4h] [9h]
ea5eba95: checks
928a94bb: bets $16.85 and is all-in
ea5eba95: calls $16.85
928a94bb: shows [Kh Ks] (Three Kings)
ea5eba95: shows [Kd Ah] (Pair of Kings)
*** SHOWDOWN ***
928a94bb collected $50.1 from pot
*** SUMMARY ***
Total pot $50.1
Board [6c Kc 7s 4h 9h]
Seat 1: 23cd8de (button) folded before Flop (didn't bet)
Seat 2: Hero (small blind) folded before Flop
Seat 3: ea5eba95 (big blind) showed [Ah Kd] and lost with Pair of Kings
Seat 4: 8466ae26 folded before Flop (didn't bet)
Seat 5: 9b358964 folded before Flop (didn't bet)
Seat 6: 928a94bb showed [Ks Kh] and won ($50.1) with Three Kings


Poker Hand #RC94795863: Hold'em No Limit ($0.1/$0.25) - 2020/04/06 23:36:28
Table 'RushAndCash319505' 6-max Seat #1 is the button
Seat 1: a3949718 ($11.25 in chips)
Seat 2: Hero ($27.07 in chips)
Seat 3: 38359122 ($18.48 in chips)
Seat 4: cce649b7 ($32.81 in chips)
Seat 5: 41ab7510 ($26.02 in chips)
Seat 6: cf8c7400 ($25 in chips)
Hero: posts small blind $0.1
38359122: posts big blind $0.25
*** HOLE CARDS ***
Dealt to a3949718 
Dealt to Hero [Ac 2d]
Dealt to 38359122 
Dealt to cce649b7 
Dealt to 41ab7510 
Dealt to cf8c7400 
cce649b7: folds
41ab7510: folds
cf8c7400: raises $0.38 to $0.63
a3949718: folds
Hero: folds
38359122: folds
Uncalled bet ($0.38) returned to cf8c7400
*** SHOWDOWN ***
cf8c7400 collected $0.6 from pot
*** SUMMARY ***
Total pot $0.6
Seat 1: a3949718 (button) folded before Flop (didn't bet)
Seat 2: Hero (small blind) folded before Flop
Seat 3: 38359122 (big blind) folded before Flop
Seat 4: cce649b7 folded before Flop (didn't bet)
Seat 5: 41ab7510 folded before Flop (didn't bet)
Seat 6: cf8c7400 collected ($0.6)


Poker Hand #RC94795884: Hold'em No Limit ($0.1/$0.25) - 2020/04/06 23:36:33
Table 'RushAndCash319508' 6-max Seat #1 is the button
Seat 1: 9d598a03 ($48.76 in chips)
Seat 2: 90609fad ($56.24 in chips)
Seat 3: eeae3d7 ($10 in chips)
Seat 4: 17480666 ($106.54 in chips)
Seat 5: e58da42d ($35.42 in chips)
Seat 6: Hero ($26.97 in chips)
90609fad: posts small blind $0.1
eeae3d7: posts big blind $0.25
*** HOLE CARDS ***
Dealt to 9d598a03 
Dealt to 90609fad 
Dealt to eeae3d7 
Dealt to 17480666 
Dealt to e58da42d 
Dealt to Hero [Td 3c]
17480666: folds
e58da42d: folds
Hero: folds
9d598a03: folds
90609fad: folds
Uncalled bet ($0.15) returned to eeae3d7
*** SHOWDOWN ***
eeae3d7 collected $0.2 from pot
*** SUMMARY ***
Total pot $0.2
Seat 1: 9d598a03 (button) folded before Flop (didn't bet)
Seat 2: 90609fad (small blind) folded before Flop
Seat 3: eeae3d7 (big blind) collected ($0.2)
Seat 4: 17480666 folded before Flop (didn't bet)
Seat 5: e58da42d folded before Flop (didn't bet)
Seat 6: Hero folded before Flop (didn't bet)


Poker Hand #RC94795898: Hold'em No Limit ($0.1/$0.25) - 2020/04/06 23:36:36
Table 'RushAndCash319511' 6-max Seat #1 is the button
Seat 1: 1bc051b2 ($12 in chips)
Seat 2: 8a31aea7 ($75.63 in chips)
Seat 3: 41459cc9 ($25.67 in chips)
Seat 4: Hero ($26.97 in chips)
Seat 5: ca69da65 ($35.21 in chips)
Seat 6: 969ce17 ($31.3 in chips)
8a31aea7: posts small blind $0.1
41459cc9: posts big blind $0.25
*** HOLE CARDS ***
Dealt to 1bc051b2 
Dealt to 8a31aea7 
Dealt to 41459cc9 
Dealt to Hero [Th 5d]
Dealt to ca69da65 
Dealt to 969ce17 
Hero: folds
ca69da65: folds
969ce17: folds
1bc051b2: raises $0.25 to $0.5
8a31aea7: folds
41459cc9: calls $0.25
*** FLOP *** [Kd Qd Ks]
41459cc9: checks
1bc051b2: bets $0.4
41459cc9: folds
Uncalled bet ($0.4) returned to 1bc051b2
*** SHOWDOWN ***
1bc051b2 collected $1.1 from pot
*** SUMMARY ***
Total pot $1.1
Board [Kd Qd Ks]
Seat 1: 1bc051b2 (button) won ($1.1)
Seat 2: 8a31aea7 (small blind) folded before Flop
Seat 3: 41459cc9 (big blind) folded on the Flop
Seat 4: Hero folded before Flop (didn't bet)
Seat 5: ca69da65 folded before Flop (didn't bet)
Seat 6: 969ce17 folded before Flop (didn't bet)


Poker Hand #RC94795921: Hold'em No Limit ($0.1/$0.25) - 2020/04/06 23:36:40
Table 'RushAndCash319515' 6-max Seat #1 is the button
Seat 1: Hero ($26.97 in chips)
Seat 2: 8f2f88a4 ($50.49 in chips)
Seat 3: ba032eea ($56.39 in chips)
Seat 4: e64b2cd5 ($13.2 in chips)
Seat 5: cc4afcf8 ($4.07 in chips)
Seat 6: e767af3b ($25 in chips)
8f2f88a4: posts small blind $0.1
ba032eea: posts big blind $0.25
*** HOLE CARDS ***
Dealt to Hero [Th 6s]
Dealt to 8f2f88a4 
Dealt to ba032eea 
Dealt to e64b2cd5 
Dealt to cc4afcf8 
Dealt to e767af3b 
e64b2cd5: folds
cc4afcf8: folds
e767af3b: folds
Hero: folds
8f2f88a4: folds
Uncalled bet ($0.15) returned to ba032eea
*** SHOWDOWN ***
ba032eea collected $0.2 from pot
*** SUMMARY ***
Total pot $0.2
Seat 1: Hero (button) folded before Flop (didn't bet)
Seat 2: 8f2f88a4 (small blind) folded before Flop
Seat 3: ba032eea (big blind) collected ($0.2)
Seat 4: e64b2cd5 folded before Flop (didn't bet)
Seat 5: cc4afcf8 folded before Flop (didn't bet)
Seat 6: e767af3b folded before Flop (didn't bet)


Poker Hand #RC94795949: Hold'em No Limit ($0.1/$0.25) - 2020/04/06 23:36:46
Table 'RushAndCash319520' 6-max Seat #1 is the button
Seat 1: d7f99a39 ($8.47 in chips)
Seat 2: b215699c ($64.44 in chips)
Seat 3: Hero ($26.97 in chips)
Seat 4: 23cd8de ($12.5 in chips)
Seat 5: e767af3b ($25 in chips)
Seat 6: 2467bb49 ($52.28 in chips)
b215699c: posts small blind $0.1
Hero: posts big blind $0.25
*** HOLE CARDS ***
Dealt to d7f99a39 
Dealt to b215699c 
Dealt to Hero [Tc 2c]
Dealt to 23cd8de 
Dealt to e767af3b 
Dealt to 2467bb49 
23cd8de: folds
e767af3b: folds
2467bb49: folds
d7f99a39: folds
b215699c: raises $0.25 to $0.5
Hero: folds
Uncalled bet ($0.25) returned to b215699c
*** SHOWDOWN ***
b215699c collected $0.5 from pot
*** SUMMARY ***
Total pot $0.5
Seat 1: d7f99a39 (button) folded before Flop (didn't bet)
Seat 2: b215699c (small blind) collected ($0.5)
Seat 3: Hero (big blind) folded before Flop
Seat 4: 23cd8de folded before Flop (didn't bet)
Seat 5: e767af3b folded before Flop (didn't bet)
Seat 6: 2467bb49 folded before Flop (didn't bet)


Poker Hand #RC94795962: Hold'em No Limit ($0.1/$0.25) - 2020/04/06 23:36:48
Table 'RushAndCash319522' 6-max Seat #1 is the button
Seat 1: 969ce17 ($31.3 in chips)
Seat 2: bc200877 ($8.32 in chips)
Seat 3: ca69da65 ($35.21 in chips)
Seat 4: 604f36f0 ($17.44 in chips)
Seat 5: Hero ($26.72 in chips)
Seat 6: fd369e31 ($60.23 in chips)
bc200877: posts small blind $0.1
ca69da65: posts big blind $0.25
*** HOLE CARDS ***
Dealt to 969ce17 
Dealt to bc200877 
Dealt to ca69da65 
Dealt to 604f36f0 
Dealt to Hero [Tc 8h]
Dealt to fd369e31 
604f36f0: folds
Hero: folds
fd369e31: folds
969ce17: raises $0.5 to $0.75
bc200877: calls $0.65
ca69da65: raises $3 to $3.75
969ce17: folds
bc200877: folds
Uncalled bet ($3) returned to ca69da65
*** SHOWDOWN ***
ca69da65 collected $2.25 from pot
*** SUMMARY ***
Total pot $2.25
Seat 1: 969ce17 (button) folded before Flop
Seat 2: bc200877 (small blind) folded before Flop
Seat 3: ca69da65 (big blind) collected ($2.25)
Seat 4: 604f36f0 folded before Flop (didn't bet)
Seat 5: Hero folded before Flop (didn't bet)
Seat 6: fd369e31 folded before Flop (didn't bet)


Poker Hand #RC94795984: Hold'em No Limit ($0.1/$0.25) - 2020/04/06 23:36:52
Table 'RushAndCash319525' 6-max Seat #1 is the button
Seat 1: 9d598a03 ($48.76 in chips)
Seat 2: c63a382b ($29.06 in chips)
Seat 3: 8abd2614 ($14.46 in chips)
Seat 4: Hero ($26.72 in chips)
Seat 5: 604f36f0 ($17.44 in chips)
Seat 6: eeae3d7 ($10.1 in chips)
c63a382b: posts small blind $0.1
8abd2614: posts big blind $0.25
*** HOLE CARDS ***
Dealt to 9d598a03 
Dealt to c63a382b 
Dealt to 8abd2614 
Dealt to Hero [Th 8c]
Dealt to 604f36f0 
Dealt to eeae3d7 
Hero: folds
604f36f0: folds
eeae3d7: folds
9d598a03: folds
c63a382b: raises $0.5 to $0.75
8abd2614: folds
Uncalled bet ($0.5) returned to c63a382b
*** SHOWDOWN ***
c63a382b collected $0.5 from pot
*** SUMMARY ***
Total pot $0.5
Seat 1: 9d598a03 (button) folded before Flop (didn't bet)
Seat 2: c63a382b (small blind) collected ($0.5)
Seat 3: 8abd2614 (big blind) folded before Flop
Seat 4: Hero folded before Flop (didn't bet)
Seat 5: 604f36f0 folded before Flop (didn't bet)
Seat 6: eeae3d7 folded before Flop (didn't bet)


Poker Hand #RC94796004: Hold'em No Limit ($0.1/$0.25) - 2020/04/06 23:36:56
Table 'RushAndCash319528' 6-max Seat #1 is the button
Seat 1: Hero ($26.72 in chips)
Seat 2: e64b2cd5 ($13.2 in chips)
Seat 3: c8c1c85c ($12.5 in chips)
Seat 4: d7bbc6af ($28.37 in chips)
Seat 5: 604f36f0 ($17.44 in chips)
Seat 6: 94efc628 ($25 in chips)
e64b2cd5: posts small blind $0.1
c8c1c85c: posts big blind $0.25
*** HOLE CARDS ***
Dealt to Hero [Ks 9c]
Dealt to e64b2cd5 
Dealt to c8c1c85c 
Dealt to d7bbc6af 
Dealt to 604f36f0 
Dealt to 94efc628 
d7bbc6af: folds
604f36f0: folds
94efc628: folds
Hero: folds
e64b2cd5: raises $0.5 to $0.75
c8c1c85c: folds
Uncalled bet ($0.5) returned to e64b2cd5
*** SHOWDOWN ***
e64b2cd5 collected $0.5 from pot
*** SUMMARY ***
Total pot $0.5
Seat 1: Hero (button) folded before Flop (didn't bet)
Seat 2: e64b2cd5 (small blind) collected ($0.5)
Seat 3: c8c1c85c (big blind) folded before Flop
Seat 4: d7bbc6af folded before Flop (didn't bet)
Seat 5: 604f36f0 folded before Flop (didn't bet)
Seat 6: 94efc628 folded before Flop (didn't bet)


Poker Hand #RC94796021: Hold'em No Limit ($0.1/$0.25) - 2020/04/06 23:37:00
Table 'RushAndCash319530' 6-max Seat #1 is the button
Seat 1: 8e166af5 ($29.01 in chips)
Seat 2: dfcfe0b3 ($34.13 in chips)
Seat 3: e58da42d ($35.42 in chips)
Seat 4: 9c511c89 ($12.5 in chips)
Seat 5: fd369e31 ($60.23 in chips)
Seat 6: Hero ($26.72 in chips)
dfcfe0b3: posts small blind $0.1
e58da42d: posts big blind $0.25
*** HOLE CARDS ***
Dealt to 8e166af5 
Dealt to dfcfe0b3 
Dealt to e58da42d 
Dealt to 9c511c89 
Dealt to fd369e31 
Dealt to Hero [Qc 4c]
9c511c89: folds
fd369e31: folds
Hero: folds
8e166af5: raises $0.5 to $0.75
dfcfe0b3: raises $1.95 to $2.7
e58da42d: folds
8e166af5: raises $3.8 to $6.5
dfcfe0b3: raises $27.63 to $34.13 and is all-in
8e166af5: calls $22.51 and is all-in
Uncalled bet ($5.12) returned to dfcfe0b3
dfcfe0b3: shows [Kd Ac]
8e166af5: shows [Ah As]
*** FIRST FLOP *** [9s Jc 7s]
*** FIRST TURN *** [9s Jc 7s] [4d]
*** FIRST RIVER *** [9s Jc 7s 4d] [2c]
*** SECOND FLOP *** [Js 8c 5s]
*** SECOND TURN *** [Js 8c 5s] [3d]
*** SECOND RIVER *** [Js 8c 5s 3d] [4s]
*** FIRST SHOWDOWN ***
8e166af5 collected $29.13 from pot
*** SECOND SHOWDOWN ***
8e166af5 collected $29.13 from pot
*** SUMMARY ***
Total pot $58.27
Hand was run two times
FIRST Board [9s Jc 7s 4d 2c]
SECOND Board [Js 8c 5s 3d 4s]
Seat 1: 8e166af5 (button) showed [As Ah] and won ($29.13) with Pair of Aces, and won ($29.13) with Pair of Aces
Seat 2: dfcfe0b3 (small blind) showed [Ac Kd] and lost with Ace-High, and lost with Ace-High
Seat 3: e58da42d (big blind) folded before Flop
Seat 4: 9c511c89 folded before Flop (didn't bet)
Seat 5: fd369e31 folded before Flop (didn't bet)
Seat 6: Hero folded before Flop (didn't bet)


Poker Hand #RC94796038: Hold'em No Limit ($0.1/$0.25) - 2020/04/06 23:37:04
Table 'RushAndCash319532' 6-max Seat #1 is the button
Seat 1: 8466ae26 ($25.01 in chips)
Seat 2: c8c1c85c ($12.5 in chips)
Seat 3: fe7c9e7a ($27.82 in chips)
Seat 4: 8a31aea7 ($75.43 in chips)
Seat 5: Hero ($26.72 in chips)
Seat 6: a3949718 ($11.25 in chips)
c8c1c85c: posts small blind $0.1
fe7c9e7a: posts big blind $0.25
*** HOLE CARDS ***
Dealt to 8466ae26 
Dealt to c8c1c85c 
Dealt to fe7c9e7a 
Dealt to 8a31aea7 
Dealt to Hero [Jh 6d]
Dealt to a3949718 
8a31aea7: folds
Hero: folds
a3949718: raises $0.38 to $0.63
8466ae26: folds
c8c1c85c: folds
fe7c9e7a: folds
Uncalled bet ($0.38) returned to a3949718
*** SHOWDOWN ***
a3949718 collected $0.6 from pot
*** SUMMARY ***
Total pot $0.6
Seat 1: 8466ae26 (button) folded before Flop (didn't bet)
Seat 2: c8c1c85c (small blind) folded before Flop
Seat 3: fe7c9e7a (big blind) folded before Flop
Seat 4: 8a31aea7 folded before Flop (didn't bet)
Seat 5: Hero folded before Flop (didn't bet)
Seat 6: a3949718 collected ($0.6)


Poker Hand #RC94796059: Hold'em No Limit ($0.1/$0.25) - 2020/04/06 23:37:08
Table 'RushAndCash319535' 6-max Seat #1 is the button
Seat 1: afa5143c ($33.71 in chips)
Seat 2: 9c511c89 ($12.5 in chips)
Seat 3: e44fce1a ($25.56 in chips)
Seat 4: ba032eea ($56.39 in chips)
Seat 5: Hero ($26.72 in chips)
Seat 6: 8a31aea7 ($75.43 in chips)
9c511c89: posts small blind $0.1
e44fce1a: posts big blind $0.25
*** HOLE CARDS ***
Dealt to afa5143c 
Dealt to 9c511c89 
Dealt to e44fce1a 
Dealt to ba032eea 
Dealt to Hero [Ad 2c]
Dealt to 8a31aea7 
ba032eea: folds
Hero: folds
8a31aea7: raises $0.38 to $0.63
afa5143c: folds
9c511c89: folds
e44fce1a: calls $0.38
*** FLOP *** [8h Kh 2d]
e44fce1a: checks
8a31aea7: bets $0.5
e44fce1a: folds
Uncalled bet ($0.5) returned to 8a31aea7
*** SHOWDOWN ***
8a31aea7 collected $1.36 from pot
*** SUMMARY ***
Total pot $1.36
Board [8h Kh 2d]
Seat 1: afa5143c (button) folded before Flop (didn't bet)
Seat 2: 9c511c89 (small blind) folded before Flop
Seat 3: e44fce1a (big blind) folded on the Flop
Seat 4: ba032eea folded before Flop (didn't bet)
Seat 5: Hero folded before Flop (didn't bet)
Seat 6: 8a31aea7 won ($1.36)


Poker Hand #RC94796074: Hold'em No Limit ($0.1/$0.25) - 2020/04/06 23:37:12
Table 'RushAndCash319537' 6-max Seat #1 is the button
Seat 1: c8c1c85c ($12.5 in chips)
Seat 2: 41459cc9 ($25.17 in chips)
Seat 3: b9bbf733 ($25 in chips)
Seat 4: 94efc628 ($25 in chips)
Seat 5: Hero ($26.72 in chips)
Seat 6: 1bc051b2 ($12.55 in chips)
41459cc9: posts small blind $0.1
b9bbf733: posts big blind $0.25
*** HOLE CARDS ***
Dealt to c8c1c85c 
Dealt to 41459cc9 
Dealt to b9bbf733 
Dealt to 94efc628 
Dealt to Hero [6c 2d]
Dealt to 1bc051b2 
94efc628: folds
Hero: folds
1bc051b2: folds
c8c1c85c: folds
41459cc9: folds
Uncalled bet ($0.15) returned to b9bbf733
*** SHOWDOWN ***
b9bbf733 collected $0.2 from pot
*** SUMMARY ***
Total pot $0.2
Seat 1: c8c1c85c (button) folded before Flop (didn't bet)
Seat 2: 41459cc9 (small blind) folded before Flop
Seat 3: b9bbf733 (big blind) collected ($0.2)
Seat 4: 94efc628 folded before Flop (didn't bet)
Seat 5: Hero folded before Flop (didn't bet)
Seat 6: 1bc051b2 folded before Flop (didn't bet)


Poker Hand #RC94796092: Hold'em No Limit ($0.1/$0.25) - 2020/04/06 23:37:14
Table 'RushAndCash319540' 6-max Seat #1 is the button
Seat 1: ba032eea ($56.39 in chips)
Seat 2: 9d598a03 ($48.66 in chips)
Seat 3: Hero ($26.72 in chips)
Seat 4: 8466ae26 ($25.01 in chips)
Seat 5: c63a382b ($29.31 in chips)
Seat 6: 2904eaa2 ($25 in chips)
9d598a03: posts small blind $0.1
Hero: posts big blind $0.25
*** HOLE CARDS ***
Dealt to ba032eea 
Dealt to 9d598a03 
Dealt to Hero [Qd 9d]
Dealt to 8466ae26 
Dealt to c63a382b 
Dealt to 2904eaa2 
8466ae26: folds
c63a382b: folds
2904eaa2: folds
ba032eea: raises $0.38 to $0.63
9d598a03: folds
Hero: folds
Uncalled bet ($0.38) returned to ba032eea
*** SHOWDOWN ***
ba032eea collected $0.6 from pot
*** SUMMARY ***
Total pot $0.6
Seat 1: ba032eea (button) collected ($0.6)
Seat 2: 9d598a03 (small blind) folded before Flop
Seat 3: Hero (big blind) folded before Flop
Seat 4: 8466ae26 folded before Flop (didn't bet)
Seat 5: c63a382b folded before Flop (didn't bet)
Seat 6: 2904eaa2 folded before Flop (didn't bet)


Poker Hand #RC94796174: Hold'em No Limit ($0.1/$0.25) - 2020/04/06 23:37:31
Table 'RushAndCash319552' 6-max Seat #1 is the button
Seat 1: cc4afcf8 ($4.42 in chips)
Seat 2: Hero ($26.47 in chips)
Seat 3: 969ce17 ($30.55 in chips)
Seat 4: e64b2cd5 ($13.55 in chips)
Seat 5: bd6eeaf3 ($55.93 in chips)
Seat 6: d8a224aa ($32.74 in chips)
Hero: posts small blind $0.1
969ce17: posts big blind $0.25
*** HOLE CARDS ***
Dealt to cc4afcf8 
Dealt to Hero [5d 3d]
Dealt to 969ce17 
Dealt to e64b2cd5 
Dealt to bd6eeaf3 
Dealt to d8a224aa 
e64b2cd5: folds
bd6eeaf3: folds
d8a224aa: raises $0.38 to $0.63
cc4afcf8: folds
Hero: folds
969ce17: calls $0.38
*** FLOP *** [2c Ks 2s]
969ce17: checks
d8a224aa: bets $0.5
969ce17: calls $0.5
*** TURN *** [2c Ks 2s] [3s]
969ce17: bets $1.6
d8a224aa: calls $1.6
*** RIVER *** [2c Ks 2s 3s] [8c]
969ce17: bets $3.7
d8a224aa: calls $3.7
969ce17: shows [8s Qs] (King High Flush)
d8a224aa: shows [Js Kh] (Pair of Kings and Pair of Twos)
*** SHOWDOWN ***
969ce17 collected $12.96 from pot
*** SUMMARY ***
Total pot $12.96
Board [2c Ks 2s 3s 8c]
Seat 1: cc4afcf8 (button) folded before Flop (didn't bet)
Seat 2: Hero (small blind) folded before Flop
Seat 3: 969ce17 (big blind) showed [Qs 8s] and won ($12.96) with King High Flush
Seat 4: e64b2cd5 folded before Flop (didn't bet)
Seat 5: bd6eeaf3 folded before Flop (didn't bet)
Seat 6: d8a224aa showed [Kh Js] and lost with Pair of Kings and Pair of Twos


Poker Hand #RC94796193: Hold'em No Limit ($0.1/$0.25) - 2020/04/06 23:37:34
Table 'RushAndCash319555' 6-max Seat #1 is the button
Seat 1: Hero ($26.37 in chips)
Seat 2: 58b04451 ($23.4 in chips)
Seat 3: e0680a48 ($74.72 in chips)
Seat 4: 312f6846 ($25 in chips)
Seat 5: 90609fad ($53.74 in chips)
Seat 6: 8fb93df3 ($34.86 in chips)
58b04451: posts small blind $0.1
e0680a48: posts big blind $0.25
*** HOLE CARDS ***
Dealt to Hero [Js Tc]
Dealt to 58b04451 
Dealt to e0680a48 
Dealt to 312f6846 
Dealt to 90609fad 
Dealt to 8fb93df3 
312f6846: folds
90609fad: folds
8fb93df3: folds
Hero: folds
58b04451: folds
Uncalled bet ($0.15) returned to e0680a48
*** SHOWDOWN ***
e0680a48 collected $0.2 from pot
*** SUMMARY ***
Total pot $0.2
Seat 1: Hero (button) folded before Flop (didn't bet)
Seat 2: 58b04451 (small blind) folded before Flop
Seat 3: e0680a48 (big blind) collected ($0.2)
Seat 4: 312f6846 folded before Flop (didn't bet)
Seat 5: 90609fad folded before Flop (didn't bet)
Seat 6: 8fb93df3 folded before Flop (didn't bet)


Poker Hand #RC94796215: Hold'em No Limit ($0.1/$0.25) - 2020/04/06 23:37:39
Table 'RushAndCash319560' 6-max Seat #1 is the button
Seat 1: d7bbc6af ($28.02 in chips)
Seat 2: ff501d94 ($13.37 in chips)
Seat 3: afa5143c ($33.71 in chips)
Seat 4: Hero ($26.37 in chips)
Seat 5: b9bbf733 ($25.1 in chips)
Seat 6: 1bc051b2 ($12.55 in chips)
ff501d94: posts small blind $0.1
afa5143c: posts big blind $0.25
*** HOLE CARDS ***
Dealt to d7bbc6af 
Dealt to ff501d94 
Dealt to afa5143c 
Dealt to Hero [As 2c]
Dealt to b9bbf733 
Dealt to 1bc051b2 
Hero: folds
b9bbf733: folds
1bc051b2: folds
d7bbc6af: folds
ff501d94: folds
Uncalled bet ($0.15) returned to afa5143c
*** SHOWDOWN ***
afa5143c collected $0.2 from pot
*** SUMMARY ***
Total pot $0.2
Seat 1: d7bbc6af (button) folded before Flop (didn't bet)
Seat 2: ff501d94 (small blind) folded before Flop
Seat 3: afa5143c (big blind) collected ($0.2)
Seat 4: Hero folded before Flop (didn't bet)
Seat 5: b9bbf733 folded before Flop (didn't bet)
Seat 6: 1bc051b2 folded before Flop (didn't bet)


Poker Hand #RC94796235: Hold'em No Limit ($0.1/$0.25) - 2020/04/06 23:37:42
Table 'RushAndCash319564' 6-max Seat #1 is the button
Seat 1: 72fa991e ($38.09 in chips)
Seat 2: Hero ($26.37 in chips)
Seat 3: 522e695b ($4.21 in chips)
Seat 4: 99d6d386 ($25 in chips)
Seat 5: 9d598a03 ($48.46 in chips)
Seat 6: 7ae5ca25 ($12.5 in chips)
Hero: posts small blind $0.1
522e695b: posts big blind $0.25
*** HOLE CARDS ***
Dealt to 72fa991e 
Dealt to Hero [8d 7d]
Dealt to 522e695b 
Dealt to 99d6d386 
Dealt to 9d598a03 
Dealt to 7ae5ca25 
99d6d386: folds
9d598a03: folds
7ae5ca25: folds
72fa991e: raises $0.38 to $0.63
Hero: folds
522e695b: folds
Uncalled bet ($0.38) returned to 72fa991e
*** SHOWDOWN ***
72fa991e collected $0.6 from pot
*** SUMMARY ***
Total pot $0.6
Seat 1: 72fa991e (button) collected ($0.6)
Seat 2: Hero (small blind) folded before Flop
Seat 3: 522e695b (big blind) folded before Flop
Seat 4: 99d6d386 folded before Flop (didn't bet)
Seat 5: 9d598a03 folded before Flop (didn't bet)
Seat 6: 7ae5ca25 folded before Flop (didn't bet)


Poker Hand #RC94796338: Hold'em No Limit ($0.1/$0.25) - 2020/04/06 23:38:03
Table 'RushAndCash319579' 6-max Seat #1 is the button
Seat 1: ff501d94 ($12.92 in chips)
Seat 2: 8abd2614 ($14.46 in chips)
Seat 3: 8e166af5 ($57.27 in chips)
Seat 4: dfcfe0b3 ($25 in chips)
Seat 5: Hero ($26.27 in chips)
Seat 6: 58b04451 ($23.65 in chips)
8abd2614: posts small blind $0.1
8e166af5: posts big blind $0.25
*** HOLE CARDS ***
Dealt to ff501d94 
Dealt to 8abd2614 
Dealt to 8e166af5 
Dealt to dfcfe0b3 
Dealt to Hero [Qs Qd]
Dealt to 58b04451 
dfcfe0b3: folds
Hero: raises $0.38 to $0.63
58b04451: folds
ff501d94: raises $1.38 to $2.01
8abd2614: folds
8e166af5: folds
Hero: raises $3.24 to $5.25
ff501d94: calls $3.24
*** FLOP *** [8s 7h Kd]
Hero: bets $7.75
ff501d94: folds
Uncalled bet ($7.75) returned to Hero
*** SHOWDOWN ***
Hero collected $10.85 from pot
*** SUMMARY ***
Total pot $10.85
Board [8s 7h Kd]
Seat 1: ff501d94 (button) folded on the Flop
Seat 2: 8abd2614 (small blind) folded before Flop
Seat 3: 8e166af5 (big blind) folded before Flop
Seat 4: dfcfe0b3 folded before Flop (didn't bet)
Seat 5: Hero won ($10.85)
Seat 6: 58b04451 folded before Flop (didn't bet)


Poker Hand #RC94796575: Hold'em No Limit ($0.1/$0.25) - 2020/04/06 23:38:49
Table 'RushAndCash319608' 6-max Seat #1 is the button
Seat 1: 7357eb2f ($49 in chips)
Seat 2: ca69da65 ($37.05 in chips)
Seat 3: Hero ($31.08 in chips)
Seat 4: ff501d94 ($7.67 in chips)
Seat 5: 9c511c89 ($12.5 in chips)
Seat 6: 41459cc9 ($25 in chips)
ca69da65: posts small blind $0.1
Hero: posts big blind $0.25
*** HOLE CARDS ***
Dealt to 7357eb2f 
Dealt to ca69da65 
Dealt to Hero [Ac 9d]
Dealt to ff501d94 
Dealt to 9c511c89 
Dealt to 41459cc9 
ff501d94: raises $0.63 to $0.88
9c511c89: folds
41459cc9: folds
7357eb2f: folds
ca69da65: folds
Hero: folds
Uncalled bet ($0.63) returned to ff501d94
*** SHOWDOWN ***
ff501d94 collected $0.6 from pot
*** SUMMARY ***
Total pot $0.6
Seat 1: 7357eb2f (button) folded before Flop (didn't bet)
Seat 2: ca69da65 (small blind) folded before Flop
Seat 3: Hero (big blind) folded before Flop
Seat 4: ff501d94 collected ($0.6)
Seat 5: 9c511c89 folded before Flop (didn't bet)
Seat 6: 41459cc9 folded before Flop (didn't bet)


Poker Hand #RC94796594: Hold'em No Limit ($0.1/$0.25) - 2020/04/06 23:38:53
Table 'RushAndCash319611' 6-max Seat #1 is the button
Seat 1: Hero ($30.83 in chips)
Seat 2: fe7c9e7a ($26.92 in chips)
Seat 3: 9d598a03 ($52.62 in chips)
Seat 4: 9afeb2a7 ($30.02 in chips)
Seat 5: 8466ae26 ($25 in chips)
Seat 6: e58da42d ($25 in chips)
fe7c9e7a: posts small blind $0.1
9d598a03: posts big blind $0.25
*** HOLE CARDS ***
Dealt to Hero [Kc 4h]
Dealt to fe7c9e7a 
Dealt to 9d598a03 
Dealt to 9afeb2a7 
Dealt to 8466ae26 
Dealt to e58da42d 
9afeb2a7: folds
8466ae26: folds
e58da42d: raises $0.38 to $0.63
Hero: folds
fe7c9e7a: folds
9d598a03: folds
Uncalled bet ($0.38) returned to e58da42d
*** SHOWDOWN ***
e58da42d collected $0.6 from pot
*** SUMMARY ***
Total pot $0.6
Seat 1: Hero (button) folded before Flop (didn't bet)
Seat 2: fe7c9e7a (small blind) folded before Flop
Seat 3: 9d598a03 (big blind) folded before Flop
Seat 4: 9afeb2a7 folded before Flop (didn't bet)
Seat 5: 8466ae26 folded before Flop (didn't bet)
Seat 6: e58da42d collected ($0.6)


Poker Hand #RC94796612: Hold'em No Limit ($0.1/$0.25) - 2020/04/06 23:38:57
Table 'RushAndCash319614' 6-max Seat #1 is the button
Seat 1: b00dbb18 ($36.58 in chips)
Seat 2: 23cd8de ($12.5 in chips)
Seat 3: 9e9b6fda ($25 in chips)
Seat 4: 41459cc9 ($25 in chips)
Seat 5: Hero ($30.83 in chips)
Seat 6: fe7c9e7a ($26.82 in chips)
23cd8de: posts small blind $0.1
9e9b6fda: posts big blind $0.25
*** HOLE CARDS ***
Dealt to b00dbb18 
Dealt to 23cd8de 
Dealt to 9e9b6fda 
Dealt to 41459cc9 
Dealt to Hero [Ac 7c]
Dealt to fe7c9e7a 
41459cc9: folds
Hero: raises $0.38 to $0.63
fe7c9e7a: folds
b00dbb18: folds
23cd8de: folds
9e9b6fda: folds
Uncalled bet ($0.38) returned to Hero
*** SHOWDOWN ***
Hero collected $0.6 from pot
*** SUMMARY ***
Total pot $0.6
Seat 1: b00dbb18 (button) folded before Flop (didn't bet)
Seat 2: 23cd8de (small blind) folded before Flop
Seat 3: 9e9b6fda (big blind) folded before Flop
Seat 4: 41459cc9 folded before Flop (didn't bet)
Seat 5: Hero collected ($0.6)
Seat 6: fe7c9e7a folded before Flop (didn't bet)


Poker Hand #RC94796694: Hold'em No Limit ($0.1/$0.25) - 2020/04/06 23:39:15
Table 'RushAndCash319629' 6-max Seat #1 is the button
Seat 1: ba032eea ($56.6 in chips)
Seat 2: Hero ($31.18 in chips)
Seat 3: e44fce1a ($24.18 in chips)
Seat 4: e0680a48 ($75.29 in chips)
Seat 5: 1d6fff9c ($27.32 in chips)
Seat 6: 41ab7510 ($27.76 in chips)
Hero: posts small blind $0.1
e44fce1a: posts big blind $0.25
*** HOLE CARDS ***
Dealt to ba032eea 
Dealt to Hero [Qs Th]
Dealt to e44fce1a 
Dealt to e0680a48 
Dealt to 1d6fff9c 
Dealt to 41ab7510 
e0680a48: folds
1d6fff9c: folds
41ab7510: folds
ba032eea: folds
Hero: folds
Uncalled bet ($0.15) returned to e44fce1a
*** SHOWDOWN ***
e44fce1a collected $0.2 from pot
*** SUMMARY ***
Total pot $0.2
Seat 1: ba032eea (button) folded before Flop (didn't bet)
Seat 2: Hero (small blind) folded before Flop
Seat 3: e44fce1a (big blind) collected ($0.2)
Seat 4: e0680a48 folded before Flop (didn't bet)
Seat 5: 1d6fff9c folded before Flop (didn't bet)
Seat 6: 41ab7510 folded before Flop (didn't bet)


Poker Hand #RC94796713: Hold'em No Limit ($0.1/$0.25) - 2020/04/06 23:39:19
Table 'RushAndCash319632' 6-max Seat #1 is the button
Seat 1: 9e9b6fda ($24.65 in chips)
Seat 2: b00dbb18 ($36.68 in chips)
Seat 3: 58b04451 ($24.23 in chips)
Seat 4: 7357eb2f ($48.65 in chips)
Seat 5: Hero ($31.08 in chips)
Seat 6: 2467bb49 ($53.55 in chips)
b00dbb18: posts small blind $0.1
58b04451: posts big blind $0.25
*** HOLE CARDS ***
Dealt to 9e9b6fda 
Dealt to b00dbb18 
Dealt to 58b04451 
Dealt to 7357eb2f 
Dealt to Hero [4h 3s]
Dealt to 2467bb49 
7357eb2f: folds
Hero: folds
2467bb49: raises $0.38 to $0.63
9e9b6fda: raises $1.48 to $2.11
b00dbb18: folds
58b04451: calls $1.86
2467bb49: raises $3.23 to $5.34
9e9b6fda: folds
58b04451: calls $3.23
*** FLOP *** [6h 5c Jh]
58b04451: checks
2467bb49: checks
*** TURN *** [6h 5c Jh] [Qd]
58b04451: checks
2467bb49: checks
*** RIVER *** [6h 5c Jh Qd] [7s]
58b04451: checks
2467bb49: bets $48.21 and is all-in
58b04451: folds
Uncalled bet ($48.21) returned to 2467bb49
*** SHOWDOWN ***
2467bb49 collected $12.89 from pot
*** SUMMARY ***
Total pot $12.89
Board [6h 5c Jh Qd 7s]
Seat 1: 9e9b6fda (button) folded before Flop
Seat 2: b00dbb18 (small blind) folded before Flop
Seat 3: 58b04451 (big blind) folded on the River
Seat 4: 7357eb2f folded before Flop (didn't bet)
Seat 5: Hero folded before Flop (didn't bet)
Seat 6: 2467bb49 won ($12.89)


Poker Hand #RC94796727: Hold'em No Limit ($0.1/$0.25) - 2020/04/06 23:39:22
Table 'RushAndCash319636' 6-max Seat #1 is the button
Seat 1: 8fb93df3 ($35.21 in chips)
Seat 2: 64933f7d ($12.5 in chips)
Seat 3: 928a94bb ($52.92 in chips)
Seat 4: 522e695b ($3.56 in chips)
Seat 5: Hero ($31.08 in chips)
Seat 6: 41ab7510 ($27.76 in chips)
64933f7d: posts small blind $0.1
928a94bb: posts big blind $0.25
*** HOLE CARDS ***
Dealt to 8fb93df3 
Dealt to 64933f7d 
Dealt to 928a94bb 
Dealt to 522e695b 
Dealt to Hero [3d 2d]
Dealt to 41ab7510 
522e695b: folds
Hero: folds
41ab7510: folds
8fb93df3: raises $0.38 to $0.63
64933f7d: calls $0.53
928a94bb: folds
*** FLOP *** [2c Kd 3s]
64933f7d: bets $1.2
8fb93df3: calls $1.2
*** TURN *** [2c Kd 3s] [5h]
64933f7d: bets $3
8fb93df3: calls $3
*** RIVER *** [2c Kd 3s 5h] [6h]
64933f7d: bets $7.67 and is all-in
8fb93df3: calls $7.67
64933f7d: shows [Kc Qs] (Pair of Kings)
8fb93df3: shows [Kh 2h] (Pair of Kings and Pair of Twos)
*** SHOWDOWN ***
8fb93df3 collected $25.25 from pot
*** SUMMARY ***
Total pot $25.25
Board [2c Kd 3s 5h 6h]
Seat 1: 8fb93df3 (button) showed [Kh 2h] and won ($25.25) with Pair of Kings and Pair of Twos
Seat 2: 64933f7d (small blind) showed [Kc Qs] and lost with Pair of Kings
Seat 3: 928a94bb (big blind) folded before Flop
Seat 4: 522e695b folded before Flop (didn't bet)
Seat 5: Hero folded before Flop (didn't bet)
Seat 6: 41ab7510 folded before Flop (didn't bet)


Poker Hand #RC94796740: Hold'em No Limit ($0.1/$0.25) - 2020/04/06 23:39:25
Table 'RushAndCash319638' 6-max Seat #1 is the button
Seat 1: 94efc628 ($26.12 in chips)
Seat 2: Hero ($31.08 in chips)
Seat 3: 1bc051b2 ($12.55 in chips)
Seat 4: 72fa991e ($38.79 in chips)
Seat 5: e0680a48 ($75.19 in chips)
Seat 6: 604f36f0 ($15.64 in chips)
Hero: posts small blind $0.1
1bc051b2: posts big blind $0.25
*** HOLE CARDS ***
Dealt to 94efc628 
Dealt to Hero [Qs 4s]
Dealt to 1bc051b2 
Dealt to 72fa991e 
Dealt to e0680a48 
Dealt to 604f36f0 
72fa991e: folds
e0680a48: raises $0.5 to $0.75
604f36f0: folds
94efc628: folds
Hero: folds
1bc051b2: folds
Uncalled bet ($0.5) returned to e0680a48
*** SHOWDOWN ***
e0680a48 collected $0.6 from pot
*** SUMMARY ***
Total pot $0.6
Seat 1: 94efc628 (button) folded before Flop (didn't bet)
Seat 2: Hero (small blind) folded before Flop
Seat 3: 1bc051b2 (big blind) folded before Flop
Seat 4: 72fa991e folded before Flop (didn't bet)
Seat 5: e0680a48 collected ($0.6)
Seat 6: 604f36f0 folded before Flop (didn't bet)


Poker Hand #RC94796761: Hold'em No Limit ($0.1/$0.25) - 2020/04/06 23:39:30
Table 'RushAndCash319642' 6-max Seat #1 is the button
Seat 1: 94efc628 ($26.12 in chips)
Seat 2: fd369e31 ($61.51 in chips)
Seat 3: Hero ($30.98 in chips)
Seat 4: 604f36f0 ($15.64 in chips)
Seat 5: 9c584d7d ($13.92 in chips)
Seat 6: d8a224aa ($25.96 in chips)
fd369e31: posts small blind $0.1
Hero: posts big blind $0.25
*** HOLE CARDS ***
Dealt to 94efc628 
Dealt to fd369e31 
Dealt to Hero [Jc 6d]
Dealt to 604f36f0 
Dealt to 9c584d7d 
Dealt to d8a224aa 
604f36f0: folds
9c584d7d: folds
d8a224aa: folds
94efc628: folds
fd369e31: folds
Uncalled bet ($0.15) returned to Hero
*** SHOWDOWN ***
Hero collected $0.2 from pot
*** SUMMARY ***
Total pot $0.2
Seat 1: 94efc628 (button) folded before Flop (didn't bet)
Seat 2: fd369e31 (small blind) folded before Flop
Seat 3: Hero (big blind) collected ($0.2)
Seat 4: 604f36f0 folded before Flop (didn't bet)
Seat 5: 9c584d7d folded before Flop (didn't bet)
Seat 6: d8a224aa folded before Flop (didn't bet)


Poker Hand #RC94796779: Hold'em No Limit ($0.1/$0.25) - 2020/04/06 23:39:33
Table 'RushAndCash319644' 6-max Seat #1 is the button
Seat 1: 36ac4586 ($54.38 in chips)
Seat 2: 928a94bb ($52.67 in chips)
Seat 3: Hero ($30.73 in chips)
Seat 4: 9afeb2a7 ($30.12 in chips)
Seat 5: e767af3b ($26.02 in chips)
Seat 6: 522e695b ($3.56 in chips)
928a94bb: posts small blind $0.1
Hero: posts big blind $0.25
*** HOLE CARDS ***
Dealt to 36ac4586 
Dealt to 928a94bb 
Dealt to Hero [Kd 6c]
Dealt to 9afeb2a7 
Dealt to e767af3b 
Dealt to 522e695b 
9afeb2a7: folds
e767af3b: folds
522e695b: raises $0.38 to $0.63
36ac4586: folds
928a94bb: folds
Hero: folds
Uncalled bet ($0.38) returned to 522e695b
*** SHOWDOWN ***
522e695b collected $0.6 from pot
*** SUMMARY ***
Total pot $0.6
Seat 1: 36ac4586 (button) folded before Flop (didn't bet)
Seat 2: 928a94bb (small blind) folded before Flop
Seat 3: Hero (big blind) folded before Flop
Seat 4: 9afeb2a7 folded before Flop (didn't bet)
Seat 5: e767af3b folded before Flop (didn't bet)
Seat 6: 522e695b collected ($0.6)


Poker Hand #RC94796796: Hold'em No Limit ($0.1/$0.25) - 2020/04/06 23:39:37
Table 'RushAndCash319648' 6-max Seat #1 is the button
Seat 1: cf8c7400 ($25.25 in chips)
Seat 2: 7ae5ca25 ($12.5 in chips)
Seat 3: ca69da65 ($36.95 in chips)
Seat 4: e767af3b ($26.02 in chips)
Seat 5: Hero ($30.48 in chips)
Seat 6: 2904eaa2 ($25.7 in chips)
7ae5ca25: posts small blind $0.1
ca69da65: posts big blind $0.25
*** HOLE CARDS ***
Dealt to cf8c7400 
Dealt to 7ae5ca25 
Dealt to ca69da65 
Dealt to e767af3b 
Dealt to Hero [Qs 4d]
Dealt to 2904eaa2 
e767af3b: raises $0.5 to $0.75
Hero: folds
2904eaa2: folds
cf8c7400: folds
7ae5ca25: folds
ca69da65: folds
Uncalled bet ($0.5) returned to e767af3b
*** SHOWDOWN ***
e767af3b collected $0.6 from pot
*** SUMMARY ***
Total pot $0.6
Seat 1: cf8c7400 (button) folded before Flop (didn't bet)
Seat 2: 7ae5ca25 (small blind) folded before Flop
Seat 3: ca69da65 (big blind) folded before Flop
Seat 4: e767af3b collected ($0.6)
Seat 5: Hero folded before Flop (didn't bet)
Seat 6: 2904eaa2 folded before Flop (didn't bet)


Poker Hand #RC94796821: Hold'em No Limit ($0.1/$0.25) - 2020/04/06 23:39:41
Table 'RushAndCash319652' 6-max Seat #1 is the button
Seat 1: Hero ($30.48 in chips)
Seat 2: 90609fad ($54.39 in chips)
Seat 3: 72fa991e ($38.79 in chips)
Seat 4: 9d598a03 ($52.72 in chips)
Seat 5: 8abd2614 ($14.11 in chips)
Seat 6: 9b358964 ($25.35 in chips)
90609fad: posts small blind $0.1
72fa991e: posts big blind $0.25
*** HOLE CARDS ***
Dealt to Hero [As 2h]
Dealt to 90609fad 
Dealt to 72fa991e 
Dealt to 9d598a03 
Dealt to 8abd2614 
Dealt to 9b358964 
9d598a03: folds
8abd2614: folds
9b358964: raises $0.38 to $0.63
Hero: folds
90609fad: folds
72fa991e: folds
Uncalled bet ($0.38) returned to 9b358964
*** SHOWDOWN ***
9b358964 collected $0.6 from pot
*** SUMMARY ***
Total pot $0.6
Seat 1: Hero (button) folded before Flop (didn't bet)
Seat 2: 90609fad (small blind) folded before Flop
Seat 3: 72fa991e (big blind) folded before Flop
Seat 4: 9d598a03 folded before Flop (didn't bet)
Seat 5: 8abd2614 folded before Flop (didn't bet)
Seat 6: 9b358964 collected ($0.6)


Poker Hand #RC94796835: Hold'em No Limit ($0.1/$0.25) - 2020/04/06 23:39:43
Table 'RushAndCash319654' 6-max Seat #1 is the button
Seat 1: 99d6d386 ($25 in chips)
Seat 2: 2904eaa2 ($25.7 in chips)
Seat 3: cc4afcf8 ($3.97 in chips)
Seat 4: ff501d94 ($15.37 in chips)
Seat 5: 94efc628 ($26.12 in chips)
Seat 6: Hero ($30.48 in chips)
2904eaa2: posts small blind $0.1
cc4afcf8: posts big blind $0.25
*** HOLE CARDS ***
Dealt to 99d6d386 
Dealt to 2904eaa2 
Dealt to cc4afcf8 
Dealt to ff501d94 
Dealt to 94efc628 
Dealt to Hero [Qs Th]
ff501d94: folds
94efc628: raises $0.38 to $0.63
Hero: folds
99d6d386: folds
2904eaa2: raises $1.63 to $2.26
cc4afcf8: folds
94efc628: calls $1.63
*** FLOP *** [Td 8d 2h]
2904eaa2: bets $3.1
94efc628: folds
Uncalled bet ($3.1) returned to 2904eaa2
*** SHOWDOWN ***
2904eaa2 collected $4.77 from pot
*** SUMMARY ***
Total pot $4.77
Board [Td 8d 2h]
Seat 1: 99d6d386 (button) folded before Flop (didn't bet)
Seat 2: 2904eaa2 (small blind) won ($4.77)
Seat 3: cc4afcf8 (big blind) folded before Flop
Seat 4: ff501d94 folded before Flop (didn't bet)
Seat 5: 94efc628 folded on the Flop
Seat 6: Hero folded before Flop (didn't bet)


Poker Hand #RC94796856: Hold'em No Limit ($0.1/$0.25) - 2020/04/06 23:39:49
Table 'RushAndCash319657' 6-max Seat #1 is the button
Seat 1: Hero ($30.83 in chips)
Seat 2: 8abd2614 ($13.86 in chips)
Seat 3: 41ab7510 ($27.66 in chips)
Seat 4: bd6eeaf3 ($60.36 in chips)
Seat 5: ea5eba95 ($71.22 in chips)
Seat 6: fe7c9e7a ($27.17 in chips)
8abd2614: posts small blind $0.1
41ab7510: posts big blind $0.25
*** HOLE CARDS ***
Dealt to Hero [Ah 9h]
Dealt to 8abd2614 
Dealt to 41ab7510 
Dealt to bd6eeaf3 
Dealt to ea5eba95 
Dealt to fe7c9e7a 
bd6eeaf3: folds
ea5eba95: folds
fe7c9e7a: folds
Hero: raises $0.38 to $0.63
8abd2614: raises $1.57 to $2.2
41ab7510: folds
Hero: folds
Uncalled bet ($1.57) returned to 8abd2614
*** SHOWDOWN ***
8abd2614 collected $1.51 from pot
*** SUMMARY ***
Total pot $1.51
Seat 1: Hero (button) folded before Flop
Seat 2: 8abd2614 (small blind) collected ($1.51)
Seat 3: 41ab7510 (big blind) folded before Flop
Seat 4: bd6eeaf3 folded before Flop (didn't bet)
Seat 5: ea5eba95 folded before Flop (didn't bet)
Seat 6: fe7c9e7a folded before Flop (didn't bet)


Poker Hand #RC94796965: Hold'em No Limit ($0.1/$0.25) - 2020/04/06 23:40:13
Table 'RushAndCash319671' 6-max Seat #1 is the button
Seat 1: 1bc051b2 ($12.2 in chips)
Seat 2: e64b2cd5 ($15.82 in chips)
Seat 3: 23cd8de ($13.42 in chips)
Seat 4: 19e4cb38 ($24.65 in chips)
Seat 5: 41459cc9 ($25 in chips)
Seat 6: Hero ($30.2 in chips)
e64b2cd5: posts small blind $0.1
23cd8de: posts big blind $0.25
*** HOLE CARDS ***
Dealt to 1bc051b2 
Dealt to e64b2cd5 
Dealt to 23cd8de 
Dealt to 19e4cb38 
Dealt to 41459cc9 
Dealt to Hero [Th 8h]
19e4cb38: folds
41459cc9: folds
Hero: folds
1bc051b2: raises $0.25 to $0.5
e64b2cd5: folds
23cd8de: calls $0.25
*** FLOP *** [6s 9h 9d]
23cd8de: checks
1bc051b2: bets $0.4
23cd8de: folds
Uncalled bet ($0.4) returned to 1bc051b2
*** SHOWDOWN ***
1bc051b2 collected $1.1 from pot
*** SUMMARY ***
Total pot $1.1
Board [6s 9h 9d]
Seat 1: 1bc051b2 (button) won ($1.1)
Seat 2: e64b2cd5 (small blind) folded before Flop
Seat 3: 23cd8de (big blind) folded on the Flop
Seat 4: 19e4cb38 folded before Flop (didn't bet)
Seat 5: 41459cc9 folded before Flop (didn't bet)
Seat 6: Hero folded before Flop (didn't bet)


Poker Hand #RC94796994: Hold'em No Limit ($0.1/$0.25) - 2020/04/06 23:40:18
Table 'RushAndCash319675' 6-max Seat #1 is the button
Seat 1: 8466ae26 ($25 in chips)
Seat 2: 9b358964 ($25.8 in chips)
Seat 3: b9bbf733 ($25 in chips)
Seat 4: afa5143c ($32.23 in chips)
Seat 5: Hero ($30.2 in chips)
Seat 6: 90609fad ($54.19 in chips)
9b358964: posts small blind $0.1
b9bbf733: posts big blind $0.25
*** HOLE CARDS ***
Dealt to 8466ae26 
Dealt to 9b358964 
Dealt to b9bbf733 
Dealt to afa5143c 
Dealt to Hero [6s 6h]
Dealt to 90609fad 
afa5143c: folds
Hero: raises $0.38 to $0.63
90609fad: folds
8466ae26: folds
9b358964: folds
b9bbf733: folds
Uncalled bet ($0.38) returned to Hero
*** SHOWDOWN ***
Hero collected $0.6 from pot
*** SUMMARY ***
Total pot $0.6
Seat 1: 8466ae26 (button) folded before Flop (didn't bet)
Seat 2: 9b358964 (small blind) folded before Flop
Seat 3: b9bbf733 (big blind) folded before Flop
Seat 4: afa5143c folded before Flop (didn't bet)
Seat 5: Hero collected ($0.6)
Seat 6: 90609fad folded before Flop (didn't bet)


Poker Hand #RC94797096: Hold'em No Limit ($0.1/$0.25) - 2020/04/06 23:40:39
Table 'RushAndCash319688' 6-max Seat #1 is the button
Seat 1: 8466ae26 ($25 in chips)
Seat 2: b9bbf733 ($25 in chips)
Seat 3: Hero ($30.55 in chips)
Seat 4: 604f36f0 ($15.74 in chips)
Seat 5: 9c511c89 ($12.5 in chips)
Seat 6: 8e166af5 ($55.82 in chips)
b9bbf733: posts small blind $0.1
Hero: posts big blind $0.25
*** HOLE CARDS ***
Dealt to 8466ae26 
Dealt to b9bbf733 
Dealt to Hero [Qc Ts]
Dealt to 604f36f0 
Dealt to 9c511c89 
Dealt to 8e166af5 
604f36f0: folds
9c511c89: folds
8e166af5: folds
8466ae26: folds
b9bbf733: raises $0.5 to $0.75
Hero: folds
Uncalled bet ($0.5) returned to b9bbf733
*** SHOWDOWN ***
b9bbf733 collected $0.5 from pot
*** SUMMARY ***
Total pot $0.5
Seat 1: 8466ae26 (button) folded before Flop (didn't bet)
Seat 2: b9bbf733 (small blind) collected ($0.5)
Seat 3: Hero (big blind) folded before Flop
Seat 4: 604f36f0 folded before Flop (didn't bet)
Seat 5: 9c511c89 folded before Flop (didn't bet)
Seat 6: 8e166af5 folded before Flop (didn't bet)


Poker Hand #RC94797113: Hold'em No Limit ($0.1/$0.25) - 2020/04/06 23:40:42
Table 'RushAndCash319690' 6-max Seat #1 is the button
Seat 1: e0680a48 ($80.08 in chips)
Seat 2: Hero ($30.3 in chips)
Seat 3: cc4afcf8 ($3.72 in chips)
Seat 4: 41459cc9 ($25 in chips)
Seat 5: 604f36f0 ($15.74 in chips)
Seat 6: e767af3b ($26.37 in chips)
Hero: posts small blind $0.1
cc4afcf8: posts big blind $0.25
*** HOLE CARDS ***
Dealt to e0680a48 
Dealt to Hero [Qd 7c]
Dealt to cc4afcf8 
Dealt to 41459cc9 
Dealt to 604f36f0 
Dealt to e767af3b 
41459cc9: folds
604f36f0: folds
e767af3b: folds
e0680a48: folds
Hero: folds
Uncalled bet ($0.15) returned to cc4afcf8
*** SHOWDOWN ***
cc4afcf8 collected $0.2 from pot
*** SUMMARY ***
Total pot $0.2
Seat 1: e0680a48 (button) folded before Flop (didn't bet)
Seat 2: Hero (small blind) folded before Flop
Seat 3: cc4afcf8 (big blind) collected ($0.2)
Seat 4: 41459cc9 folded before Flop (didn't bet)
Seat 5: 604f36f0 folded before Flop (didn't bet)
Seat 6: e767af3b folded before Flop (didn't bet)


Poker Hand #RC94797124: Hold'em No Limit ($0.1/$0.25) - 2020/04/06 23:40:45
Table 'RushAndCash319692' 6-max Seat #1 is the button
Seat 1: 19e4cb38 ($24.3 in chips)
Seat 2: 17480666 ($105.97 in chips)
Seat 3: 522e695b ($3.81 in chips)
Seat 4: 8e166af5 ($55.82 in chips)
Seat 5: 7ae5ca25 ($11.75 in chips)
Seat 6: Hero ($30.2 in chips)
17480666: posts small blind $0.1
522e695b: posts big blind $0.25
*** HOLE CARDS ***
Dealt to 19e4cb38 
Dealt to 17480666 
Dealt to 522e695b 
Dealt to 8e166af5 
Dealt to 7ae5ca25 
Dealt to Hero [Kd 3h]
8e166af5: folds
7ae5ca25: folds
Hero: folds
19e4cb38: folds
17480666: folds
Uncalled bet ($0.15) returned to 522e695b
*** SHOWDOWN ***
522e695b collected $0.2 from pot
*** SUMMARY ***
Total pot $0.2
Seat 1: 19e4cb38 (button) folded before Flop (didn't bet)
Seat 2: 17480666 (small blind) folded before Flop
Seat 3: 522e695b (big blind) collected ($0.2)
Seat 4: 8e166af5 folded before Flop (didn't bet)
Seat 5: 7ae5ca25 folded before Flop (didn't bet)
Seat 6: Hero folded before Flop (didn't bet)


Poker Hand #RC94797143: Hold'em No Limit ($0.1/$0.25) - 2020/04/06 23:40:50
Table 'RushAndCash319695' 6-max Seat #1 is the button
Seat 1: 90609fad ($54.29 in chips)
Seat 2: 9c584d7d ($15.11 in chips)
Seat 3: 9c511c89 ($12.5 in chips)
Seat 4: 19e4cb38 ($24.65 in chips)
Seat 5: 7ae5ca25 ($11.75 in chips)
Seat 6: Hero ($30.2 in chips)
9c584d7d: posts small blind $0.1
9c511c89: posts big blind $0.25
*** HOLE CARDS ***
Dealt to 90609fad 
Dealt to 9c584d7d 
Dealt to 9c511c89 
Dealt to 19e4cb38 
Dealt to 7ae5ca25 
Dealt to Hero [Kc 8d]
19e4cb38: folds
7ae5ca25: folds
Hero: folds
90609fad: folds
9c584d7d: raises $0.38 to $0.63
9c511c89: folds
Uncalled bet ($0.38) returned to 9c584d7d
*** SHOWDOWN ***
9c584d7d collected $0.5 from pot
*** SUMMARY ***
Total pot $0.5
Seat 1: 90609fad (button) folded before Flop (didn't bet)
Seat 2: 9c584d7d (small blind) collected ($0.5)
Seat 3: 9c511c89 (big blind) folded before Flop
Seat 4: 19e4cb38 folded before Flop (didn't bet)
Seat 5: 7ae5ca25 folded before Flop (didn't bet)
Seat 6: Hero folded before Flop (didn't bet)


Poker Hand #RC94797165: Hold'em No Limit ($0.1/$0.25) - 2020/04/06 23:40:54
Table 'RushAndCash319699' 6-max Seat #1 is the button
Seat 1: Hero ($30.2 in chips)
Seat 2: 23cd8de ($12.92 in chips)
Seat 3: 1d6fff9c ($26.97 in chips)
Seat 4: b9bbf733 ($25.25 in chips)
Seat 5: 1bc051b2 ($12.75 in chips)
Seat 6: 8f2f88a4 ($47.99 in chips)
23cd8de: posts small blind $0.1
1d6fff9c: posts big blind $0.25
*** HOLE CARDS ***
Dealt to Hero [Jh 7s]
Dealt to 23cd8de 
Dealt to 1d6fff9c 
Dealt to b9bbf733 
Dealt to 1bc051b2 
Dealt to 8f2f88a4 
b9bbf733: folds
1bc051b2: folds
8f2f88a4: folds
Hero: folds
23cd8de: folds
Uncalled bet ($0.15) returned to 1d6fff9c
*** SHOWDOWN ***
1d6fff9c collected $0.2 from pot
*** SUMMARY ***
Total pot $0.2
Seat 1: Hero (button) folded before Flop (didn't bet)
Seat 2: 23cd8de (small blind) folded before Flop
Seat 3: 1d6fff9c (big blind) collected ($0.2)
Seat 4: b9bbf733 folded before Flop (didn't bet)
Seat 5: 1bc051b2 folded before Flop (didn't bet)
Seat 6: 8f2f88a4 folded before Flop (didn't bet)


Poker Hand #RC94797181: Hold'em No Limit ($0.1/$0.25) - 2020/04/06 23:40:58
Table 'RushAndCash319702' 6-max Seat #1 is the button
Seat 1: 1e890f21 ($15.02 in chips)
Seat 2: ce4e1e37 ($23.51 in chips)
Seat 3: 41ab7510 ($27.76 in chips)
Seat 4: 969ce17 ($35.09 in chips)
Seat 5: 58b04451 ($18.79 in chips)
Seat 6: Hero ($30.2 in chips)
ce4e1e37: posts small blind $0.1
41ab7510: posts big blind $0.25
*** HOLE CARDS ***
Dealt to 1e890f21 
Dealt to ce4e1e37 
Dealt to 41ab7510 
Dealt to 969ce17 
Dealt to 58b04451 
Dealt to Hero [7s 5c]
969ce17: folds
58b04451: raises $0.5 to $0.75
Hero: folds
1e890f21: folds
ce4e1e37: calls $0.65
41ab7510: folds
*** FLOP *** [9c Jh Qs]
ce4e1e37: checks
58b04451: checks
*** TURN *** [9c Jh Qs] [7h]
ce4e1e37: bets $1.4
58b04451: calls $1.4
*** RIVER *** [9c Jh Qs 7h] [Ks]
ce4e1e37: bets $3.5
58b04451: calls $3.5
ce4e1e37: shows [8h Th] (Kings-High Straight)
58b04451: shows [Ac Kc] (Pair of Kings)
*** SHOWDOWN ***
ce4e1e37 collected $11.55 from pot
*** SUMMARY ***
Total pot $11.55
Board [9c Jh Qs 7h Ks]
Seat 1: 1e890f21 (button) folded before Flop (didn't bet)
Seat 2: ce4e1e37 (small blind) showed [Th 8h] and won ($11.55) with Kings-High Straight
Seat 3: 41ab7510 (big blind) folded before Flop
Seat 4: 969ce17 folded before Flop (didn't bet)
Seat 5: 58b04451 showed [Ac Kc] and lost with Pair of Kings
Seat 6: Hero folded before Flop (didn't bet)


Poker Hand #RC94797201: Hold'em No Limit ($0.1/$0.25) - 2020/04/06 23:41:03
Table 'RushAndCash319706' 6-max Seat #1 is the button
Seat 1: d8a224aa ($25.61 in chips)
Seat 2: Hero ($30.2 in chips)
Seat 3: 7ae5ca25 ($12.5 in chips)
Seat 4: 2467bb49 ($60.21 in chips)
Seat 5: e0680a48 ($80.43 in chips)
Seat 6: 1bc051b2 ($12.75 in chips)
Hero: posts small blind $0.1
7ae5ca25: posts big blind $0.25
*** HOLE CARDS ***
Dealt to d8a224aa 
Dealt to Hero [3h 2d]
Dealt to 7ae5ca25 
Dealt to 2467bb49 
Dealt to e0680a48 
Dealt to 1bc051b2 
2467bb49: folds
e0680a48: raises $0.5 to $0.75
1bc051b2: folds
d8a224aa: folds
Hero: folds
7ae5ca25: folds
Uncalled bet ($0.5) returned to e0680a48
*** SHOWDOWN ***
e0680a48 collected $0.6 from pot
*** SUMMARY ***
Total pot $0.6
Seat 1: d8a224aa (button) folded before Flop (didn't bet)
Seat 2: Hero (small blind) folded before Flop
Seat 3: 7ae5ca25 (big blind) folded before Flop
Seat 4: 2467bb49 folded before Flop (didn't bet)
Seat 5: e0680a48 collected ($0.6)
Seat 6: 1bc051b2 folded before Flop (didn't bet)


Poker Hand #RC94797217: Hold'em No Limit ($0.1/$0.25) - 2020/04/06 23:41:07
Table 'RushAndCash319708' 6-max Seat #1 is the button
Seat 1: 9c511c89 ($12.5 in chips)
Seat 2: dcc7f9d7 ($11.75 in chips)
Seat 3: 2467bb49 ($60.21 in chips)
Seat 4: 969ce17 ($35.09 in chips)
Seat 5: Hero ($30.1 in chips)
Seat 6: 9e9b6fda ($22.54 in chips)
dcc7f9d7: posts small blind $0.1
2467bb49: posts big blind $0.25
*** HOLE CARDS ***
Dealt to 9c511c89 
Dealt to dcc7f9d7 
Dealt to 2467bb49 
Dealt to 969ce17 
Dealt to Hero [Kh 5c]
Dealt to 9e9b6fda 
969ce17: folds
Hero: folds
9e9b6fda: raises $0.46 to $0.71
9c511c89: folds
dcc7f9d7: folds
2467bb49: folds
Uncalled bet ($0.46) returned to 9e9b6fda
*** SHOWDOWN ***
9e9b6fda collected $0.6 from pot
*** SUMMARY ***
Total pot $0.6
Seat 1: 9c511c89 (button) folded before Flop (didn't bet)
Seat 2: dcc7f9d7 (small blind) folded before Flop
Seat 3: 2467bb49 (big blind) folded before Flop
Seat 4: 969ce17 folded before Flop (didn't bet)
Seat 5: Hero folded before Flop (didn't bet)
Seat 6: 9e9b6fda collected ($0.6)


Poker Hand #RC94797237: Hold'em No Limit ($0.1/$0.25) - 2020/04/06 23:41:11
Table 'RushAndCash319712' 6-max Seat #1 is the button
Seat 1: ff501d94 ($13.45 in chips)
Seat 2: 9c511c89 ($12.5 in chips)
Seat 3: Hero ($30.1 in chips)
Seat 4: 969ce17 ($35.09 in chips)
Seat 5: 9c584d7d ($15.36 in chips)
Seat 6: 41ab7510 ($27.51 in chips)
9c511c89: posts small blind $0.1
Hero: posts big blind $0.25
*** HOLE CARDS ***
Dealt to ff501d94 
Dealt to 9c511c89 
Dealt to Hero [Tc 5h]
Dealt to 969ce17 
Dealt to 9c584d7d 
Dealt to 41ab7510 
969ce17: folds
9c584d7d: folds
41ab7510: folds
ff501d94: folds
9c511c89: raises $0.25 to $0.5
Hero: folds
Uncalled bet ($0.25) returned to 9c511c89
*** SHOWDOWN ***
9c511c89 collected $0.5 from pot
*** SUMMARY ***
Total pot $0.5
Seat 1: ff501d94 (button) folded before Flop (didn't bet)
Seat 2: 9c511c89 (small blind) collected ($0.5)
Seat 3: Hero (big blind) folded before Flop
Seat 4: 969ce17 folded before Flop (didn't bet)
Seat 5: 9c584d7d folded before Flop (didn't bet)
Seat 6: 41ab7510 folded before Flop (didn't bet)


Poker Hand #RC94797249: Hold'em No Limit ($0.1/$0.25) - 2020/04/06 23:41:15
Table 'RushAndCash319714' 6-max Seat #1 is the button
Seat 1: 17480666 ($105.97 in chips)
Seat 2: 969ce17 ($35.09 in chips)
Seat 3: afa5143c ($32.48 in chips)
Seat 4: Hero ($29.85 in chips)
Seat 5: 1bc051b2 ($12.75 in chips)
Seat 6: 23cd8de ($12.82 in chips)
969ce17: posts small blind $0.1
afa5143c: posts big blind $0.25
*** HOLE CARDS ***
Dealt to 17480666 
Dealt to 969ce17 
Dealt to afa5143c 
Dealt to Hero [Th 8c]
Dealt to 1bc051b2 
Dealt to 23cd8de 
Hero: folds
1bc051b2: folds
23cd8de: folds
17480666: raises $0.5 to $0.75
969ce17: folds
afa5143c: folds
Uncalled bet ($0.5) returned to 17480666
*** SHOWDOWN ***
17480666 collected $0.6 from pot
*** SUMMARY ***
Total pot $0.6
Seat 1: 17480666 (button) collected ($0.6)
Seat 2: 969ce17 (small blind) folded before Flop
Seat 3: afa5143c (big blind) folded before Flop
Seat 4: Hero folded before Flop (didn't bet)
Seat 5: 1bc051b2 folded before Flop (didn't bet)
Seat 6: 23cd8de folded before Flop (didn't bet)


Poker Hand #RC94797267: Hold'em No Limit ($0.1/$0.25) - 2020/04/06 23:41:18
Table 'RushAndCash319718' 6-max Seat #1 is the button
Seat 1: fe7c9e7a ($30.68 in chips)
Seat 2: Hero ($29.85 in chips)
Seat 3: 36ac4586 ($52.26 in chips)
Seat 4: 8a31aea7 ($71.1 in chips)
Seat 5: 6ee3fbae ($13.69 in chips)
Seat 6: 9afeb2a7 ($29.67 in chips)
Hero: posts small blind $0.1
36ac4586: posts big blind $0.25
*** HOLE CARDS ***
Dealt to fe7c9e7a 
Dealt to Hero [9d 5d]
Dealt to 36ac4586 
Dealt to 8a31aea7 
Dealt to 6ee3fbae 
Dealt to 9afeb2a7 
8a31aea7: folds
6ee3fbae: folds
9afeb2a7: folds
fe7c9e7a: folds
Hero: folds
Uncalled bet ($0.15) returned to 36ac4586
*** SHOWDOWN ***
36ac4586 collected $0.2 from pot
*** SUMMARY ***
Total pot $0.2
Seat 1: fe7c9e7a (button) folded before Flop (didn't bet)
Seat 2: Hero (small blind) folded before Flop
Seat 3: 36ac4586 (big blind) collected ($0.2)
Seat 4: 8a31aea7 folded before Flop (didn't bet)
Seat 5: 6ee3fbae folded before Flop (didn't bet)
Seat 6: 9afeb2a7 folded before Flop (didn't bet)


Poker Hand #RC94797283: Hold'em No Limit ($0.1/$0.25) - 2020/04/06 23:41:22
Table 'RushAndCash319720' 6-max Seat #1 is the button
Seat 1: Hero ($29.75 in chips)
Seat 2: 8a31aea7 ($71.1 in chips)
Seat 3: ff501d94 ($13.35 in chips)
Seat 4: 9c511c89 ($12.75 in chips)
Seat 5: 99d6d386 ($25 in chips)
Seat 6: 1e890f21 ($15.02 in chips)
8a31aea7: posts small blind $0.1
ff501d94: posts big blind $0.25
*** HOLE CARDS ***
Dealt to Hero [As 9h]
Dealt to 8a31aea7 
Dealt to ff501d94 
Dealt to 9c511c89 
Dealt to 99d6d386 
Dealt to 1e890f21 
9c511c89: folds
99d6d386: folds
1e890f21: raises $0.38 to $0.63
Hero: folds
8a31aea7: folds
ff501d94: folds
Uncalled bet ($0.38) returned to 1e890f21
*** SHOWDOWN ***
1e890f21 collected $0.6 from pot
*** SUMMARY ***
Total pot $0.6
Seat 1: Hero (button) folded before Flop (didn't bet)
Seat 2: 8a31aea7 (small blind) folded before Flop
Seat 3: ff501d94 (big blind) folded before Flop
Seat 4: 9c511c89 folded before Flop (didn't bet)
Seat 5: 99d6d386 folded before Flop (didn't bet)
Seat 6: 1e890f21 collected ($0.6)


Poker Hand #RC94797309: Hold'em No Limit ($0.1/$0.25) - 2020/04/06 23:41:27
Table 'RushAndCash319723' 6-max Seat #1 is the button
Seat 1: 36ac4586 ($52.36 in chips)
Seat 2: fe7c9e7a ($30.68 in chips)
Seat 3: 1bc051b2 ($12.75 in chips)
Seat 4: b215699c ($70.06 in chips)
Seat 5: Hero ($29.75 in chips)
Seat 6: 9c511c89 ($12.75 in chips)
fe7c9e7a: posts small blind $0.1
1bc051b2: posts big blind $0.25
*** HOLE CARDS ***
Dealt to 36ac4586 
Dealt to fe7c9e7a 
Dealt to 1bc051b2 
Dealt to b215699c 
Dealt to Hero [Kh Jc]
Dealt to 9c511c89 
b215699c: folds
Hero: raises $0.38 to $0.63
9c511c89: raises $1.67 to $2.3
36ac4586: folds
fe7c9e7a: folds
1bc051b2: folds
Hero: folds
Uncalled bet ($1.67) returned to 9c511c89
*** SHOWDOWN ***
9c511c89 collected $1.61 from pot
*** SUMMARY ***
Total pot $1.61
Seat 1: 36ac4586 (button) folded before Flop (didn't bet)
Seat 2: fe7c9e7a (small blind) folded before Flop
Seat 3: 1bc051b2 (big blind) folded before Flop
Seat 4: b215699c folded before Flop (didn't bet)
Seat 5: Hero folded before Flop
Seat 6: 9c511c89 collected ($1.61)


Poker Hand #RC94797383: Hold'em No Limit ($0.1/$0.25) - 2020/04/06 23:41:43
Table 'RushAndCash319733' 6-max Seat #1 is the button
Seat 1: Hero ($29.12 in chips)
Seat 2: 2258ad9f ($67.22 in chips)
Seat 3: 8a31aea7 ($71 in chips)
Seat 4: 1e890f21 ($15.37 in chips)
Seat 5: b9bbf733 ($25.35 in chips)
Seat 6: ce4e1e37 ($28.59 in chips)
2258ad9f: posts small blind $0.1
8a31aea7: posts big blind $0.25
*** HOLE CARDS ***
Dealt to Hero [Ah 7h]
Dealt to 2258ad9f 
Dealt to 8a31aea7 
Dealt to 1e890f21 
Dealt to b9bbf733 
Dealt to ce4e1e37 
1e890f21: folds
b9bbf733: folds
ce4e1e37: folds
Hero: raises $0.38 to $0.63
2258ad9f: folds
8a31aea7: calls $0.38
*** FLOP *** [2d 4d 9c]
8a31aea7: checks
Hero: checks
*** TURN *** [2d 4d 9c] [Ks]
8a31aea7: checks
Hero: bets $1.1
8a31aea7: folds
Uncalled bet ($1.1) returned to Hero
*** SHOWDOWN ***
Hero collected $1.36 from pot
*** SUMMARY ***
Total pot $1.36
Board [2d 4d 9c Ks]
Seat 1: Hero (button) won ($1.36)
Seat 2: 2258ad9f (small blind) folded before Flop
Seat 3: 8a31aea7 (big blind) folded on the Turn
Seat 4: 1e890f21 folded before Flop (didn't bet)
Seat 5: b9bbf733 folded before Flop (didn't bet)
Seat 6: ce4e1e37 folded before Flop (didn't bet)


Poker Hand #RC94797596: Hold'em No Limit ($0.1/$0.25) - 2020/04/06 23:42:27
Table 'RushAndCash319760' 6-max Seat #1 is the button
Seat 1: afa5143c ($35.47 in chips)
Seat 2: cc4afcf8 ($3.72 in chips)
Seat 3: fe7c9e7a ($29.08 in chips)
Seat 4: 35a45ce2 ($25.35 in chips)
Seat 5: Hero ($29.79 in chips)
Seat 6: fd369e31 ($59.81 in chips)
cc4afcf8: posts small blind $0.1
fe7c9e7a: posts big blind $0.25
*** HOLE CARDS ***
Dealt to afa5143c 
Dealt to cc4afcf8 
Dealt to fe7c9e7a 
Dealt to 35a45ce2 
Dealt to Hero [Jh 8d]
Dealt to fd369e31 
35a45ce2: folds
Hero: folds
fd369e31: folds
afa5143c: raises $0.38 to $0.63
cc4afcf8: folds
fe7c9e7a: folds
Uncalled bet ($0.38) returned to afa5143c
*** SHOWDOWN ***
afa5143c collected $0.6 from pot
*** SUMMARY ***
Total pot $0.6
Seat 1: afa5143c (button) collected ($0.6)
Seat 2: cc4afcf8 (small blind) folded before Flop
Seat 3: fe7c9e7a (big blind) folded before Flop
Seat 4: 35a45ce2 folded before Flop (didn't bet)
Seat 5: Hero folded before Flop (didn't bet)
Seat 6: fd369e31 folded before Flop (didn't bet)


Poker Hand #RC94797616: Hold'em No Limit ($0.1/$0.25) - 2020/04/06 23:42:31
Table 'RushAndCash319763' 6-max Seat #1 is the button
Seat 1: bd6eeaf3 ($60.01 in chips)
Seat 2: fd369e31 ($59.81 in chips)
Seat 3: Hero ($29.79 in chips)
Seat 4: 7ae5ca25 ($14.59 in chips)
Seat 5: dcc7f9d7 ($8.42 in chips)
Seat 6: fe7c9e7a ($28.83 in chips)
fd369e31: posts small blind $0.1
Hero: posts big blind $0.25
*** HOLE CARDS ***
Dealt to bd6eeaf3 
Dealt to fd369e31 
Dealt to Hero [Ks 5d]
Dealt to 7ae5ca25 
Dealt to dcc7f9d7 
Dealt to fe7c9e7a 
7ae5ca25: folds
dcc7f9d7: folds
fe7c9e7a: folds
bd6eeaf3: folds
fd369e31: folds
Uncalled bet ($0.15) returned to Hero
*** SHOWDOWN ***
Hero collected $0.2 from pot
*** SUMMARY ***
Total pot $0.2
Seat 1: bd6eeaf3 (button) folded before Flop (didn't bet)
Seat 2: fd369e31 (small blind) folded before Flop
Seat 3: Hero (big blind) collected ($0.2)
Seat 4: 7ae5ca25 folded before Flop (didn't bet)
Seat 5: dcc7f9d7 folded before Flop (didn't bet)
Seat 6: fe7c9e7a folded before Flop (didn't bet)


Poker Hand #RC94797636: Hold'em No Limit ($0.1/$0.25) - 2020/04/06 23:42:35
Table 'RushAndCash319766' 6-max Seat #1 is the button
Seat 1: 6ee3fbae ($13.34 in chips)
Seat 2: Hero ($29.54 in chips)
Seat 3: 36ac4586 ($52.71 in chips)
Seat 4: 23cd8de ($12.5 in chips)
Seat 5: 7ae5ca25 ($14.59 in chips)
Seat 6: 8fb93df3 ($46.68 in chips)
Hero: posts small blind $0.1
36ac4586: posts big blind $0.25
*** HOLE CARDS ***
Dealt to 6ee3fbae 
Dealt to Hero [8c 5d]
Dealt to 36ac4586 
Dealt to 23cd8de 
Dealt to 7ae5ca25 
Dealt to 8fb93df3 
23cd8de: folds
7ae5ca25: folds
8fb93df3: folds
6ee3fbae: folds
Hero: folds
Uncalled bet ($0.15) returned to 36ac4586
*** SHOWDOWN ***
36ac4586 collected $0.2 from pot
*** SUMMARY ***
Total pot $0.2
Seat 1: 6ee3fbae (button) folded before Flop (didn't bet)
Seat 2: Hero (small blind) folded before Flop
Seat 3: 36ac4586 (big blind) collected ($0.2)
Seat 4: 23cd8de folded before Flop (didn't bet)
Seat 5: 7ae5ca25 folded before Flop (didn't bet)
Seat 6: 8fb93df3 folded before Flop (didn't bet)


Poker Hand #RC94797654: Hold'em No Limit ($0.1/$0.25) - 2020/04/06 23:42:39
Table 'RushAndCash319769' 6-max Seat #1 is the button
Seat 1: 9e9b6fda ($21.89 in chips)
Seat 2: b9bbf733 ($27.69 in chips)
Seat 3: 604f36f0 ($18.96 in chips)
Seat 4: Hero ($29.44 in chips)
Seat 5: 9c584d7d ($15.36 in chips)
Seat 6: 7ae5ca25 ($14.59 in chips)
b9bbf733: posts small blind $0.1
604f36f0: posts big blind $0.25
*** HOLE CARDS ***
Dealt to 9e9b6fda 
Dealt to b9bbf733 
Dealt to 604f36f0 
Dealt to Hero [Kh 7s]
Dealt to 9c584d7d 
Dealt to 7ae5ca25 
Hero: folds
9c584d7d: folds
7ae5ca25: raises $0.5 to $0.75
9e9b6fda: raises $1.58 to $2.33
b9bbf733: folds
604f36f0: folds
7ae5ca25: folds
Uncalled bet ($1.58) returned to 9e9b6fda
*** SHOWDOWN ***
9e9b6fda collected $1.85 from pot
*** SUMMARY ***
Total pot $1.85
Seat 1: 9e9b6fda (button) collected ($1.85)
Seat 2: b9bbf733 (small blind) folded before Flop
Seat 3: 604f36f0 (big blind) folded before Flop
Seat 4: Hero folded before Flop (didn't bet)
Seat 5: 9c584d7d folded before Flop (didn't bet)
Seat 6: 7ae5ca25 folded before Flop


Poker Hand #RC94797669: Hold'em No Limit ($0.1/$0.25) - 2020/04/06 23:42:43
Table 'RushAndCash319772' 6-max Seat #1 is the button
Seat 1: 928a94bb ($54.01 in chips)
Seat 2: dfcfe0b3 ($25 in chips)
Seat 3: ac4ab575 ($12.5 in chips)
Seat 4: Hero ($29.79 in chips)
Seat 5: ba032eea ($54.97 in chips)
Seat 6: dcc7f9d7 ($8.42 in chips)
dfcfe0b3: posts small blind $0.1
ac4ab575: posts big blind $0.25
*** HOLE CARDS ***
Dealt to 928a94bb 
Dealt to dfcfe0b3 
Dealt to ac4ab575 
Dealt to Hero [Jd 3d]
Dealt to ba032eea 
Dealt to dcc7f9d7 
Hero: folds
ba032eea: folds
dcc7f9d7: raises $0.5 to $0.75
928a94bb: folds
dfcfe0b3: folds
ac4ab575: calls $0.5
*** FLOP *** [3s 9c 9s]
ac4ab575: checks
dcc7f9d7: bets $0.6
ac4ab575: folds
Uncalled bet ($0.6) returned to dcc7f9d7
*** SHOWDOWN ***
dcc7f9d7 collected $1.6 from pot
*** SUMMARY ***
Total pot $1.6
Board [3s 9c 9s]
Seat 1: 928a94bb (button) folded before Flop (didn't bet)
Seat 2: dfcfe0b3 (small blind) folded before Flop
Seat 3: ac4ab575 (big blind) folded on the Flop
Seat 4: Hero folded before Flop (didn't bet)
Seat 5: ba032eea folded before Flop (didn't bet)
Seat 6: dcc7f9d7 won ($1.6)


Poker Hand #RC94797690: Hold'em No Limit ($0.1/$0.25) - 2020/04/06 23:42:47
Table 'RushAndCash319776' 6-max Seat #1 is the button
Seat 1: 23cd8de ($12.5 in chips)
Seat 2: ba032eea ($54.97 in chips)
Seat 3: b00dbb18 ($34.7 in chips)
Seat 4: Hero ($29.79 in chips)
Seat 5: 522e695b ($5.16 in chips)
Seat 6: cf8c7400 ($25 in chips)
ba032eea: posts small blind $0.1
b00dbb18: posts big blind $0.25
*** HOLE CARDS ***
Dealt to 23cd8de 
Dealt to ba032eea 
Dealt to b00dbb18 
Dealt to Hero [Kc Ts]
Dealt to 522e695b 
Dealt to cf8c7400 
Hero: folds
522e695b: folds
cf8c7400: folds
23cd8de: folds
ba032eea: folds
Uncalled bet ($0.15) returned to b00dbb18
*** SHOWDOWN ***
b00dbb18 collected $0.2 from pot
*** SUMMARY ***
Total pot $0.2
Seat 1: 23cd8de (button) folded before Flop (didn't bet)
Seat 2: ba032eea (small blind) folded before Flop
Seat 3: b00dbb18 (big blind) collected ($0.2)
Seat 4: Hero folded before Flop (didn't bet)
Seat 5: 522e695b folded before Flop (didn't bet)
Seat 6: cf8c7400 folded before Flop (didn't bet)


Poker Hand #RC94797728: Hold'em No Limit ($0.1/$0.25) - 2020/04/06 23:42:54
Table 'RushAndCash319783' 6-max Seat #1 is the button
Seat 1: e58da42d ($28.63 in chips)
Seat 2: 64933f7d ($12.85 in chips)
Seat 3: db4d85e3 ($12.5 in chips)
Seat 4: cce649b7 ($32.15 in chips)
Seat 5: Hero ($29.79 in chips)
Seat 6: dfcfe0b3 ($25 in chips)
64933f7d: posts small blind $0.1
db4d85e3: posts big blind $0.25
*** HOLE CARDS ***
Dealt to e58da42d 
Dealt to 64933f7d 
Dealt to db4d85e3 
Dealt to cce649b7 
Dealt to Hero [9s 2s]
Dealt to dfcfe0b3 
cce649b7: folds
Hero: folds
dfcfe0b3: folds
e58da42d: raises $0.5 to $0.75
64933f7d: calls $0.65
db4d85e3: calls $0.5
*** FLOP *** [8c 7d 8s]
64933f7d: checks
db4d85e3: checks
e58da42d: bets $1.2
64933f7d: folds
db4d85e3: calls $1.2
*** TURN *** [8c 7d 8s] [Jd]
db4d85e3: checks
e58da42d: checks
*** RIVER *** [8c 7d 8s Jd] [As]
db4d85e3: checks
e58da42d: checks
db4d85e3: shows [3c Kc] (Pair of Eights)
e58da42d: shows [Th Ts] (Pair of Tens and Pair of Eights)
*** SHOWDOWN ***
e58da42d collected $4.65 from pot
*** SUMMARY ***
Total pot $4.65
Board [8c 7d 8s Jd As]
Seat 1: e58da42d (button) showed [Ts Th] and won ($4.65) with Pair of Tens and Pair of Eights
Seat 2: 64933f7d (small blind) folded on the Flop
Seat 3: db4d85e3 (big blind) showed [Kc 3c] and lost with Pair of Eights
Seat 4: cce649b7 folded before Flop (didn't bet)
Seat 5: Hero folded before Flop (didn't bet)
Seat 6: dfcfe0b3 folded before Flop (didn't bet)


Poker Hand #RC94797765: Hold'em No Limit ($0.1/$0.25) - 2020/04/06 23:43:03
Table 'RushAndCash319789' 6-max Seat #1 is the button
Seat 1: Hero ($29.79 in chips)
Seat 2: 8e166af5 ($55.07 in chips)
Seat 3: cce649b7 ($32.15 in chips)
Seat 4: 19e4cb38 ($27.16 in chips)
Seat 5: bc200877 ($12.16 in chips)
Seat 6: d8a224aa ($26.53 in chips)
8e166af5: posts small blind $0.1
cce649b7: posts big blind $0.25
*** HOLE CARDS ***
Dealt to Hero [Qc 3c]
Dealt to 8e166af5 
Dealt to cce649b7 
Dealt to 19e4cb38 
Dealt to bc200877 
Dealt to d8a224aa 
19e4cb38: folds
bc200877: raises $0.38 to $0.63
d8a224aa: folds
Hero: folds
8e166af5: folds
cce649b7: folds
Uncalled bet ($0.38) returned to bc200877
*** SHOWDOWN ***
bc200877 collected $0.6 from pot
*** SUMMARY ***
Total pot $0.6
Seat 1: Hero (button) folded before Flop (didn't bet)
Seat 2: 8e166af5 (small blind) folded before Flop
Seat 3: cce649b7 (big blind) folded before Flop
Seat 4: 19e4cb38 folded before Flop (didn't bet)
Seat 5: bc200877 collected ($0.6)
Seat 6: d8a224aa folded before Flop (didn't bet)


Poker Hand #RC94797780: Hold'em No Limit ($0.1/$0.25) - 2020/04/06 23:43:06
Table 'RushAndCash319792' 6-max Seat #1 is the button
Seat 1: 1e890f21 ($15.37 in chips)
Seat 2: 9afeb2a7 ($29.42 in chips)
Seat 3: Hero ($29.79 in chips)
Seat 4: 19e4cb38 ($27.16 in chips)
Seat 5: 41ab7510 ($27.31 in chips)
Seat 6: fe7c9e7a ($28.48 in chips)
9afeb2a7: posts small blind $0.1
Hero: posts big blind $0.25
*** HOLE CARDS ***
Dealt to 1e890f21 
Dealt to 9afeb2a7 
Dealt to Hero [Jc 4d]
Dealt to 19e4cb38 
Dealt to 41ab7510 
Dealt to fe7c9e7a 
19e4cb38: folds
41ab7510: folds
fe7c9e7a: folds
1e890f21: folds
9afeb2a7: folds
Uncalled bet ($0.15) returned to Hero
*** SHOWDOWN ***
Hero collected $0.2 from pot
*** SUMMARY ***
Total pot $0.2
Seat 1: 1e890f21 (button) folded before Flop (didn't bet)
Seat 2: 9afeb2a7 (small blind) folded before Flop
Seat 3: Hero (big blind) collected ($0.2)
Seat 4: 19e4cb38 folded before Flop (didn't bet)
Seat 5: 41ab7510 folded before Flop (didn't bet)
Seat 6: fe7c9e7a folded before Flop (didn't bet)


Poker Hand #RC94797803: Hold'em No Limit ($0.1/$0.25) - 2020/04/06 23:43:11
Table 'RushAndCash319796' 6-max Seat #1 is the button
Seat 1: 792342dd ($8.82 in chips)
Seat 2: 41ab7510 ($27.31 in chips)
Seat 3: Hero ($29.54 in chips)
Seat 4: 9afeb2a7 ($29.32 in chips)
Seat 5: fe7c9e7a ($28.48 in chips)
Seat 6: 928a94bb ($53.66 in chips)
41ab7510: posts small blind $0.1
Hero: posts big blind $0.25
*** HOLE CARDS ***
Dealt to 792342dd 
Dealt to 41ab7510 
Dealt to Hero [Ks Kd]
Dealt to 9afeb2a7 
Dealt to fe7c9e7a 
Dealt to 928a94bb 
9afeb2a7: folds
fe7c9e7a: folds
928a94bb: folds
792342dd: folds
41ab7510: raises $0.5 to $0.75
Hero: calls $0.5
*** FLOP *** [Ad 6h 9d]
41ab7510: bets $0.55
Hero: calls $0.55
*** TURN *** [Ad 6h 9d] [6c]
41ab7510: checks
Hero: checks
*** RIVER *** [Ad 6h 9d 6c] [Kh]
41ab7510: bets $1.3
Hero: raises $3.9 to $5.2
41ab7510: folds
Uncalled bet ($3.9) returned to Hero
*** SHOWDOWN ***
Hero collected $5.2 from pot
*** SUMMARY ***
Total pot $5.2
Board [Ad 6h 9d 6c Kh]
Seat 1: 792342dd (button) folded before Flop (didn't bet)
Seat 2: 41ab7510 (small blind) folded on the River
Seat 3: Hero (big blind) won ($5.2)
Seat 4: 9afeb2a7 folded before Flop (didn't bet)
Seat 5: fe7c9e7a folded before Flop (didn't bet)
Seat 6: 928a94bb folded before Flop (didn't bet)


Poker Hand #RC94798196: Hold'em No Limit ($0.1/$0.25) - 2020/04/06 23:44:38
Table 'RushAndCash319866' 6-max Seat #1 is the button
Seat 1: afa5143c ($33.27 in chips)
Seat 2: ac4ab575 ($12.95 in chips)
Seat 3: fe7c9e7a ($28.13 in chips)
Seat 4: a82639fc ($63.67 in chips)
Seat 5: 9d598a03 ($52.22 in chips)
Seat 6: Hero ($32.23 in chips)
ac4ab575: posts small blind $0.1
fe7c9e7a: posts big blind $0.25
*** HOLE CARDS ***
Dealt to afa5143c 
Dealt to ac4ab575 
Dealt to fe7c9e7a 
Dealt to a82639fc 
Dealt to 9d598a03 
Dealt to Hero [Jd 3d]
a82639fc: folds
9d598a03: folds
Hero: folds
afa5143c: raises $0.38 to $0.63
ac4ab575: raises $1.57 to $2.2
fe7c9e7a: folds
afa5143c: folds
Uncalled bet ($1.57) returned to ac4ab575
*** SHOWDOWN ***
ac4ab575 collected $1.51 from pot
*** SUMMARY ***
Total pot $1.51
Seat 1: afa5143c (button) folded before Flop
Seat 2: ac4ab575 (small blind) collected ($1.51)
Seat 3: fe7c9e7a (big blind) folded before Flop
Seat 4: a82639fc folded before Flop (didn't bet)
Seat 5: 9d598a03 folded before Flop (didn't bet)
Seat 6: Hero folded before Flop (didn't bet)


Poker Hand #RC94798219: Hold'em No Limit ($0.1/$0.25) - 2020/04/06 23:44:42
Table 'RushAndCash319870' 6-max Seat #1 is the button
Seat 1: 9d598a03 ($52.22 in chips)
Seat 2: fe7c9e7a ($27.88 in chips)
Seat 3: 4244d459 ($12.85 in chips)
Seat 4: a2913d47 ($24.65 in chips)
Seat 5: Hero ($32.23 in chips)
Seat 6: 36ac4586 ($52.61 in chips)
fe7c9e7a: posts small blind $0.1
4244d459: posts big blind $0.25
*** HOLE CARDS ***
Dealt to 9d598a03 
Dealt to fe7c9e7a 
Dealt to 4244d459 
Dealt to a2913d47 
Dealt to Hero [6s 5h]
Dealt to 36ac4586 
a2913d47: folds
Hero: folds
36ac4586: folds
9d598a03: folds
fe7c9e7a: folds
Uncalled bet ($0.15) returned to 4244d459
*** SHOWDOWN ***
4244d459 collected $0.2 from pot
*** SUMMARY ***
Total pot $0.2
Seat 1: 9d598a03 (button) folded before Flop (didn't bet)
Seat 2: fe7c9e7a (small blind) folded before Flop
Seat 3: 4244d459 (big blind) collected ($0.2)
Seat 4: a2913d47 folded before Flop (didn't bet)
Seat 5: Hero folded before Flop (didn't bet)
Seat 6: 36ac4586 folded before Flop (didn't bet)


Poker Hand #RC94798255: Hold'em No Limit ($0.1/$0.25) - 2020/04/06 23:44:49
Table 'RushAndCash319877' 6-max Seat #1 is the button
Seat 1: b9492ea1 ($24.28 in chips)
Seat 2: b23c402d ($12.45 in chips)
Seat 3: Hero ($32.23 in chips)
Seat 4: e767af3b ($37.26 in chips)
Seat 5: 7ae5ca25 ($13.84 in chips)
Seat 6: 8466ae26 ($28.39 in chips)
b23c402d: posts small blind $0.1
Hero: posts big blind $0.25
*** HOLE CARDS ***
Dealt to b9492ea1 
Dealt to b23c402d 
Dealt to Hero [Ts 3h]
Dealt to e767af3b 
Dealt to 7ae5ca25 
Dealt to 8466ae26 
e767af3b: folds
7ae5ca25: folds
8466ae26: raises $0.38 to $0.63
b9492ea1: raises $1.67 to $2.3
b23c402d: calls $2.2
Hero: folds
8466ae26: raises $5.1 to $7.4
b9492ea1: raises $16.88 to $24.28 and is all-in
b23c402d: calls $10.15 and is all-in
8466ae26: calls $16.88
b9492ea1: shows [Kc Kd]
b23c402d: shows [Jh Kh]
8466ae26: shows [As Ac]
*** FLOP *** [9c 7c 9h]
*** TURN *** [9c 7c 9h] [Td]
*** RIVER *** [9c 7c 9h Td] [4h]
*** SHOWDOWN ***
8466ae26 collected $37.6 from pot
8466ae26 collected $23.66 from pot
*** SUMMARY ***
Total pot $61.26
Board [9c 7c 9h Td 4h]
Seat 1: b9492ea1 (button) showed [Kd Kc] and lost with Pair of Kings and Pair of Nines
Seat 2: b23c402d (small blind) showed [Kh Jh] and lost with Pair of Nines
Seat 3: Hero (big blind) folded before Flop
Seat 4: e767af3b folded before Flop (didn't bet)
Seat 5: 7ae5ca25 folded before Flop (didn't bet)
Seat 6: 8466ae26 showed [As Ac] and won ($61.26) with Pair of Aces and Pair of Nines


Poker Hand #RC94798274: Hold'em No Limit ($0.1/$0.25) - 2020/04/06 23:44:53
Table 'RushAndCash319881' 6-max Seat #1 is the button
Seat 1: 1bc051b2 ($12.34 in chips)
Seat 2: Hero ($31.98 in chips)
Seat 3: 9d598a03 ($52.22 in chips)
Seat 4: 90609fad ($54.55 in chips)
Seat 5: 604f36f0 ($18.36 in chips)
Seat 6: 9c511c89 ($15.93 in chips)
Hero: posts small blind $0.1
9d598a03: posts big blind $0.25
*** HOLE CARDS ***
Dealt to 1bc051b2 
Dealt to Hero [5s 3d]
Dealt to 9d598a03 
Dealt to 90609fad 
Dealt to 604f36f0 
Dealt to 9c511c89 
90609fad: folds
604f36f0: folds
9c511c89: folds
1bc051b2: raises $0.25 to $0.5
Hero: folds
9d598a03: folds
Uncalled bet ($0.25) returned to 1bc051b2
*** SHOWDOWN ***
1bc051b2 collected $0.6 from pot
*** SUMMARY ***
Total pot $0.6
Seat 1: 1bc051b2 (button) collected ($0.6)
Seat 2: Hero (small blind) folded before Flop
Seat 3: 9d598a03 (big blind) folded before Flop
Seat 4: 90609fad folded before Flop (didn't bet)
Seat 5: 604f36f0 folded before Flop (didn't bet)
Seat 6: 9c511c89 folded before Flop (didn't bet)


Poker Hand #RC94798286: Hold'em No Limit ($0.1/$0.25) - 2020/04/06 23:44:56
Table 'RushAndCash319884' 6-max Seat #1 is the button
Seat 1: cc4afcf8 ($12 in chips)
Seat 2: 2258ad9f ($68.96 in chips)
Seat 3: 2467bb49 ($57.96 in chips)
Seat 4: 969ce17 ($40.71 in chips)
Seat 5: d5960dd1 ($22.95 in chips)
Seat 6: Hero ($31.88 in chips)
2258ad9f: posts small blind $0.1
2467bb49: posts big blind $0.25
*** HOLE CARDS ***
Dealt to cc4afcf8 
Dealt to 2258ad9f 
Dealt to 2467bb49 
Dealt to 969ce17 
Dealt to d5960dd1 
Dealt to Hero [8c 4s]
969ce17: folds
d5960dd1: raises $0.5 to $0.75
Hero: folds
cc4afcf8: folds
2258ad9f: folds
2467bb49: folds
Uncalled bet ($0.5) returned to d5960dd1
*** SHOWDOWN ***
d5960dd1 collected $0.6 from pot
*** SUMMARY ***
Total pot $0.6
Seat 1: cc4afcf8 (button) folded before Flop (didn't bet)
Seat 2: 2258ad9f (small blind) folded before Flop
Seat 3: 2467bb49 (big blind) folded before Flop
Seat 4: 969ce17 folded before Flop (didn't bet)
Seat 5: d5960dd1 collected ($0.6)
Seat 6: Hero folded before Flop (didn't bet)


Poker Hand #RC94798306: Hold'em No Limit ($0.1/$0.25) - 2020/04/06 23:44:59
Table 'RushAndCash319889' 6-max Seat #1 is the button
Seat 1: Hero ($31.88 in chips)
Seat 2: afa5143c ($32.64 in chips)
Seat 3: 94efc628 ($25.1 in chips)
Seat 4: 8e166af5 ($53.92 in chips)
Seat 5: 312f6846 ($25 in chips)
Seat 6: 9b358964 ($27.85 in chips)
afa5143c: posts small blind $0.1
94efc628: posts big blind $0.25
*** HOLE CARDS ***
Dealt to Hero [3c 2h]
Dealt to afa5143c 
Dealt to 94efc628 
Dealt to 8e166af5 
Dealt to 312f6846 
Dealt to 9b358964 
8e166af5: folds
312f6846: folds
9b358964: folds
Hero: folds
afa5143c: raises $0.5 to $0.75
94efc628: folds
Uncalled bet ($0.5) returned to afa5143c
*** SHOWDOWN ***
afa5143c collected $0.5 from pot
*** SUMMARY ***
Total pot $0.5
Seat 1: Hero (button) folded before Flop (didn't bet)
Seat 2: afa5143c (small blind) collected ($0.5)
Seat 3: 94efc628 (big blind) folded before Flop
Seat 4: 8e166af5 folded before Flop (didn't bet)
Seat 5: 312f6846 folded before Flop (didn't bet)
Seat 6: 9b358964 folded before Flop (didn't bet)


Poker Hand #RC94798330: Hold'em No Limit ($0.1/$0.25) - 2020/04/06 23:45:04
Table 'RushAndCash319894' 6-max Seat #1 is the button
Seat 1: 8abd2614 ($15.54 in chips)
Seat 2: Hero ($31.88 in chips)
Seat 3: a82639fc ($63.57 in chips)
Seat 4: b9bbf733 ($25.49 in chips)
Seat 5: 94efc628 ($25.35 in chips)
Seat 6: b215699c ($57.81 in chips)
Hero: posts small blind $0.1
a82639fc: posts big blind $0.25
*** HOLE CARDS ***
Dealt to 8abd2614 
Dealt to Hero [Td Tc]
Dealt to a82639fc 
Dealt to b9bbf733 
Dealt to 94efc628 
Dealt to b215699c 
b9bbf733: folds
94efc628: folds
b215699c: folds
8abd2614: raises $0.5 to $0.75
Hero: raises $2.25 to $3
a82639fc: folds
8abd2614: folds
Uncalled bet ($2.25) returned to Hero
*** SHOWDOWN ***
Hero collected $1.75 from pot
*** SUMMARY ***
Total pot $1.75
Seat 1: 8abd2614 (button) folded before Flop
Seat 2: Hero (small blind) collected ($1.75)
Seat 3: a82639fc (big blind) folded before Flop
Seat 4: b9bbf733 folded before Flop (didn't bet)
Seat 5: 94efc628 folded before Flop (didn't bet)
Seat 6: b215699c folded before Flop (didn't bet)


Poker Hand #RC94798446: Hold'em No Limit ($0.1/$0.25) - 2020/04/06 23:45:28
Table 'RushAndCash319917' 6-max Seat #1 is the button
Seat 1: 8fb93df3 ($41.74 in chips)
Seat 2: 792342dd ($8.22 in chips)
Seat 3: 8abd2614 ($14.79 in chips)
Seat 4: ce4e1e37 ($29.71 in chips)
Seat 5: Hero ($32.8 in chips)
Seat 6: 7357eb2f ($46.1 in chips)
792342dd: posts small blind $0.1
8abd2614: posts big blind $0.25
*** HOLE CARDS ***
Dealt to 8fb93df3 
Dealt to 792342dd 
Dealt to 8abd2614 
Dealt to ce4e1e37 
Dealt to Hero [Qd 4s]
Dealt to 7357eb2f 
ce4e1e37: folds
Hero: folds
7357eb2f: folds
8fb93df3: folds
792342dd: folds
Uncalled bet ($0.15) returned to 8abd2614
*** SHOWDOWN ***
8abd2614 collected $0.2 from pot
*** SUMMARY ***
Total pot $0.2
Seat 1: 8fb93df3 (button) folded before Flop (didn't bet)
Seat 2: 792342dd (small blind) folded before Flop
Seat 3: 8abd2614 (big blind) collected ($0.2)
Seat 4: ce4e1e37 folded before Flop (didn't bet)
Seat 5: Hero folded before Flop (didn't bet)
Seat 6: 7357eb2f folded before Flop (didn't bet)


Poker Hand #RC94798474: Hold'em No Limit ($0.1/$0.25) - 2020/04/06 23:45:33
Table 'RushAndCash319923' 6-max Seat #1 is the button
Seat 1: Hero ($32.8 in chips)
Seat 2: 1d6fff9c ($25.1 in chips)
Seat 3: dfcfe0b3 ($25.26 in chips)
Seat 4: b5518434 ($24.65 in chips)
Seat 5: 19e4cb38 ($26.31 in chips)
Seat 6: 8e166af5 ($54.02 in chips)
1d6fff9c: posts small blind $0.1
dfcfe0b3: posts big blind $0.25
*** HOLE CARDS ***
Dealt to Hero [4c 2d]
Dealt to 1d6fff9c 
Dealt to dfcfe0b3 
Dealt to b5518434 
Dealt to 19e4cb38 
Dealt to 8e166af5 
b5518434: folds
19e4cb38: folds
8e166af5: raises $0.5 to $0.75
Hero: folds
1d6fff9c: folds
dfcfe0b3: raises $2.25 to $3
8e166af5: folds
Uncalled bet ($2.25) returned to dfcfe0b3
*** SHOWDOWN ***
dfcfe0b3 collected $1.6 from pot
*** SUMMARY ***
Total pot $1.6
Seat 1: Hero (button) folded before Flop (didn't bet)
Seat 2: 1d6fff9c (small blind) folded before Flop
Seat 3: dfcfe0b3 (big blind) collected ($1.6)
Seat 4: b5518434 folded before Flop (didn't bet)
Seat 5: 19e4cb38 folded before Flop (didn't bet)
Seat 6: 8e166af5 folded before Flop


Poker Hand #RC94798527: Hold'em No Limit ($0.1/$0.25) - 2020/04/06 23:45:44
Table 'RushAndCash319935' 6-max Seat #1 is the button
Seat 1: 7357eb2f ($46 in chips)
Seat 2: 312f6846 ($25 in chips)
Seat 3: 969ce17 ($41.06 in chips)
Seat 4: 5bb85d35 ($16.97 in chips)
Seat 5: cce649b7 ($31.52 in chips)
Seat 6: Hero ($32.8 in chips)
312f6846: posts small blind $0.1
969ce17: posts big blind $0.25
*** HOLE CARDS ***
Dealt to 7357eb2f 
Dealt to 312f6846 
Dealt to 969ce17 
Dealt to 5bb85d35 
Dealt to cce649b7 
Dealt to Hero [Ac Kh]
5bb85d35: calls $0.25
cce649b7: folds
Hero: raises $0.65 to $0.9
7357eb2f: folds
312f6846: folds
969ce17: folds
5bb85d35: raises $2.2 to $3.1
Hero: calls $2.2
*** FLOP *** [2c Td 4s]
5bb85d35: bets $13.87 and is all-in
Hero: folds
Uncalled bet ($13.87) returned to 5bb85d35
*** SHOWDOWN ***
5bb85d35 collected $6.55 from pot
*** SUMMARY ***
Total pot $6.55
Board [2c Td 4s]
Seat 1: 7357eb2f (button) folded before Flop (didn't bet)
Seat 2: 312f6846 (small blind) folded before Flop
Seat 3: 969ce17 (big blind) folded before Flop
Seat 4: 5bb85d35 won ($6.55)
Seat 5: cce649b7 folded before Flop (didn't bet)
Seat 6: Hero folded on the Flop


Poker Hand #RC94798697: Hold'em No Limit ($0.1/$0.25) - 2020/04/06 23:46:21
Table 'RushAndCash319968' 6-max Seat #1 is the button
Seat 1: 5e03da34 ($90.37 in chips)
Seat 2: ba032eea ($59.29 in chips)
Seat 3: 5bb85d35 ($20.1 in chips)
Seat 4: 1d6fff9c ($25.35 in chips)
Seat 5: Hero ($29.7 in chips)
Seat 6: c256b4a2 ($21.87 in chips)
ba032eea: posts small blind $0.1
5bb85d35: posts big blind $0.25
*** HOLE CARDS ***
Dealt to 5e03da34 
Dealt to ba032eea 
Dealt to 5bb85d35 
Dealt to 1d6fff9c 
Dealt to Hero [As Ac]
Dealt to c256b4a2 
1d6fff9c: folds
Hero: raises $0.38 to $0.63
c256b4a2: raises $1.32 to $1.95
5e03da34: folds
ba032eea: folds
5bb85d35: folds
Hero: calls $1.32
*** FLOP *** [4s Qd 6c]
Hero: checks
c256b4a2: bets $2.2
Hero: raises $2.9 to $5.1
c256b4a2: calls $2.9
*** TURN *** [4s Qd 6c] [9c]
Hero: checks
c256b4a2: checks
*** RIVER *** [4s Qd 6c 9c] [Qh]
Hero: bets $14.5
c256b4a2: calls $14.5
Hero: shows [As Ac] (Pair of Aces and Pair of Queens)
c256b4a2: shows [Qc Kd] (Three Queens)
*** SHOWDOWN ***
c256b4a2 collected $43.45 from pot
*** SUMMARY ***
Total pot $43.45
Board [4s Qd 6c 9c Qh]
Seat 1: 5e03da34 (button) folded before Flop (didn't bet)
Seat 2: ba032eea (small blind) folded before Flop
Seat 3: 5bb85d35 (big blind) folded before Flop
Seat 4: 1d6fff9c folded before Flop (didn't bet)
Seat 5: Hero showed [As Ac] and lost with Pair of Aces and Pair of Queens
Seat 6: c256b4a2 showed [Kd Qc] and won ($43.45) with Three Queens


Poker Hand #RC94799011: Hold'em No Limit ($0.1/$0.25) - 2020/04/06 23:47:31
Table 'RushAndCash320017' 6-max Seat #1 is the button
Seat 1: 8b5f3466 ($33.11 in chips)
Seat 2: dcc7f9d7 ($9.29 in chips)
Seat 3: b00dbb18 ($38.54 in chips)
Seat 4: Hero ($25 in chips)
Seat 5: 8466ae26 ($62.15 in chips)
Seat 6: 9e9b6fda ($22.52 in chips)
dcc7f9d7: posts small blind $0.1
b00dbb18: posts big blind $0.25
*** HOLE CARDS ***
Dealt to 8b5f3466 
Dealt to dcc7f9d7 
Dealt to b00dbb18 
Dealt to Hero [Qd 6d]
Dealt to 8466ae26 
Dealt to 9e9b6fda 
Hero: folds
8466ae26: raises $0.38 to $0.63
9e9b6fda: folds
8b5f3466: calls $0.63
dcc7f9d7: folds
b00dbb18: calls $0.38
*** FLOP *** [7c 3h 4c]
b00dbb18: checks
8466ae26: bets $1.2
8b5f3466: folds
b00dbb18: folds
Uncalled bet ($1.2) returned to 8466ae26
*** SHOWDOWN ***
8466ae26 collected $1.99 from pot
*** SUMMARY ***
Total pot $1.99
Board [7c 3h 4c]
Seat 1: 8b5f3466 (button) folded on the Flop
Seat 2: dcc7f9d7 (small blind) folded before Flop
Seat 3: b00dbb18 (big blind) folded on the Flop
Seat 4: Hero folded before Flop (didn't bet)
Seat 5: 8466ae26 won ($1.99)
Seat 6: 9e9b6fda folded before Flop (didn't bet)


Poker Hand #RC94799048: Hold'em No Limit ($0.1/$0.25) - 2020/04/06 23:47:39
Table 'RushAndCash320026' 6-max Seat #1 is the button
Seat 1: e767af3b ($36.18 in chips)
Seat 2: Hero ($25 in chips)
Seat 3: bc200877 ($13.52 in chips)
Seat 4: 4244d459 ($23.75 in chips)
Seat 5: 7ae5ca25 ($14.77 in chips)
Seat 6: ea5eba95 ($69.16 in chips)
Hero: posts small blind $0.1
bc200877: posts big blind $0.25
*** HOLE CARDS ***
Dealt to e767af3b 
Dealt to Hero [5h 3d]
Dealt to bc200877 
Dealt to 4244d459 
Dealt to 7ae5ca25 
Dealt to ea5eba95 
4244d459: folds
7ae5ca25: folds
ea5eba95: folds
e767af3b: raises $0.5 to $0.75
Hero: folds
bc200877: folds
Uncalled bet ($0.5) returned to e767af3b
*** SHOWDOWN ***
e767af3b collected $0.6 from pot
*** SUMMARY ***
Total pot $0.6
Seat 1: e767af3b (button) collected ($0.6)
Seat 2: Hero (small blind) folded before Flop
Seat 3: bc200877 (big blind) folded before Flop
Seat 4: 4244d459 folded before Flop (didn't bet)
Seat 5: 7ae5ca25 folded before Flop (didn't bet)
Seat 6: ea5eba95 folded before Flop (didn't bet)


Poker Hand #RC94799067: Hold'em No Limit ($0.1/$0.25) - 2020/04/06 23:47:44
Table 'RushAndCash320031' 6-max Seat #1 is the button
Seat 1: 8e166af5 ($53.58 in chips)
Seat 2: cc4afcf8 ($12.2 in chips)
Seat 3: Hero ($25 in chips)
Seat 4: 7357eb2f ($46 in chips)
Seat 5: 2c58d58e ($15.75 in chips)
Seat 6: 576737c8 ($12.85 in chips)
cc4afcf8: posts small blind $0.1
Hero: posts big blind $0.25
*** HOLE CARDS ***
Dealt to 8e166af5 
Dealt to cc4afcf8 
Dealt to Hero [4c 2h]
Dealt to 7357eb2f 
Dealt to 2c58d58e 
Dealt to 576737c8 
7357eb2f: folds
2c58d58e: folds
576737c8: folds
8e166af5: raises $0.5 to $0.75
cc4afcf8: folds
Hero: folds
Uncalled bet ($0.5) returned to 8e166af5
*** SHOWDOWN ***
8e166af5 collected $0.6 from pot
*** SUMMARY ***
Total pot $0.6
Seat 1: 8e166af5 (button) collected ($0.6)
Seat 2: cc4afcf8 (small blind) folded before Flop
Seat 3: Hero (big blind) folded before Flop
Seat 4: 7357eb2f folded before Flop (didn't bet)
Seat 5: 2c58d58e folded before Flop (didn't bet)
Seat 6: 576737c8 folded before Flop (didn't bet)


Poker Hand #RC94799098: Hold'em No Limit ($0.1/$0.25) - 2020/04/06 23:47:52
Table 'RushAndCash320037' 6-max Seat #1 is the button
Seat 1: 5b5fe518 ($29.73 in chips)
Seat 2: bd6eeaf3 ($57.42 in chips)
Seat 3: 9c584d7d ($15.71 in chips)
Seat 4: 9b358964 ($27.15 in chips)
Seat 5: 576737c8 ($12.85 in chips)
Seat 6: Hero ($25 in chips)
bd6eeaf3: posts small blind $0.1
9c584d7d: posts big blind $0.25
*** HOLE CARDS ***
Dealt to 5b5fe518 
Dealt to bd6eeaf3 
Dealt to 9c584d7d 
Dealt to 9b358964 
Dealt to 576737c8 
Dealt to Hero [Qd Qc]
9b358964: folds
576737c8: folds
Hero: raises $0.38 to $0.63
5b5fe518: folds
bd6eeaf3: folds
9c584d7d: folds
Uncalled bet ($0.38) returned to Hero
*** SHOWDOWN ***
Hero collected $0.6 from pot
*** SUMMARY ***
Total pot $0.6
Seat 1: 5b5fe518 (button) folded before Flop (didn't bet)
Seat 2: bd6eeaf3 (small blind) folded before Flop
Seat 3: 9c584d7d (big blind) folded before Flop
Seat 4: 9b358964 folded before Flop (didn't bet)
Seat 5: 576737c8 folded before Flop (didn't bet)
Seat 6: Hero collected ($0.6)


Poker Hand #RC94799197: Hold'em No Limit ($0.1/$0.25) - 2020/04/06 23:48:16
Table 'RushAndCash320052' 6-max Seat #1 is the button
Seat 1: 72fa991e ($35.95 in chips)
Seat 2: db4d85e3 ($14.05 in chips)
Seat 3: Hero ($25.35 in chips)
Seat 4: 41459cc9 ($26.01 in chips)
Seat 5: fe7c9e7a ($25 in chips)
Seat 6: 1826a10f ($11.65 in chips)
db4d85e3: posts small blind $0.1
Hero: posts big blind $0.25
*** HOLE CARDS ***
Dealt to 72fa991e 
Dealt to db4d85e3 
Dealt to Hero [8c 3s]
Dealt to 41459cc9 
Dealt to fe7c9e7a 
Dealt to 1826a10f 
41459cc9: folds
fe7c9e7a: folds
1826a10f: raises $0.38 to $0.63
72fa991e: folds
db4d85e3: folds
Hero: folds
Uncalled bet ($0.38) returned to 1826a10f
*** SHOWDOWN ***
1826a10f collected $0.6 from pot
*** SUMMARY ***
Total pot $0.6
Seat 1: 72fa991e (button) folded before Flop (didn't bet)
Seat 2: db4d85e3 (small blind) folded before Flop
Seat 3: Hero (big blind) folded before Flop
Seat 4: 41459cc9 folded before Flop (didn't bet)
Seat 5: fe7c9e7a folded before Flop (didn't bet)
Seat 6: 1826a10f collected ($0.6)


Poker Hand #RC94799212: Hold'em No Limit ($0.1/$0.25) - 2020/04/06 23:48:20
Table 'RushAndCash320055' 6-max Seat #1 is the button
Seat 1: a82639fc ($62.24 in chips)
Seat 2: 9d598a03 ($54.06 in chips)
Seat 3: 2c58d58e ($15.65 in chips)
Seat 4: 8a31aea7 ($71.13 in chips)
Seat 5: 9c584d7d ($15.36 in chips)
Seat 6: Hero ($25.1 in chips)
9d598a03: posts small blind $0.1
2c58d58e: posts big blind $0.25
*** HOLE CARDS ***
Dealt to a82639fc 
Dealt to 9d598a03 
Dealt to 2c58d58e 
Dealt to 8a31aea7 
Dealt to 9c584d7d 
Dealt to Hero [Ad 3s]
8a31aea7: raises $0.38 to $0.63
9c584d7d: folds
Hero: folds
a82639fc: folds
9d598a03: folds
2c58d58e: folds
Uncalled bet ($0.38) returned to 8a31aea7
*** SHOWDOWN ***
8a31aea7 collected $0.6 from pot
*** SUMMARY ***
Total pot $0.6
Seat 1: a82639fc (button) folded before Flop (didn't bet)
Seat 2: 9d598a03 (small blind) folded before Flop
Seat 3: 2c58d58e (big blind) folded before Flop
Seat 4: 8a31aea7 collected ($0.6)
Seat 5: 9c584d7d folded before Flop (didn't bet)
Seat 6: Hero folded before Flop (didn't bet)


Poker Hand #RC94799238: Hold'em No Limit ($0.1/$0.25) - 2020/04/06 23:48:27
Table 'RushAndCash320060' 6-max Seat #1 is the button
Seat 1: ba032eea ($58.74 in chips)
Seat 2: Hero ($25.1 in chips)
Seat 3: 19e4cb38 ($49.63 in chips)
Seat 4: b00dbb18 ($37.91 in chips)
Seat 5: e767af3b ($36.53 in chips)
Seat 6: 8abd2614 ($13.95 in chips)
Hero: posts small blind $0.1
19e4cb38: posts big blind $0.25
*** HOLE CARDS ***
Dealt to ba032eea 
Dealt to Hero [5h 2c]
Dealt to 19e4cb38 
Dealt to b00dbb18 
Dealt to e767af3b 
Dealt to 8abd2614 
b00dbb18: folds
e767af3b: folds
8abd2614: folds
ba032eea: folds
Hero: folds
Uncalled bet ($0.15) returned to 19e4cb38
*** SHOWDOWN ***
19e4cb38 collected $0.2 from pot
*** SUMMARY ***
Total pot $0.2
Seat 1: ba032eea (button) folded before Flop (didn't bet)
Seat 2: Hero (small blind) folded before Flop
Seat 3: 19e4cb38 (big blind) collected ($0.2)
Seat 4: b00dbb18 folded before Flop (didn't bet)
Seat 5: e767af3b folded before Flop (didn't bet)
Seat 6: 8abd2614 folded before Flop (didn't bet)


Poker Hand #RC94799277: Hold'em No Limit ($0.1/$0.25) - 2020/04/06 23:48:36
Table 'RushAndCash320066' 6-max Seat #1 is the button
Seat 1: Hero ($25 in chips)
Seat 2: dfcfe0b3 ($29.71 in chips)
Seat 3: e58da42d ($25 in chips)
Seat 4: 2ebb8f6c ($26.02 in chips)
Seat 5: b9bbf733 ($27.48 in chips)
Seat 6: 17480666 ($112.43 in chips)
dfcfe0b3: posts small blind $0.1
e58da42d: posts big blind $0.25
*** HOLE CARDS ***
Dealt to Hero [7d 3d]
Dealt to dfcfe0b3 
Dealt to e58da42d 
Dealt to 2ebb8f6c 
Dealt to b9bbf733 
Dealt to 17480666 
2ebb8f6c: folds
b9bbf733: folds
17480666: folds
Hero: folds
dfcfe0b3: folds
Uncalled bet ($0.15) returned to e58da42d
*** SHOWDOWN ***
e58da42d collected $0.2 from pot
*** SUMMARY ***
Total pot $0.2
Seat 1: Hero (button) folded before Flop (didn't bet)
Seat 2: dfcfe0b3 (small blind) folded before Flop
Seat 3: e58da42d (big blind) collected ($0.2)
Seat 4: 2ebb8f6c folded before Flop (didn't bet)
Seat 5: b9bbf733 folded before Flop (didn't bet)
Seat 6: 17480666 folded before Flop (didn't bet)


Poker Hand #RC94799299: Hold'em No Limit ($0.1/$0.25) - 2020/04/06 23:48:40
Table 'RushAndCash320070' 6-max Seat #1 is the button
Seat 1: 522e695b ($12.26 in chips)
Seat 2: 2467bb49 ($62.44 in chips)
Seat 3: d8a224aa ($43.35 in chips)
Seat 4: Hero ($25 in chips)
Seat 5: 928a94bb ($57.86 in chips)
Seat 6: db4d85e3 ($13.95 in chips)
2467bb49: posts small blind $0.1
d8a224aa: posts big blind $0.25
*** HOLE CARDS ***
Dealt to 522e695b 
Dealt to 2467bb49 
Dealt to d8a224aa 
Dealt to Hero [As 8c]
Dealt to 928a94bb 
Dealt to db4d85e3 
Hero: folds
928a94bb: folds
db4d85e3: raises $0.45 to $0.7
522e695b: folds
2467bb49: folds
d8a224aa: calls $0.45
*** FLOP *** [9h 9d Qc]
d8a224aa: checks
db4d85e3: checks
*** TURN *** [9h 9d Qc] [Kd]
d8a224aa: bets $1.2
db4d85e3: folds
Uncalled bet ($1.2) returned to d8a224aa
*** SHOWDOWN ***
d8a224aa collected $1.5 from pot
*** SUMMARY ***
Total pot $1.5
Board [9h 9d Qc Kd]
Seat 1: 522e695b (button) folded before Flop (didn't bet)
Seat 2: 2467bb49 (small blind) folded before Flop
Seat 3: d8a224aa (big blind) won ($1.5)
Seat 4: Hero folded before Flop (didn't bet)
Seat 5: 928a94bb folded before Flop (didn't bet)
Seat 6: db4d85e3 folded on the Turn


Poker Hand #RC94799319: Hold'em No Limit ($0.1/$0.25) - 2020/04/06 23:48:45
Table 'RushAndCash320074' 6-max Seat #1 is the button
Seat 1: 41459cc9 ($25.76 in chips)
Seat 2: 576737c8 ($12.5 in chips)
Seat 3: 8a31aea7 ($71.48 in chips)
Seat 4: dfcfe0b3 ($29.61 in chips)
Seat 5: Hero ($25 in chips)
Seat 6: 928a94bb ($57.86 in chips)
576737c8: posts small blind $0.1
8a31aea7: posts big blind $0.25
*** HOLE CARDS ***
Dealt to 41459cc9 
Dealt to 576737c8 
Dealt to 8a31aea7 
Dealt to dfcfe0b3 
Dealt to Hero [Qc 9d]
Dealt to 928a94bb 
dfcfe0b3: folds
Hero: folds
928a94bb: raises $0.38 to $0.63
41459cc9: folds
576737c8: folds
8a31aea7: calls $0.38
*** FLOP *** [Ad 9s 3s]
8a31aea7: checks
928a94bb: bets $0.7
8a31aea7: calls $0.7
*** TURN *** [Ad 9s 3s] [7s]
8a31aea7: checks
928a94bb: checks
*** RIVER *** [Ad 9s 3s 7s] [Ah]
8a31aea7: bets $1
928a94bb: calls $1
8a31aea7: shows [As 8d] (Three Aces)
928a94bb: shows [Kd 5d] (Pair of Aces)
*** SHOWDOWN ***
8a31aea7 collected $4.76 from pot
*** SUMMARY ***
Total pot $4.76
Board [Ad 9s 3s 7s Ah]
Seat 1: 41459cc9 (button) folded before Flop (didn't bet)
Seat 2: 576737c8 (small blind) folded before Flop
Seat 3: 8a31aea7 (big blind) showed [As 8d] and won ($4.76) with Three Aces
Seat 4: dfcfe0b3 folded before Flop (didn't bet)
Seat 5: Hero folded before Flop (didn't bet)
Seat 6: 928a94bb showed [Kd 5d] and lost with Pair of Aces


Poker Hand #RC94799341: Hold'em No Limit ($0.1/$0.25) - 2020/04/06 23:48:49
Table 'RushAndCash320078' 6-max Seat #1 is the button
Seat 1: b00dbb18 ($37.81 in chips)
Seat 2: Hero ($25 in chips)
Seat 3: 94efc628 ($25.1 in chips)
Seat 4: dfcfe0b3 ($29.61 in chips)
Seat 5: ba032eea ($58.74 in chips)
Seat 6: 2060075e ($25.35 in chips)
Hero: posts small blind $0.1
94efc628: posts big blind $0.25
*** HOLE CARDS ***
Dealt to b00dbb18 
Dealt to Hero [Th 4h]
Dealt to 94efc628 
Dealt to dfcfe0b3 
Dealt to ba032eea 
Dealt to 2060075e 
dfcfe0b3: folds
ba032eea: raises $0.38 to $0.63
2060075e: folds
b00dbb18: raises $1.27 to $1.9
Hero: folds
94efc628: folds
ba032eea: calls $1.27
*** FLOP *** [9s 4s 6s]
ba032eea: checks
b00dbb18: checks
*** TURN *** [9s 4s 6s] [Ac]
ba032eea: bets $2.35
b00dbb18: folds
Uncalled bet ($2.35) returned to ba032eea
*** SHOWDOWN ***
ba032eea collected $4.15 from pot
*** SUMMARY ***
Total pot $4.15
Board [9s 4s 6s Ac]
Seat 1: b00dbb18 (button) folded on the Turn
Seat 2: Hero (small blind) folded before Flop
Seat 3: 94efc628 (big blind) folded before Flop
Seat 4: dfcfe0b3 folded before Flop (didn't bet)
Seat 5: ba032eea won ($4.15)
Seat 6: 2060075e folded before Flop (didn't bet)


Poker Hand #RC94799361: Hold'em No Limit ($0.1/$0.25) - 2020/04/06 23:48:54
Table 'RushAndCash320083' 6-max Seat #1 is the button
Seat 1: dfcfe0b3 ($29.61 in chips)
Seat 2: ca69da65 ($34.77 in chips)
Seat 3: 9b358964 ($28.81 in chips)
Seat 4: a2913d47 ($17.14 in chips)
Seat 5: 1bc051b2 ($17.01 in chips)
Seat 6: Hero ($25 in chips)
ca69da65: posts small blind $0.1
9b358964: posts big blind $0.25
*** HOLE CARDS ***
Dealt to dfcfe0b3 
Dealt to ca69da65 
Dealt to 9b358964 
Dealt to a2913d47 
Dealt to 1bc051b2 
Dealt to Hero [Jh 3c]
a2913d47: raises $0.5 to $0.75
1bc051b2: folds
Hero: folds
dfcfe0b3: folds
ca69da65: folds
9b358964: folds
Uncalled bet ($0.5) returned to a2913d47
*** SHOWDOWN ***
a2913d47 collected $0.6 from pot
*** SUMMARY ***
Total pot $0.6
Seat 1: dfcfe0b3 (button) folded before Flop (didn't bet)
Seat 2: ca69da65 (small blind) folded before Flop
Seat 3: 9b358964 (big blind) folded before Flop
Seat 4: a2913d47 collected ($0.6)
Seat 5: 1bc051b2 folded before Flop (didn't bet)
Seat 6: Hero folded before Flop (didn't bet)


Poker Hand #RC94799377: Hold'em No Limit ($0.1/$0.25) - 2020/04/06 23:48:58
Table 'RushAndCash320087' 6-max Seat #1 is the button
Seat 1: 969ce17 ($38.68 in chips)
Seat 2: 59bcbffa ($25.1 in chips)
Seat 3: 8466ae26 ($63.66 in chips)
Seat 4: Hero ($25 in chips)
Seat 5: bd6eeaf3 ($56.69 in chips)
Seat 6: 8abd2614 ($13.95 in chips)
59bcbffa: posts small blind $0.1
8466ae26: posts big blind $0.25
*** HOLE CARDS ***
Dealt to 969ce17 
Dealt to 59bcbffa 
Dealt to 8466ae26 
Dealt to Hero [Ah Qs]
Dealt to bd6eeaf3 
Dealt to 8abd2614 
Hero: raises $0.38 to $0.63
bd6eeaf3: folds
8abd2614: folds
969ce17: folds
59bcbffa: folds
8466ae26: calls $0.38
*** FLOP *** [9h 9c 6h]
8466ae26: checks
Hero: bets $0.5
8466ae26: folds
Uncalled bet ($0.5) returned to Hero
*** SHOWDOWN ***
Hero collected $1.36 from pot
*** SUMMARY ***
Total pot $1.36
Board [9h 9c 6h]
Seat 1: 969ce17 (button) folded before Flop (didn't bet)
Seat 2: 59bcbffa (small blind) folded before Flop
Seat 3: 8466ae26 (big blind) folded on the Flop
Seat 4: Hero won ($1.36)
Seat 5: bd6eeaf3 folded before Flop (didn't bet)
Seat 6: 8abd2614 folded before Flop (didn't bet)


Poker Hand #RC94799492: Hold'em No Limit ($0.1/$0.25) - 2020/04/06 23:49:23
Table 'RushAndCash320105' 6-max Seat #1 is the button
Seat 1: b9bbf733 ($27.23 in chips)
Seat 2: 8466ae26 ($63.03 in chips)
Seat 3: Hero ($25.67 in chips)
Seat 4: db4d85e3 ($13.25 in chips)
Seat 5: 90609fad ($54.14 in chips)
Seat 6: d8a224aa ($44.08 in chips)
8466ae26: posts small blind $0.1
Hero: posts big blind $0.25
*** HOLE CARDS ***
Dealt to b9bbf733 
Dealt to 8466ae26 
Dealt to Hero [Td 4c]
Dealt to db4d85e3 
Dealt to 90609fad 
Dealt to d8a224aa 
db4d85e3: folds
90609fad: folds
d8a224aa: folds
b9bbf733: raises $0.25 to $0.5
8466ae26: folds
Hero: folds
Uncalled bet ($0.25) returned to b9bbf733
*** SHOWDOWN ***
b9bbf733 collected $0.6 from pot
*** SUMMARY ***
Total pot $0.6
Seat 1: b9bbf733 (button) collected ($0.6)
Seat 2: 8466ae26 (small blind) folded before Flop
Seat 3: Hero (big blind) folded before Flop
Seat 4: db4d85e3 folded before Flop (didn't bet)
Seat 5: 90609fad folded before Flop (didn't bet)
Seat 6: d8a224aa folded before Flop (didn't bet)


Poker Hand #RC94799534: Hold'em No Limit ($0.1/$0.25) - 2020/04/06 23:49:32
Table 'RushAndCash320114' 6-max Seat #1 is the button
Seat 1: 90609fad ($53.89 in chips)
Seat 2: 17480666 ($112.18 in chips)
Seat 3: 792342dd ($15.34 in chips)
Seat 4: 5e03da34 ($84.47 in chips)
Seat 5: Hero ($25.42 in chips)
Seat 6: 72fa991e ($35.95 in chips)
17480666: posts small blind $0.1
792342dd: posts big blind $0.25
*** HOLE CARDS ***
Dealt to 90609fad 
Dealt to 17480666 
Dealt to 792342dd 
Dealt to 5e03da34 
Dealt to Hero [Ah 9d]
Dealt to 72fa991e 
5e03da34: folds
Hero: folds
72fa991e: raises $0.38 to $0.63
90609fad: folds
17480666: folds
792342dd: folds
Uncalled bet ($0.38) returned to 72fa991e
*** SHOWDOWN ***
72fa991e collected $0.6 from pot
*** SUMMARY ***
Total pot $0.6
Seat 1: 90609fad (button) folded before Flop (didn't bet)
Seat 2: 17480666 (small blind) folded before Flop
Seat 3: 792342dd (big blind) folded before Flop
Seat 4: 5e03da34 folded before Flop (didn't bet)
Seat 5: Hero folded before Flop (didn't bet)
Seat 6: 72fa991e collected ($0.6)


Poker Hand #RC94799555: Hold'em No Limit ($0.1/$0.25) - 2020/04/06 23:49:37
Table 'RushAndCash320119' 6-max Seat #1 is the button
Seat 1: 8b5f3466 ($32.83 in chips)
Seat 2: 5b5fe518 ($27.33 in chips)
Seat 3: 9afeb2a7 ($32.8 in chips)
Seat 4: 19e4cb38 ($49.93 in chips)
Seat 5: Hero ($25.42 in chips)
Seat 6: 90609fad ($53.89 in chips)
5b5fe518: posts small blind $0.1
9afeb2a7: posts big blind $0.25
*** HOLE CARDS ***
Dealt to 8b5f3466 
Dealt to 5b5fe518 
Dealt to 9afeb2a7 
Dealt to 19e4cb38 
Dealt to Hero [Jd 8s]
Dealt to 90609fad 
19e4cb38: folds
Hero: folds
90609fad: folds
8b5f3466: folds
5b5fe518: folds
Uncalled bet ($0.15) returned to 9afeb2a7
*** SHOWDOWN ***
9afeb2a7 collected $0.2 from pot
*** SUMMARY ***
Total pot $0.2
Seat 1: 8b5f3466 (button) folded before Flop (didn't bet)
Seat 2: 5b5fe518 (small blind) folded before Flop
Seat 3: 9afeb2a7 (big blind) collected ($0.2)
Seat 4: 19e4cb38 folded before Flop (didn't bet)
Seat 5: Hero folded before Flop (didn't bet)
Seat 6: 90609fad folded before Flop (didn't bet)


Poker Hand #RC94799571: Hold'em No Limit ($0.1/$0.25) - 2020/04/06 23:49:41
Table 'RushAndCash320123' 6-max Seat #1 is the button
Seat 1: Hero ($25.42 in chips)
Seat 2: 19e4cb38 ($49.93 in chips)
Seat 3: fd369e31 ($62.54 in chips)
Seat 4: 2467bb49 ($62.34 in chips)
Seat 5: 64933f7d ($16.02 in chips)
Seat 6: bc200877 ($14.3 in chips)
19e4cb38: posts small blind $0.1
fd369e31: posts big blind $0.25
*** HOLE CARDS ***
Dealt to Hero [Jd 2c]
Dealt to 19e4cb38 
Dealt to fd369e31 
Dealt to 2467bb49 
Dealt to 64933f7d 
Dealt to bc200877 
2467bb49: folds
64933f7d: folds
bc200877: folds
Hero: folds
19e4cb38: folds
Uncalled bet ($0.15) returned to fd369e31
*** SHOWDOWN ***
fd369e31 collected $0.2 from pot
*** SUMMARY ***
Total pot $0.2
Seat 1: Hero (button) folded before Flop (didn't bet)
Seat 2: 19e4cb38 (small blind) folded before Flop
Seat 3: fd369e31 (big blind) collected ($0.2)
Seat 4: 2467bb49 folded before Flop (didn't bet)
Seat 5: 64933f7d folded before Flop (didn't bet)
Seat 6: bc200877 folded before Flop (didn't bet)


Poker Hand #RC94799590: Hold'em No Limit ($0.1/$0.25) - 2020/04/06 23:49:44
Table 'RushAndCash320127' 6-max Seat #1 is the button
Seat 1: 5b5fe518 ($27.23 in chips)
Seat 2: b215699c ($55.41 in chips)
Seat 3: 64933f7d ($16.02 in chips)
Seat 4: Hero ($25.42 in chips)
Seat 5: 604f36f0 ($13.06 in chips)
Seat 6: 8b5f3466 ($32.83 in chips)
b215699c: posts small blind $0.1
64933f7d: posts big blind $0.25
*** HOLE CARDS ***
Dealt to 5b5fe518 
Dealt to b215699c 
Dealt to 64933f7d 
Dealt to Hero [7c 5h]
Dealt to 604f36f0 
Dealt to 8b5f3466 
Hero: folds
604f36f0: folds
8b5f3466: folds
5b5fe518: folds
b215699c: folds
Uncalled bet ($0.15) returned to 64933f7d
*** SHOWDOWN ***
64933f7d collected $0.2 from pot
*** SUMMARY ***
Total pot $0.2
Seat 1: 5b5fe518 (button) folded before Flop (didn't bet)
Seat 2: b215699c (small blind) folded before Flop
Seat 3: 64933f7d (big blind) collected ($0.2)
Seat 4: Hero folded before Flop (didn't bet)
Seat 5: 604f36f0 folded before Flop (didn't bet)
Seat 6: 8b5f3466 folded before Flop (didn't bet)


Poker Hand #RC94799607: Hold'em No Limit ($0.1/$0.25) - 2020/04/06 23:49:48
Table 'RushAndCash320131' 6-max Seat #1 is the button
Seat 1: Hero ($25.42 in chips)
Seat 2: 9afeb2a7 ($32.9 in chips)
Seat 3: 604f36f0 ($13.06 in chips)
Seat 4: e767af3b ($36.53 in chips)
Seat 5: ce4e1e37 ($30.88 in chips)
Seat 6: d5960dd1 ($23.41 in chips)
9afeb2a7: posts small blind $0.1
604f36f0: posts big blind $0.25
*** HOLE CARDS ***
Dealt to Hero [Js Jd]
Dealt to 9afeb2a7 
Dealt to 604f36f0 
Dealt to e767af3b 
Dealt to ce4e1e37 
Dealt to d5960dd1 
e767af3b: folds
ce4e1e37: folds
d5960dd1: folds
Hero: raises $0.38 to $0.63
9afeb2a7: folds
604f36f0: folds
Uncalled bet ($0.38) returned to Hero
*** SHOWDOWN ***
Hero collected $0.6 from pot
*** SUMMARY ***
Total pot $0.6
Seat 1: Hero (button) collected ($0.6)
Seat 2: 9afeb2a7 (small blind) folded before Flop
Seat 3: 604f36f0 (big blind) folded before Flop
Seat 4: e767af3b folded before Flop (didn't bet)
Seat 5: ce4e1e37 folded before Flop (didn't bet)
Seat 6: d5960dd1 folded before Flop (didn't bet)


Poker Hand #RC94799697: Hold'em No Limit ($0.1/$0.25) - 2020/04/06 23:50:06
Table 'RushAndCash320152' 6-max Seat #1 is the button
Seat 1: db4d85e3 ($13.92 in chips)
Seat 2: dfcfe0b3 ($29.61 in chips)
Seat 3: 9e9b6fda ($41.22 in chips)
Seat 4: 17480666 ($111.63 in chips)
Seat 5: Hero ($25.77 in chips)
Seat 6: b9492ea1 ($22.8 in chips)
dfcfe0b3: posts small blind $0.1
9e9b6fda: posts big blind $0.25
*** HOLE CARDS ***
Dealt to db4d85e3 
Dealt to dfcfe0b3 
Dealt to 9e9b6fda 
Dealt to 17480666 
Dealt to Hero [Ad Jd]
Dealt to b9492ea1 
17480666: folds
Hero: raises $0.38 to $0.63
b9492ea1: folds
db4d85e3: raises $0.88 to $1.51
dfcfe0b3: folds
9e9b6fda: folds
Hero: calls $0.88
*** FLOP *** [As Th 5d]
Hero: checks
db4d85e3: checks
*** TURN *** [As Th 5d] [5c]
Hero: bets $2.6
db4d85e3: folds
Uncalled bet ($2.6) returned to Hero
*** SHOWDOWN ***
Hero collected $3.37 from pot
*** SUMMARY ***
Total pot $3.37
Board [As Th 5d 5c]
Seat 1: db4d85e3 (button) folded on the Turn
Seat 2: dfcfe0b3 (small blind) folded before Flop
Seat 3: 9e9b6fda (big blind) folded before Flop
Seat 4: 17480666 folded before Flop (didn't bet)
Seat 5: Hero won ($3.37)
Seat 6: b9492ea1 folded before Flop (didn't bet)


Poker Hand #RC94799921: Hold'em No Limit ($0.1/$0.25) - 2020/04/06 23:50:57
Table 'RushAndCash320192' 6-max Seat #1 is the button
Seat 1: 41ab7510 ($25.66 in chips)
Seat 2: Hero ($27.47 in chips)
Seat 3: 41459cc9 ($29.4 in chips)
Seat 4: 1826a10f ($12 in chips)
Seat 5: 8a31aea7 ($72.98 in chips)
Seat 6: b9bbf733 ($26.73 in chips)
Hero: posts small blind $0.1
41459cc9: posts big blind $0.25
*** HOLE CARDS ***
Dealt to 41ab7510 
Dealt to Hero [7s 5h]
Dealt to 41459cc9 
Dealt to 1826a10f 
Dealt to 8a31aea7 
Dealt to b9bbf733 
1826a10f: folds
8a31aea7: raises $0.38 to $0.63
b9bbf733: folds
41ab7510: folds
Hero: folds
41459cc9: folds
Uncalled bet ($0.38) returned to 8a31aea7
*** SHOWDOWN ***
8a31aea7 collected $0.6 from pot
*** SUMMARY ***
Total pot $0.6
Seat 1: 41ab7510 (button) folded before Flop (didn't bet)
Seat 2: Hero (small blind) folded before Flop
Seat 3: 41459cc9 (big blind) folded before Flop
Seat 4: 1826a10f folded before Flop (didn't bet)
Seat 5: 8a31aea7 collected ($0.6)
Seat 6: b9bbf733 folded before Flop (didn't bet)


Poker Hand #RC94799939: Hold'em No Limit ($0.1/$0.25) - 2020/04/06 23:51:00
Table 'RushAndCash320195' 6-max Seat #1 is the button
Seat 1: 792342dd ($15.34 in chips)
Seat 2: e0680a48 ($72.73 in chips)
Seat 3: 64933f7d ($16.02 in chips)
Seat 4: 35a45ce2 ($45.69 in chips)
Seat 5: 8e166af5 ($53.7 in chips)
Seat 6: Hero ($27.37 in chips)
e0680a48: posts small blind $0.1
64933f7d: posts big blind $0.25
*** HOLE CARDS ***
Dealt to 792342dd 
Dealt to e0680a48 
Dealt to 64933f7d 
Dealt to 35a45ce2 
Dealt to 8e166af5 
Dealt to Hero [As 5c]
35a45ce2: folds
8e166af5: folds
Hero: folds
792342dd: folds
e0680a48: raises $0.5 to $0.75
64933f7d: calls $0.5
*** FLOP *** [Kh 3s 8d]
e0680a48: bets $1.2
64933f7d: folds
Uncalled bet ($1.2) returned to e0680a48
*** SHOWDOWN ***
e0680a48 collected $1.5 from pot
*** SUMMARY ***
Total pot $1.5
Board [Kh 3s 8d]
Seat 1: 792342dd (button) folded before Flop (didn't bet)
Seat 2: e0680a48 (small blind) won ($1.5)
Seat 3: 64933f7d (big blind) folded on the Flop
Seat 4: 35a45ce2 folded before Flop (didn't bet)
Seat 5: 8e166af5 folded before Flop (didn't bet)
Seat 6: Hero folded before Flop (didn't bet)


Poker Hand #RC94799956: Hold'em No Limit ($0.1/$0.25) - 2020/04/06 23:51:04
Table 'RushAndCash320199' 6-max Seat #1 is the button
Seat 1: 36ac4586 ($48.72 in chips)
Seat 2: 8f2f88a4 ($51.63 in chips)
Seat 3: a82639fc ($59.54 in chips)
Seat 4: 90609fad ($53.09 in chips)
Seat 5: 5b5fe518 ($26.88 in chips)
Seat 6: Hero ($27.37 in chips)
8f2f88a4: posts small blind $0.1
a82639fc: posts big blind $0.25
*** HOLE CARDS ***
Dealt to 36ac4586 
Dealt to 8f2f88a4 
Dealt to a82639fc 
Dealt to 90609fad 
Dealt to 5b5fe518 
Dealt to Hero [6c 5s]
90609fad: folds
5b5fe518: folds
Hero: folds
36ac4586: folds
8f2f88a4: folds
Uncalled bet ($0.15) returned to a82639fc
*** SHOWDOWN ***
a82639fc collected $0.2 from pot
*** SUMMARY ***
Total pot $0.2
Seat 1: 36ac4586 (button) folded before Flop (didn't bet)
Seat 2: 8f2f88a4 (small blind) folded before Flop
Seat 3: a82639fc (big blind) collected ($0.2)
Seat 4: 90609fad folded before Flop (didn't bet)
Seat 5: 5b5fe518 folded before Flop (didn't bet)
Seat 6: Hero folded before Flop (didn't bet)


Poker Hand #RC94799969: Hold'em No Limit ($0.1/$0.25) - 2020/04/06 23:51:07
Table 'RushAndCash320202' 6-max Seat #1 is the button
Seat 1: b5518434 ($24.04 in chips)
Seat 2: ea5eba95 ($74.73 in chips)
Seat 3: Hero ($27.37 in chips)
Seat 4: cce649b7 ($63.63 in chips)
Seat 5: dfcfe0b3 ($27.91 in chips)
Seat 6: bc200877 ($9.15 in chips)
ea5eba95: posts small blind $0.1
Hero: posts big blind $0.25
*** HOLE CARDS ***
Dealt to b5518434 
Dealt to ea5eba95 
Dealt to Hero [8c 7s]
Dealt to cce649b7 
Dealt to dfcfe0b3 
Dealt to bc200877 
cce649b7: folds
dfcfe0b3: raises $0.38 to $0.63
bc200877: calls $0.63
b5518434: calls $0.63
ea5eba95: folds
Hero: folds
*** FLOP *** [Qs 5d 6d]
dfcfe0b3: checks
bc200877: bets $1.7
b5518434: raises $3.8 to $5.5
dfcfe0b3: raises $21.78 to $27.28 and is all-in
bc200877: folds
b5518434: calls $17.91 and is all-in
Uncalled bet ($3.87) returned to dfcfe0b3
dfcfe0b3: shows [Ad 9d] (Ace-High)
b5518434: shows [7d 4d] (Queen-High)
*** TURN *** [Qs 5d 6d] [Ac]
*** RIVER *** [Qs 5d 6d Ac] [Qd]
*** SHOWDOWN ***
dfcfe0b3 collected $50.76 from pot
*** SUMMARY ***
Total pot $50.76
Board [Qs 5d 6d Ac Qd]
Seat 1: b5518434 (button) showed [7d 4d] and lost with Queen High Flush
Seat 2: ea5eba95 (small blind) folded before Flop
Seat 3: Hero (big blind) folded before Flop
Seat 4: cce649b7 folded before Flop (didn't bet)
Seat 5: dfcfe0b3 showed [Ad 9d] and won ($50.76) with Ace High Flush
Seat 6: bc200877 folded on the Flop


Poker Hand #RC94799985: Hold'em No Limit ($0.1/$0.25) - 2020/04/06 23:51:10
Table 'RushAndCash320205' 6-max Seat #1 is the button
Seat 1: b00dbb18 ($40.17 in chips)
Seat 2: Hero ($27.12 in chips)
Seat 3: 6ee3fbae ($7.65 in chips)
Seat 4: 1d6fff9c ($25 in chips)
Seat 5: 41ab7510 ($25.56 in chips)
Seat 6: d5960dd1 ($26.24 in chips)
Hero: posts small blind $0.1
6ee3fbae: posts big blind $0.25
*** HOLE CARDS ***
Dealt to b00dbb18 
Dealt to Hero [Kh 3s]
Dealt to 6ee3fbae 
Dealt to 1d6fff9c 
Dealt to 41ab7510 
Dealt to d5960dd1 
1d6fff9c: folds
41ab7510: folds
d5960dd1: folds
b00dbb18: raises $0.25 to $0.5
Hero: folds
6ee3fbae: folds
Uncalled bet ($0.25) returned to b00dbb18
*** SHOWDOWN ***
b00dbb18 collected $0.6 from pot
*** SUMMARY ***
Total pot $0.6
Seat 1: b00dbb18 (button) collected ($0.6)
Seat 2: Hero (small blind) folded before Flop
Seat 3: 6ee3fbae (big blind) folded before Flop
Seat 4: 1d6fff9c folded before Flop (didn't bet)
Seat 5: 41ab7510 folded before Flop (didn't bet)
Seat 6: d5960dd1 folded before Flop (didn't bet)


Poker Hand #RC94800008: Hold'em No Limit ($0.1/$0.25) - 2020/04/06 23:51:14
Table 'RushAndCash320211' 6-max Seat #1 is the button
Seat 1: Hero ($27.02 in chips)
Seat 2: 5b5fe518 ($26.88 in chips)
Seat 3: 9d598a03 ($56.96 in chips)
Seat 4: cc4afcf8 ($13.09 in chips)
Seat 5: 8a31aea7 ($73.33 in chips)
Seat 6: 312f6846 ($25 in chips)
5b5fe518: posts small blind $0.1
9d598a03: posts big blind $0.25
*** HOLE CARDS ***
Dealt to Hero [9h 7h]
Dealt to 5b5fe518 
Dealt to 9d598a03 
Dealt to cc4afcf8 
Dealt to 8a31aea7 
Dealt to 312f6846 
cc4afcf8: folds
8a31aea7: folds
312f6846: folds
Hero: raises $0.38 to $0.63
5b5fe518: folds
9d598a03: folds
Uncalled bet ($0.38) returned to Hero
*** SHOWDOWN ***
Hero collected $0.6 from pot
*** SUMMARY ***
Total pot $0.6
Seat 1: Hero (button) collected ($0.6)
Seat 2: 5b5fe518 (small blind) folded before Flop
Seat 3: 9d598a03 (big blind) folded before Flop
Seat 4: cc4afcf8 folded before Flop (didn't bet)
Seat 5: 8a31aea7 folded before Flop (didn't bet)
Seat 6: 312f6846 folded before Flop (didn't bet)


Poker Hand #RC94800177: Hold'em No Limit ($0.1/$0.25) - 2020/04/06 23:51:54
Table 'RushAndCash320242' 6-max Seat #1 is the button
Seat 1: b96956e4 ($25 in chips)
Seat 2: dcc7f9d7 ($7.77 in chips)
Seat 3: fd369e31 ($74.14 in chips)
Seat 4: 4244d459 ($24.38 in chips)
Seat 5: Hero ($27.37 in chips)
Seat 6: a2913d47 ($20.39 in chips)
dcc7f9d7: posts small blind $0.1
fd369e31: posts big blind $0.25
*** HOLE CARDS ***
Dealt to b96956e4 
Dealt to dcc7f9d7 
Dealt to fd369e31 
Dealt to 4244d459 
Dealt to Hero [Ac 4h]
Dealt to a2913d47 
4244d459: raises $0.45 to $0.7
Hero: folds
a2913d47: folds
b96956e4: folds
dcc7f9d7: folds
fd369e31: calls $0.45
*** FLOP *** [Kc 3s 3h]
fd369e31: checks
4244d459: bets $0.45
fd369e31: folds
Uncalled bet ($0.45) returned to 4244d459
*** SHOWDOWN ***
4244d459 collected $1.5 from pot
*** SUMMARY ***
Total pot $1.5
Board [Kc 3s 3h]
Seat 1: b96956e4 (button) folded before Flop (didn't bet)
Seat 2: dcc7f9d7 (small blind) folded before Flop
Seat 3: fd369e31 (big blind) folded on the Flop
Seat 4: 4244d459 won ($1.5)
Seat 5: Hero folded before Flop (didn't bet)
Seat 6: a2913d47 folded before Flop (didn't bet)


Poker Hand #RC94800205: Hold'em No Limit ($0.1/$0.25) - 2020/04/06 23:51:59
Table 'RushAndCash320247' 6-max Seat #1 is the button
Seat 1: 17480666 ($111.63 in chips)
Seat 2: 8b5f3466 ($32.18 in chips)
Seat 3: Hero ($27.37 in chips)
Seat 4: afa5143c ($33.83 in chips)
Seat 5: 64933f7d ($15.52 in chips)
Seat 6: 520e111e ($28.41 in chips)
8b5f3466: posts small blind $0.1
Hero: posts big blind $0.25
*** HOLE CARDS ***
Dealt to 17480666 
Dealt to 8b5f3466 
Dealt to Hero [6c 2d]
Dealt to afa5143c 
Dealt to 64933f7d 
Dealt to 520e111e 
afa5143c: folds
64933f7d: folds
520e111e: raises $0.5 to $0.75
17480666: folds
8b5f3466: raises $1.35 to $2.1
Hero: folds
520e111e: calls $1.35
*** FLOP *** [Th 3c 6s]
8b5f3466: checks
520e111e: bets $2.05
8b5f3466: raises $4.35 to $6.4
520e111e: folds
Uncalled bet ($4.35) returned to 8b5f3466
*** SHOWDOWN ***
8b5f3466 collected $8.55 from pot
*** SUMMARY ***
Total pot $8.55
Board [Th 3c 6s]
Seat 1: 17480666 (button) folded before Flop (didn't bet)
Seat 2: 8b5f3466 (small blind) won ($8.55)
Seat 3: Hero (big blind) folded before Flop
Seat 4: afa5143c folded before Flop (didn't bet)
Seat 5: 64933f7d folded before Flop (didn't bet)
Seat 6: 520e111e folded on the Flop


Poker Hand #RC94800226: Hold'em No Limit ($0.1/$0.25) - 2020/04/06 23:52:03
Table 'RushAndCash320252' 6-max Seat #1 is the button
Seat 1: Hero ($27.12 in chips)
Seat 2: dfcfe0b3 ($53.63 in chips)
Seat 3: db4d85e3 ($13.11 in chips)
Seat 4: cce649b7 ($62.93 in chips)
Seat 5: 64933f7d ($15.52 in chips)
Seat 6: 1d6fff9c ($28.19 in chips)
dfcfe0b3: posts small blind $0.1
db4d85e3: posts big blind $0.25
*** HOLE CARDS ***
Dealt to Hero [Qs 5h]
Dealt to dfcfe0b3 
Dealt to db4d85e3 
Dealt to cce649b7 
Dealt to 64933f7d 
Dealt to 1d6fff9c 
cce649b7: raises $0.38 to $0.63
64933f7d: folds
1d6fff9c: folds
Hero: folds
dfcfe0b3: folds
db4d85e3: calls $0.38
*** FLOP *** [2d 4s 7s]
db4d85e3: checks
cce649b7: bets $0.75
db4d85e3: raises $1.45 to $2.2
cce649b7: folds
Uncalled bet ($1.45) returned to db4d85e3
*** SHOWDOWN ***
db4d85e3 collected $2.86 from pot
*** SUMMARY ***
Total pot $2.86
Board [2d 4s 7s]
Seat 1: Hero (button) folded before Flop (didn't bet)
Seat 2: dfcfe0b3 (small blind) folded before Flop
Seat 3: db4d85e3 (big blind) won ($2.86)
Seat 4: cce649b7 folded on the Flop
Seat 5: 64933f7d folded before Flop (didn't bet)
Seat 6: 1d6fff9c folded before Flop (didn't bet)


Poker Hand #RC94800240: Hold'em No Limit ($0.1/$0.25) - 2020/04/06 23:52:07
Table 'RushAndCash320255' 6-max Seat #1 is the button
Seat 1: 90609fad ($53.44 in chips)
Seat 2: b96956e4 ($25 in chips)
Seat 3: 8466ae26 ($64.15 in chips)
Seat 4: 9e9b6fda ($39.72 in chips)
Seat 5: ea5eba95 ($74.18 in chips)
Seat 6: Hero ($27.12 in chips)
b96956e4: posts small blind $0.1
8466ae26: posts big blind $0.25
*** HOLE CARDS ***
Dealt to 90609fad 
Dealt to b96956e4 
Dealt to 8466ae26 
Dealt to 9e9b6fda 
Dealt to ea5eba95 
Dealt to Hero [Ac 2s]
9e9b6fda: raises $0.5 to $0.75
ea5eba95: folds
Hero: folds
90609fad: folds
b96956e4: folds
8466ae26: folds
Uncalled bet ($0.5) returned to 9e9b6fda
*** SHOWDOWN ***
9e9b6fda collected $0.6 from pot
*** SUMMARY ***
Total pot $0.6
Seat 1: 90609fad (button) folded before Flop (didn't bet)
Seat 2: b96956e4 (small blind) folded before Flop
Seat 3: 8466ae26 (big blind) folded before Flop
Seat 4: 9e9b6fda collected ($0.6)
Seat 5: ea5eba95 folded before Flop (didn't bet)
Seat 6: Hero folded before Flop (didn't bet)


Poker Hand #RC94800263: Hold'em No Limit ($0.1/$0.25) - 2020/04/06 23:52:13
Table 'RushAndCash320260' 6-max Seat #1 is the button
Seat 1: 17480666 ($111.63 in chips)
Seat 2: bd6eeaf3 ($56.99 in chips)
Seat 3: dfcfe0b3 ($53.53 in chips)
Seat 4: 94efc628 ($25 in chips)
Seat 5: Hero ($27.12 in chips)
Seat 6: 19e4cb38 ($49.93 in chips)
bd6eeaf3: posts small blind $0.1
dfcfe0b3: posts big blind $0.25
*** HOLE CARDS ***
Dealt to 17480666 
Dealt to bd6eeaf3 
Dealt to dfcfe0b3 
Dealt to 94efc628 
Dealt to Hero [Qh 7h]
Dealt to 19e4cb38 
94efc628: folds
Hero: folds
19e4cb38: folds
17480666: folds
bd6eeaf3: raises $0.38 to $0.63
dfcfe0b3: folds
Uncalled bet ($0.38) returned to bd6eeaf3
*** SHOWDOWN ***
bd6eeaf3 collected $0.5 from pot
*** SUMMARY ***
Total pot $0.5
Seat 1: 17480666 (button) folded before Flop (didn't bet)
Seat 2: bd6eeaf3 (small blind) collected ($0.5)
Seat 3: dfcfe0b3 (big blind) folded before Flop
Seat 4: 94efc628 folded before Flop (didn't bet)
Seat 5: Hero folded before Flop (didn't bet)
Seat 6: 19e4cb38 folded before Flop (didn't bet)


Poker Hand #RC94800280: Hold'em No Limit ($0.1/$0.25) - 2020/04/06 23:52:16
Table 'RushAndCash320263' 6-max Seat #1 is the button
Seat 1: 19e4cb38 ($49.93 in chips)
Seat 2: Hero ($27.12 in chips)
Seat 3: c37366b8 ($13.12 in chips)
Seat 4: 969ce17 ($37.62 in chips)
Seat 5: e58da42d ($31.01 in chips)
Seat 6: 41459cc9 ($29.15 in chips)
Hero: posts small blind $0.1
c37366b8: posts big blind $0.25
*** HOLE CARDS ***
Dealt to 19e4cb38 
Dealt to Hero [9d 6c]
Dealt to c37366b8 
Dealt to 969ce17 
Dealt to e58da42d 
Dealt to 41459cc9 
969ce17: folds
e58da42d: folds
41459cc9: folds
19e4cb38: folds
Hero: folds
Uncalled bet ($0.15) returned to c37366b8
*** SHOWDOWN ***
c37366b8 collected $0.2 from pot
*** SUMMARY ***
Total pot $0.2
Seat 1: 19e4cb38 (button) folded before Flop (didn't bet)
Seat 2: Hero (small blind) folded before Flop
Seat 3: c37366b8 (big blind) collected ($0.2)
Seat 4: 969ce17 folded before Flop (didn't bet)
Seat 5: e58da42d folded before Flop (didn't bet)
Seat 6: 41459cc9 folded before Flop (didn't bet)


Poker Hand #RC94800295: Hold'em No Limit ($0.1/$0.25) - 2020/04/06 23:52:20
Table 'RushAndCash320266' 6-max Seat #1 is the button
Seat 1: c4f91a8c ($16.65 in chips)
Seat 2: afa5143c ($33.83 in chips)
Seat 3: Hero ($27.02 in chips)
Seat 4: b5518434 ($25 in chips)
Seat 5: b00dbb18 ($39.27 in chips)
Seat 6: ea5eba95 ($74.18 in chips)
afa5143c: posts small blind $0.1
Hero: posts big blind $0.25
*** HOLE CARDS ***
Dealt to c4f91a8c 
Dealt to afa5143c 
Dealt to Hero [Qs Qh]
Dealt to b5518434 
Dealt to b00dbb18 
Dealt to ea5eba95 
b5518434: raises $0.5 to $0.75
b00dbb18: folds
ea5eba95: folds
c4f91a8c: folds
afa5143c: folds
Hero: calls $0.5
*** FLOP *** [5s 4c As]
Hero: checks
b5518434: bets $0.6
Hero: calls $0.6
*** TURN *** [5s 4c As] [7c]
Hero: checks
b5518434: bets $1.4
Hero: folds
Uncalled bet ($1.4) returned to b5518434
*** SHOWDOWN ***
b5518434 collected $2.8 from pot
*** SUMMARY ***
Total pot $2.8
Board [5s 4c As 7c]
Seat 1: c4f91a8c (button) folded before Flop (didn't bet)
Seat 2: afa5143c (small blind) folded before Flop
Seat 3: Hero (big blind) folded on the Turn
Seat 4: b5518434 won ($2.8)
Seat 5: b00dbb18 folded before Flop (didn't bet)
Seat 6: ea5eba95 folded before Flop (didn't bet)


Poker Hand #RC94800497: Hold'em No Limit ($0.1/$0.25) - 2020/04/06 23:53:04
Table 'RushAndCash320307' 6-max Seat #1 is the button
Seat 1: 9e9b6fda ($40.42 in chips)
Seat 2: cc4afcf8 ($12.74 in chips)
Seat 3: e58da42d ($29 in chips)
Seat 4: fe7c9e7a ($26.37 in chips)
Seat 5: b96956e4 ($27.05 in chips)
Seat 6: Hero ($25.67 in chips)
cc4afcf8: posts small blind $0.1
e58da42d: posts big blind $0.25
*** HOLE CARDS ***
Dealt to 9e9b6fda 
Dealt to cc4afcf8 
Dealt to e58da42d 
Dealt to fe7c9e7a 
Dealt to b96956e4 
Dealt to Hero [Qc 9h]
fe7c9e7a: folds
b96956e4: folds
Hero: folds
9e9b6fda: folds
cc4afcf8: folds
Uncalled bet ($0.15) returned to e58da42d
*** SHOWDOWN ***
e58da42d collected $0.2 from pot
*** SUMMARY ***
Total pot $0.2
Seat 1: 9e9b6fda (button) folded before Flop (didn't bet)
Seat 2: cc4afcf8 (small blind) folded before Flop
Seat 3: e58da42d (big blind) collected ($0.2)
Seat 4: fe7c9e7a folded before Flop (didn't bet)
Seat 5: b96956e4 folded before Flop (didn't bet)
Seat 6: Hero folded before Flop (didn't bet)


Poker Hand #RC94800515: Hold'em No Limit ($0.1/$0.25) - 2020/04/06 23:53:08
Table 'RushAndCash320311' 6-max Seat #1 is the button
Seat 1: e0680a48 ($71.36 in chips)
Seat 2: 2ebb8f6c ($27.39 in chips)
Seat 3: c4f91a8c ($17 in chips)
Seat 4: 99d6d386 ($25 in chips)
Seat 5: 1826a10f ($11.3 in chips)
Seat 6: Hero ($25.67 in chips)
2ebb8f6c: posts small blind $0.1
c4f91a8c: posts big blind $0.25
*** HOLE CARDS ***
Dealt to e0680a48 
Dealt to 2ebb8f6c 
Dealt to c4f91a8c 
Dealt to 99d6d386 
Dealt to 1826a10f 
Dealt to Hero [Ah Qc]
99d6d386: folds
1826a10f: folds
Hero: raises $0.38 to $0.63
e0680a48: calls $0.63
2ebb8f6c: folds
c4f91a8c: folds
*** FLOP *** [Kh 4h Jc]
Hero: bets $0.6
e0680a48: calls $0.6
*** TURN *** [Kh 4h Jc] [Ac]
Hero: bets $2.2
e0680a48: folds
Uncalled bet ($2.2) returned to Hero
*** SHOWDOWN ***
Hero collected $2.81 from pot
*** SUMMARY ***
Total pot $2.81
Board [Kh 4h Jc Ac]
Seat 1: e0680a48 (button) folded on the Turn
Seat 2: 2ebb8f6c (small blind) folded before Flop
Seat 3: c4f91a8c (big blind) folded before Flop
Seat 4: 99d6d386 folded before Flop (didn't bet)
Seat 5: 1826a10f folded before Flop (didn't bet)
Seat 6: Hero won ($2.81)


Poker Hand #RC94800641: Hold'em No Limit ($0.1/$0.25) - 2020/04/06 23:53:36
Table 'RushAndCash320341' 6-max Seat #1 is the button
Seat 1: 19e4cb38 ($49.93 in chips)
Seat 2: ca69da65 ($36.78 in chips)
Seat 3: 64933f7d ($21.1 in chips)
Seat 4: dfcfe0b3 ($52.43 in chips)
Seat 5: Hero ($27.11 in chips)
Seat 6: 8e166af5 ($51.57 in chips)
ca69da65: posts small blind $0.1
64933f7d: posts big blind $0.25
*** HOLE CARDS ***
Dealt to 19e4cb38 
Dealt to ca69da65 
Dealt to 64933f7d 
Dealt to dfcfe0b3 
Dealt to Hero [Js 9s]
Dealt to 8e166af5 
dfcfe0b3: folds
Hero: folds
8e166af5: folds
19e4cb38: folds
ca69da65: folds
Uncalled bet ($0.15) returned to 64933f7d
*** SHOWDOWN ***
64933f7d collected $0.2 from pot
*** SUMMARY ***
Total pot $0.2
Seat 1: 19e4cb38 (button) folded before Flop (didn't bet)
Seat 2: ca69da65 (small blind) folded before Flop
Seat 3: 64933f7d (big blind) collected ($0.2)
Seat 4: dfcfe0b3 folded before Flop (didn't bet)
Seat 5: Hero folded before Flop (didn't bet)
Seat 6: 8e166af5 folded before Flop (didn't bet)


Poker Hand #RC94800663: Hold'em No Limit ($0.1/$0.25) - 2020/04/06 23:53:41
Table 'RushAndCash320345' 6-max Seat #1 is the button
Seat 1: dfcfe0b3 ($52.43 in chips)
Seat 2: Hero ($27.11 in chips)
Seat 3: 576737c8 ($14.46 in chips)
Seat 4: 8a31aea7 ($73.58 in chips)
Seat 5: a82639fc ($61.88 in chips)
Seat 6: 604f36f0 ($7.68 in chips)
Hero: posts small blind $0.1
576737c8: posts big blind $0.25
*** HOLE CARDS ***
Dealt to dfcfe0b3 
Dealt to Hero [6s 2h]
Dealt to 576737c8 
Dealt to 8a31aea7 
Dealt to a82639fc 
Dealt to 604f36f0 
8a31aea7: folds
a82639fc: folds
604f36f0: raises $0.38 to $0.63
dfcfe0b3: folds
Hero: folds
576737c8: folds
Uncalled bet ($0.38) returned to 604f36f0
*** SHOWDOWN ***
604f36f0 collected $0.6 from pot
*** SUMMARY ***
Total pot $0.6
Seat 1: dfcfe0b3 (button) folded before Flop (didn't bet)
Seat 2: Hero (small blind) folded before Flop
Seat 3: 576737c8 (big blind) folded before Flop
Seat 4: 8a31aea7 folded before Flop (didn't bet)
Seat 5: a82639fc folded before Flop (didn't bet)
Seat 6: 604f36f0 collected ($0.6)


Poker Hand #RC94800677: Hold'em No Limit ($0.1/$0.25) - 2020/04/06 23:53:44
Table 'RushAndCash320348' 6-max Seat #1 is the button
Seat 1: 58b04451 ($7.48 in chips)
Seat 2: b9bbf733 ($25 in chips)
Seat 3: 312f6846 ($27.5 in chips)
Seat 4: b96956e4 ($26.7 in chips)
Seat 5: Hero ($27.01 in chips)
Seat 6: 4244d459 ($25.11 in chips)
b9bbf733: posts small blind $0.1
312f6846: posts big blind $0.25
*** HOLE CARDS ***
Dealt to 58b04451 
Dealt to b9bbf733 
Dealt to 312f6846 
Dealt to b96956e4 
Dealt to Hero [Js 7c]
Dealt to 4244d459 
b96956e4: folds
Hero: folds
4244d459: folds
58b04451: folds
b9bbf733: raises $0.5 to $0.75
312f6846: folds
Uncalled bet ($0.5) returned to b9bbf733
*** SHOWDOWN ***
b9bbf733 collected $0.5 from pot
*** SUMMARY ***
Total pot $0.5
Seat 1: 58b04451 (button) folded before Flop (didn't bet)
Seat 2: b9bbf733 (small blind) collected ($0.5)
Seat 3: 312f6846 (big blind) folded before Flop
Seat 4: b96956e4 folded before Flop (didn't bet)
Seat 5: Hero folded before Flop (didn't bet)
Seat 6: 4244d459 folded before Flop (didn't bet)


Poker Hand #RC94800694: Hold'em No Limit ($0.1/$0.25) - 2020/04/06 23:53:48
Table 'RushAndCash320352' 6-max Seat #1 is the button
Seat 1: Hero ($27.01 in chips)
Seat 2: afa5143c ($32.98 in chips)
Seat 3: 55218991 ($12.5 in chips)
Seat 4: cc4afcf8 ($12.39 in chips)
Seat 5: b96956e4 ($26.7 in chips)
Seat 6: ca69da65 ($36.68 in chips)
afa5143c: posts small blind $0.1
55218991: posts big blind $0.25
*** HOLE CARDS ***
Dealt to Hero [As 3h]
Dealt to afa5143c 
Dealt to 55218991 
Dealt to cc4afcf8 
Dealt to b96956e4 
Dealt to ca69da65 
cc4afcf8: folds
b96956e4: raises $0.38 to $0.63
ca69da65: folds
Hero: folds
afa5143c: folds
55218991: folds
Uncalled bet ($0.38) returned to b96956e4
*** SHOWDOWN ***
b96956e4 collected $0.6 from pot
*** SUMMARY ***
Total pot $0.6
Seat 1: Hero (button) folded before Flop (didn't bet)
Seat 2: afa5143c (small blind) folded before Flop
Seat 3: 55218991 (big blind) folded before Flop
Seat 4: cc4afcf8 folded before Flop (didn't bet)
Seat 5: b96956e4 collected ($0.6)
Seat 6: ca69da65 folded before Flop (didn't bet)


Poker Hand #RC94800711: Hold'em No Limit ($0.1/$0.25) - 2020/04/06 23:53:52
Table 'RushAndCash320356' 6-max Seat #1 is the button
Seat 1: 17480666 ($110.93 in chips)
Seat 2: 9e9b6fda ($40.17 in chips)
Seat 3: 41ab7510 ($26.11 in chips)
Seat 4: c37366b8 ($13.47 in chips)
Seat 5: Hero ($27.01 in chips)
Seat 6: 9b358964 ($26.91 in chips)
9e9b6fda: posts small blind $0.1
41ab7510: posts big blind $0.25
*** HOLE CARDS ***
Dealt to 17480666 
Dealt to 9e9b6fda 
Dealt to 41ab7510 
Dealt to c37366b8 
Dealt to Hero [9h 3s]
Dealt to 9b358964 
c37366b8: folds
Hero: folds
9b358964: folds
17480666: raises $0.5 to $0.75
9e9b6fda: folds
41ab7510: folds
Uncalled bet ($0.5) returned to 17480666
*** SHOWDOWN ***
17480666 collected $0.6 from pot
*** SUMMARY ***
Total pot $0.6
Seat 1: 17480666 (button) collected ($0.6)
Seat 2: 9e9b6fda (small blind) folded before Flop
Seat 3: 41ab7510 (big blind) folded before Flop
Seat 4: c37366b8 folded before Flop (didn't bet)
Seat 5: Hero folded before Flop (didn't bet)
Seat 6: 9b358964 folded before Flop (didn't bet)


Poker Hand #RC94800725: Hold'em No Limit ($0.1/$0.25) - 2020/04/06 23:53:55
Table 'RushAndCash320359' 6-max Seat #1 is the button
Seat 1: 1d6fff9c ($27.84 in chips)
Seat 2: 8b5f3466 ($36.71 in chips)
Seat 3: 2c58d58e ($24.97 in chips)
Seat 4: 8f2f88a4 ($51.63 in chips)
Seat 5: Hero ($27.01 in chips)
Seat 6: fd369e31 ($73.44 in chips)
8b5f3466: posts small blind $0.1
2c58d58e: posts big blind $0.25
*** HOLE CARDS ***
Dealt to 1d6fff9c 
Dealt to 8b5f3466 
Dealt to 2c58d58e 
Dealt to 8f2f88a4 
Dealt to Hero [Ad Kd]
Dealt to fd369e31 
8f2f88a4: folds
Hero: raises $0.38 to $0.63
fd369e31: folds
1d6fff9c: raises $1.37 to $2
8b5f3466: folds
2c58d58e: folds
Hero: raises $3.25 to $5.25
1d6fff9c: folds
Uncalled bet ($3.25) returned to Hero
*** SHOWDOWN ***
Hero collected $4.35 from pot
*** SUMMARY ***
Total pot $4.35
Seat 1: 1d6fff9c (button) folded before Flop
Seat 2: 8b5f3466 (small blind) folded before Flop
Seat 3: 2c58d58e (big blind) folded before Flop
Seat 4: 8f2f88a4 folded before Flop (didn't bet)
Seat 5: Hero collected ($4.35)
Seat 6: fd369e31 folded before Flop (didn't bet)


Poker Hand #RC94800863: Hold'em No Limit ($0.1/$0.25) - 2020/04/06 23:54:27
Table 'RushAndCash320383' 6-max Seat #1 is the button
Seat 1: 312f6846 ($27.15 in chips)
Seat 2: ca69da65 ($37.03 in chips)
Seat 3: Hero ($29.15 in chips)
Seat 4: ce4e1e37 ($28.4 in chips)
Seat 5: 8fb93df3 ($39.39 in chips)
Seat 6: db4d85e3 ($14.7 in chips)
ca69da65: posts small blind $0.1
Hero: posts big blind $0.25
*** HOLE CARDS ***
Dealt to 312f6846 
Dealt to ca69da65 
Dealt to Hero [Th 2d]
Dealt to ce4e1e37 
Dealt to 8fb93df3 
Dealt to db4d85e3 
ce4e1e37: folds
8fb93df3: folds
db4d85e3: raises $0.45 to $0.7
312f6846: raises $2 to $2.7
ca69da65: folds
Hero: folds
db4d85e3: calls $2
*** FLOP *** [3d 3s Td]
db4d85e3: checks
312f6846: bets $2.7
db4d85e3: calls $2.7
*** TURN *** [3d 3s Td] [9d]
db4d85e3: checks
312f6846: checks
*** RIVER *** [3d 3s Td 9d] [6c]
db4d85e3: checks
312f6846: bets $9.6
db4d85e3: calls $9.3 and is all-in
Uncalled bet ($0.3) returned to 312f6846
312f6846: shows [Kh Kd] (Pair of Kings and Pair of Treys)
db4d85e3: shows [As Ad] (Pair of Aces and Pair of Treys)
*** SHOWDOWN ***
db4d85e3 collected $29.75 from pot
*** SUMMARY ***
Total pot $29.75
Board [3d 3s Td 9d 6c]
Seat 1: 312f6846 (button) showed [Kh Kd] and lost with Pair of Kings and Pair of Treys
Seat 2: ca69da65 (small blind) folded before Flop
Seat 3: Hero (big blind) folded before Flop
Seat 4: ce4e1e37 folded before Flop (didn't bet)
Seat 5: 8fb93df3 folded before Flop (didn't bet)
Seat 6: db4d85e3 showed [As Ad] and won ($29.75) with Pair of Aces and Pair of Treys


Poker Hand #RC94800877: Hold'em No Limit ($0.1/$0.25) - 2020/04/06 23:54:30
Table 'RushAndCash320386' 6-max Seat #1 is the button
Seat 1: 90609fad ($57.08 in chips)
Seat 2: Hero ($28.9 in chips)
Seat 3: b215699c ($47.88 in chips)
Seat 4: 976f7f67 ($12.5 in chips)
Seat 5: 576737c8 ($12.5 in chips)
Seat 6: 1826a10f ($10.95 in chips)
Hero: posts small blind $0.1
b215699c: posts big blind $0.25
*** HOLE CARDS ***
Dealt to 90609fad 
Dealt to Hero [Jc 3c]
Dealt to b215699c 
Dealt to 976f7f67 
Dealt to 576737c8 
Dealt to 1826a10f 
976f7f67: raises $0.5 to $0.75
576737c8: folds
1826a10f: folds
90609fad: folds
Hero: folds
b215699c: folds
Uncalled bet ($0.5) returned to 976f7f67
*** SHOWDOWN ***
976f7f67 collected $0.6 from pot
*** SUMMARY ***
Total pot $0.6
Seat 1: 90609fad (button) folded before Flop (didn't bet)
Seat 2: Hero (small blind) folded before Flop
Seat 3: b215699c (big blind) folded before Flop
Seat 4: 976f7f67 collected ($0.6)
Seat 5: 576737c8 folded before Flop (didn't bet)
Seat 6: 1826a10f folded before Flop (didn't bet)


Poker Hand #RC94800893: Hold'em No Limit ($0.1/$0.25) - 2020/04/06 23:54:34
Table 'RushAndCash320389' 6-max Seat #1 is the button
Seat 1: 2060075e ($25 in chips)
Seat 2: 72fa991e ($33.27 in chips)
Seat 3: cb451c32 ($16 in chips)
Seat 4: Hero ($28.8 in chips)
Seat 5: bc200877 ($2.67 in chips)
Seat 6: fe7c9e7a ($28.02 in chips)
72fa991e: posts small blind $0.1
cb451c32: posts big blind $0.25
*** HOLE CARDS ***
Dealt to 2060075e 
Dealt to 72fa991e 
Dealt to cb451c32 
Dealt to Hero [8c 5s]
Dealt to bc200877 
Dealt to fe7c9e7a 
Hero: folds
bc200877: raises $2.42 to $2.67 and is all-in
fe7c9e7a: folds
2060075e: folds
72fa991e: folds
cb451c32: folds
Uncalled bet ($2.42) returned to bc200877
*** SHOWDOWN ***
bc200877 collected $0.6 from pot
*** SUMMARY ***
Total pot $0.6
Seat 1: 2060075e (button) folded before Flop (didn't bet)
Seat 2: 72fa991e (small blind) folded before Flop
Seat 3: cb451c32 (big blind) folded before Flop
Seat 4: Hero folded before Flop (didn't bet)
Seat 5: bc200877 collected ($0.6)
Seat 6: fe7c9e7a folded before Flop (didn't bet)


Poker Hand #RC94800929: Hold'em No Limit ($0.1/$0.25) - 2020/04/06 23:54:41
Table 'RushAndCash320395' 6-max Seat #1 is the button
Seat 1: Hero ($28.8 in chips)
Seat 2: ac4ab575 ($14.57 in chips)
Seat 3: 2060075e ($25 in chips)
Seat 4: b215699c ($47.63 in chips)
Seat 5: 346636d5 ($18 in chips)
Seat 6: 1826a10f ($10.95 in chips)
ac4ab575: posts small blind $0.1
2060075e: posts big blind $0.25
*** HOLE CARDS ***
Dealt to Hero [Tc 5d]
Dealt to ac4ab575 
Dealt to 2060075e 
Dealt to b215699c 
Dealt to 346636d5 
Dealt to 1826a10f 
b215699c: folds
346636d5: folds
1826a10f: folds
Hero: folds
ac4ab575: raises $0.5 to $0.75
2060075e: raises $1.65 to $2.4
ac4ab575: folds
Uncalled bet ($1.65) returned to 2060075e
*** SHOWDOWN ***
2060075e collected $1.5 from pot
*** SUMMARY ***
Total pot $1.5
Seat 1: Hero (button) folded before Flop (didn't bet)
Seat 2: ac4ab575 (small blind) folded before Flop
Seat 3: 2060075e (big blind) collected ($1.5)
Seat 4: b215699c folded before Flop (didn't bet)
Seat 5: 346636d5 folded before Flop (didn't bet)
Seat 6: 1826a10f folded before Flop (didn't bet)


Poker Hand #RC94800942: Hold'em No Limit ($0.1/$0.25) - 2020/04/06 23:54:44
Table 'RushAndCash320398' 6-max Seat #1 is the button
Seat 1: 17480666 ($111.18 in chips)
Seat 2: 1ecb53b7 ($12.29 in chips)
Seat 3: 9e9b6fda ($40.42 in chips)
Seat 4: Hero ($28.8 in chips)
Seat 5: 36ac4586 ($47.39 in chips)
Seat 6: a82639fc ($61.88 in chips)
1ecb53b7: posts small blind $0.1
9e9b6fda: posts big blind $0.25
*** HOLE CARDS ***
Dealt to 17480666 
Dealt to 1ecb53b7 
Dealt to 9e9b6fda 
Dealt to Hero [Qd Jh]
Dealt to 36ac4586 
Dealt to a82639fc 
Hero: folds
36ac4586: folds
a82639fc: folds
17480666: folds
1ecb53b7: folds
Uncalled bet ($0.15) returned to 9e9b6fda
*** SHOWDOWN ***
9e9b6fda collected $0.2 from pot
*** SUMMARY ***
Total pot $0.2
Seat 1: 17480666 (button) folded before Flop (didn't bet)
Seat 2: 1ecb53b7 (small blind) folded before Flop
Seat 3: 9e9b6fda (big blind) collected ($0.2)
Seat 4: Hero folded before Flop (didn't bet)
Seat 5: 36ac4586 folded before Flop (didn't bet)
Seat 6: a82639fc folded before Flop (didn't bet)


Poker Hand #RC94800959: Hold'em No Limit ($0.1/$0.25) - 2020/04/06 23:54:48
Table 'RushAndCash320402' 6-max Seat #1 is the button
Seat 1: Hero ($28.8 in chips)
Seat 2: cf8c7400 ($25 in chips)
Seat 3: ca69da65 ($36.93 in chips)
Seat 4: 969ce17 ($40.46 in chips)
Seat 5: 55218991 ($12.5 in chips)
Seat 6: dfcfe0b3 ($52.43 in chips)
cf8c7400: posts small blind $0.1
ca69da65: posts big blind $0.25
*** HOLE CARDS ***
Dealt to Hero [4c 3s]
Dealt to cf8c7400 
Dealt to ca69da65 
Dealt to 969ce17 
Dealt to 55218991 
Dealt to dfcfe0b3 
969ce17: folds
55218991: raises $0.5 to $0.75
dfcfe0b3: raises $1.55 to $2.3
Hero: folds
cf8c7400: folds
ca69da65: folds
55218991: folds
Uncalled bet ($1.55) returned to dfcfe0b3
*** SHOWDOWN ***
dfcfe0b3 collected $1.85 from pot
*** SUMMARY ***
Total pot $1.85
Seat 1: Hero (button) folded before Flop (didn't bet)
Seat 2: cf8c7400 (small blind) folded before Flop
Seat 3: ca69da65 (big blind) folded before Flop
Seat 4: 969ce17 folded before Flop (didn't bet)
Seat 5: 55218991 folded before Flop
Seat 6: dfcfe0b3 collected ($1.85)


Poker Hand #RC94800978: Hold'em No Limit ($0.1/$0.25) - 2020/04/06 23:54:51
Table 'RushAndCash320405' 6-max Seat #1 is the button
Seat 1: ba032eea ($61.3 in chips)
Seat 2: a82639fc ($61.88 in chips)
Seat 3: 576737c8 ($12.5 in chips)
Seat 4: 254b7d1e ($13.27 in chips)
Seat 5: b9492ea1 ($27.47 in chips)
Seat 6: Hero ($28.8 in chips)
a82639fc: posts small blind $0.1
576737c8: posts big blind $0.25
*** HOLE CARDS ***
Dealt to ba032eea 
Dealt to a82639fc 
Dealt to 576737c8 
Dealt to 254b7d1e 
Dealt to b9492ea1 
Dealt to Hero [Qs Jd]
254b7d1e: folds
b9492ea1: raises $0.5 to $0.75
Hero: folds
ba032eea: calls $0.75
a82639fc: calls $0.65
576737c8: calls $0.5
*** FLOP *** [As 7h 8c]
a82639fc: bets $1.5
576737c8: calls $1.5
b9492ea1: folds
ba032eea: folds
*** TURN *** [As 7h 8c] [5d]
a82639fc: bets $3
576737c8: folds
Uncalled bet ($3) returned to a82639fc
*** SHOWDOWN ***
a82639fc collected $6 from pot
*** SUMMARY ***
Total pot $6
Board [As 7h 8c 5d]
Seat 1: ba032eea (button) folded on the Flop
Seat 2: a82639fc (small blind) won ($6)
Seat 3: 576737c8 (big blind) folded on the Turn
Seat 4: 254b7d1e folded before Flop (didn't bet)
Seat 5: b9492ea1 folded on the Flop
Seat 6: Hero folded before Flop (didn't bet)


Poker Hand #RC94800995: Hold'em No Limit ($0.1/$0.25) - 2020/04/06 23:54:56
Table 'RushAndCash320409' 6-max Seat #1 is the button
Seat 1: cce649b7 ($61.55 in chips)
Seat 2: Hero ($28.8 in chips)
Seat 3: fe7c9e7a ($27.92 in chips)
Seat 4: 19e4cb38 ($53.05 in chips)
Seat 5: 5e03da34 ($84.11 in chips)
Seat 6: 254b7d1e ($13.27 in chips)
Hero: posts small blind $0.1
fe7c9e7a: posts big blind $0.25
*** HOLE CARDS ***
Dealt to cce649b7 
Dealt to Hero [9c 5c]
Dealt to fe7c9e7a 
Dealt to 19e4cb38 
Dealt to 5e03da34 
Dealt to 254b7d1e 
19e4cb38: folds
5e03da34: folds
254b7d1e: folds
cce649b7: folds
Hero: folds
Uncalled bet ($0.15) returned to fe7c9e7a
*** SHOWDOWN ***
fe7c9e7a collected $0.2 from pot
*** SUMMARY ***
Total pot $0.2
Seat 1: cce649b7 (button) folded before Flop (didn't bet)
Seat 2: Hero (small blind) folded before Flop
Seat 3: fe7c9e7a (big blind) collected ($0.2)
Seat 4: 19e4cb38 folded before Flop (didn't bet)
Seat 5: 5e03da34 folded before Flop (didn't bet)
Seat 6: 254b7d1e folded before Flop (didn't bet)


Poker Hand #RC94801007: Hold'em No Limit ($0.1/$0.25) - 2020/04/06 23:54:59
Table 'RushAndCash320411' 6-max Seat #1 is the button
Seat 1: bd6eeaf3 ($56.44 in chips)
Seat 2: 604f36f0 ($7.18 in chips)
Seat 3: Hero ($28.7 in chips)
Seat 4: c256b4a2 ($43.98 in chips)
Seat 5: 2060075e ($25.68 in chips)
Seat 6: e7058be8 ($11.64 in chips)
604f36f0: posts small blind $0.1
Hero: posts big blind $0.25
*** HOLE CARDS ***
Dealt to bd6eeaf3 
Dealt to 604f36f0 
Dealt to Hero [Tc 6d]
Dealt to c256b4a2 
Dealt to 2060075e 
Dealt to e7058be8 
c256b4a2: folds
2060075e: folds
e7058be8: folds
bd6eeaf3: folds
604f36f0: raises $0.25 to $0.5
Hero: folds
Uncalled bet ($0.25) returned to 604f36f0
*** SHOWDOWN ***
604f36f0 collected $0.5 from pot
*** SUMMARY ***
Total pot $0.5
Seat 1: bd6eeaf3 (button) folded before Flop (didn't bet)
Seat 2: 604f36f0 (small blind) collected ($0.5)
Seat 3: Hero (big blind) folded before Flop
Seat 4: c256b4a2 folded before Flop (didn't bet)
Seat 5: 2060075e folded before Flop (didn't bet)
Seat 6: e7058be8 folded before Flop (didn't bet)


Poker Hand #RC94801021: Hold'em No Limit ($0.1/$0.25) - 2020/04/06 23:55:02
Table 'RushAndCash320415' 6-max Seat #1 is the button
Seat 1: e0680a48 ($90.47 in chips)
Seat 2: 8466ae26 ($60.9 in chips)
Seat 3: b215699c ($47.63 in chips)
Seat 4: Hero ($28.45 in chips)
Seat 5: cce649b7 ($61.55 in chips)
Seat 6: 8b5f3466 ($32.66 in chips)
8466ae26: posts small blind $0.1
b215699c: posts big blind $0.25
*** HOLE CARDS ***
Dealt to e0680a48 
Dealt to 8466ae26 
Dealt to b215699c 
Dealt to Hero [Jh 9s]
Dealt to cce649b7 
Dealt to 8b5f3466 
Hero: folds
cce649b7: raises $0.38 to $0.63
8b5f3466: raises $0.87 to $1.5
e0680a48: folds
8466ae26: folds
b215699c: folds
cce649b7: calls $0.87
*** FLOP *** [Qs 2s 6h]
cce649b7: checks
8b5f3466: bets $1.7
cce649b7: calls $1.7
*** TURN *** [Qs 2s 6h] [Ts]
cce649b7: checks
8b5f3466: bets $3.4
cce649b7: raises $6.9 to $10.3
8b5f3466: calls $6.9
*** RIVER *** [Qs 2s 6h Ts] [7h]
cce649b7: checks
8b5f3466: bets $19.16 and is all-in
cce649b7: folds
Uncalled bet ($19.16) returned to 8b5f3466
*** SHOWDOWN ***
8b5f3466 collected $27.35 from pot
*** SUMMARY ***
Total pot $27.35
Board [Qs 2s 6h Ts 7h]
Seat 1: e0680a48 (button) folded before Flop (didn't bet)
Seat 2: 8466ae26 (small blind) folded before Flop
Seat 3: b215699c (big blind) folded before Flop
Seat 4: Hero folded before Flop (didn't bet)
Seat 5: cce649b7 folded on the River
Seat 6: 8b5f3466 won ($27.35)


Poker Hand #RC94801034: Hold'em No Limit ($0.1/$0.25) - 2020/04/06 23:55:06
Table 'RushAndCash320417' 6-max Seat #1 is the button
Seat 1: 72fa991e ($32.92 in chips)
Seat 2: Hero ($28.45 in chips)
Seat 3: 59bcbffa ($28.42 in chips)
Seat 4: fe7c9e7a ($28.02 in chips)
Seat 5: 1d6fff9c ($25.49 in chips)
Seat 6: c4f91a8c ($21.2 in chips)
Hero: posts small blind $0.1
59bcbffa: posts big blind $0.25
*** HOLE CARDS ***
Dealt to 72fa991e 
Dealt to Hero [As 2s]
Dealt to 59bcbffa 
Dealt to fe7c9e7a 
Dealt to 1d6fff9c 
Dealt to c4f91a8c 
fe7c9e7a: folds
1d6fff9c: folds
c4f91a8c: folds
72fa991e: raises $0.38 to $0.63
Hero: calls $0.53
59bcbffa: folds
*** FLOP *** [Th 5s 7c]
Hero: checks
72fa991e: bets $0.9
Hero: folds
Uncalled bet ($0.9) returned to 72fa991e
*** SHOWDOWN ***
72fa991e collected $1.51 from pot
*** SUMMARY ***
Total pot $1.51
Board [Th 5s 7c]
Seat 1: 72fa991e (button) won ($1.51)
Seat 2: Hero (small blind) folded on the Flop
Seat 3: 59bcbffa (big blind) folded before Flop
Seat 4: fe7c9e7a folded before Flop (didn't bet)
Seat 5: 1d6fff9c folded before Flop (didn't bet)
Seat 6: c4f91a8c folded before Flop (didn't bet)


Poker Hand #RC94801187: Hold'em No Limit ($0.1/$0.25) - 2020/04/06 23:55:42
Table 'RushAndCash320443' 6-max Seat #1 is the button
Seat 1: 5b5fe518 ($35.35 in chips)
Seat 2: 72fa991e ($33.73 in chips)
Seat 3: 99d6d386 ($25 in chips)
Seat 4: c37366b8 ($9.97 in chips)
Seat 5: Hero ($27.82 in chips)
Seat 6: 59bcbffa ($28.07 in chips)
72fa991e: posts small blind $0.1
99d6d386: posts big blind $0.25
*** HOLE CARDS ***
Dealt to 5b5fe518 
Dealt to 72fa991e 
Dealt to 99d6d386 
Dealt to c37366b8 
Dealt to Hero [Ah Jh]
Dealt to 59bcbffa 
c37366b8: folds
Hero: raises $0.38 to $0.63
59bcbffa: folds
5b5fe518: calls $0.63
72fa991e: folds
99d6d386: folds
*** FLOP *** [8d 2h Td]
Hero: checks
5b5fe518: bets $0.9
Hero: folds
Uncalled bet ($0.9) returned to 5b5fe518
*** SHOWDOWN ***
5b5fe518 collected $1.61 from pot
*** SUMMARY ***
Total pot $1.61
Board [8d 2h Td]
Seat 1: 5b5fe518 (button) won ($1.61)
Seat 2: 72fa991e (small blind) folded before Flop
Seat 3: 99d6d386 (big blind) folded before Flop
Seat 4: c37366b8 folded before Flop (didn't bet)
Seat 5: Hero folded on the Flop
Seat 6: 59bcbffa folded before Flop (didn't bet)


Poker Hand #RC94801301: Hold'em No Limit ($0.1/$0.25) - 2020/04/06 23:56:09
Table 'RushAndCash320469' 6-max Seat #1 is the button
Seat 1: dfcfe0b3 ($53.09 in chips)
Seat 2: fe7c9e7a ($27.67 in chips)
Seat 3: Hero ($27.19 in chips)
Seat 4: 5b5fe518 ($36.6 in chips)
Seat 5: e44fce1a ($31.5 in chips)
Seat 6: 2060075e ($25.33 in chips)
fe7c9e7a: posts small blind $0.1
Hero: posts big blind $0.25
*** HOLE CARDS ***
Dealt to dfcfe0b3 
Dealt to fe7c9e7a 
Dealt to Hero [8c 2d]
Dealt to 5b5fe518 
Dealt to e44fce1a 
Dealt to 2060075e 
5b5fe518: raises $0.5 to $0.75
e44fce1a: folds
2060075e: folds
dfcfe0b3: folds
fe7c9e7a: folds
Hero: folds
Uncalled bet ($0.5) returned to 5b5fe518
*** SHOWDOWN ***
5b5fe518 collected $0.6 from pot
*** SUMMARY ***
Total pot $0.6
Seat 1: dfcfe0b3 (button) folded before Flop (didn't bet)
Seat 2: fe7c9e7a (small blind) folded before Flop
Seat 3: Hero (big blind) folded before Flop
Seat 4: 5b5fe518 collected ($0.6)
Seat 5: e44fce1a folded before Flop (didn't bet)
Seat 6: 2060075e folded before Flop (didn't bet)


Poker Hand #RC94801356: Hold'em No Limit ($0.1/$0.25) - 2020/04/06 23:56:23
Table 'RushAndCash320481' 6-max Seat #1 is the button
Seat 1: Hero ($26.94 in chips)
Seat 2: a2913d47 ($24.65 in chips)
Seat 3: afa5143c ($33.86 in chips)
Seat 4: ce4e1e37 ($30.36 in chips)
Seat 5: 346636d5 ($18.35 in chips)
Seat 6: 576737c8 ($12.85 in chips)
a2913d47: posts small blind $0.1
afa5143c: posts big blind $0.25
*** HOLE CARDS ***
Dealt to Hero [9s 8d]
Dealt to a2913d47 
Dealt to afa5143c 
Dealt to ce4e1e37 
Dealt to 346636d5 
Dealt to 576737c8 
ce4e1e37: folds
346636d5: folds
576737c8: raises $0.5 to $0.75
Hero: folds
a2913d47: folds
afa5143c: folds
Uncalled bet ($0.5) returned to 576737c8
*** SHOWDOWN ***
576737c8 collected $0.6 from pot
*** SUMMARY ***
Total pot $0.6
Seat 1: Hero (button) folded before Flop (didn't bet)
Seat 2: a2913d47 (small blind) folded before Flop
Seat 3: afa5143c (big blind) folded before Flop
Seat 4: ce4e1e37 folded before Flop (didn't bet)
Seat 5: 346636d5 folded before Flop (didn't bet)
Seat 6: 576737c8 collected ($0.6)


Poker Hand #RC94801373: Hold'em No Limit ($0.1/$0.25) - 2020/04/06 23:56:27
Table 'RushAndCash320484' 6-max Seat #1 is the button
Seat 1: 346636d5 ($18.35 in chips)
Seat 2: dfcfe0b3 ($52.84 in chips)
Seat 3: Hero ($26.94 in chips)
Seat 4: 2c58d58e ($27.52 in chips)
Seat 5: 1d6fff9c ($25.14 in chips)
Seat 6: e7058be8 ($11.29 in chips)
Cash Drop to Pot : total $2.5 
dfcfe0b3: posts small blind $0.1
Hero: posts big blind $0.25
*** HOLE CARDS ***
Dealt to 346636d5 
Dealt to dfcfe0b3 
Dealt to Hero [8h 7c]
Dealt to 2c58d58e 
Dealt to 1d6fff9c 
Dealt to e7058be8 
2c58d58e: folds
1d6fff9c: folds
e7058be8: raises $11.04 to $11.29 and is all-in
346636d5: folds
dfcfe0b3: folds
Hero: folds
Uncalled bet ($11.04) returned to e7058be8
*** SHOWDOWN ***
e7058be8 collected $3.1 from pot
*** SUMMARY ***
Total pot $3.1
Seat 1: 346636d5 (button) folded before Flop (didn't bet)
Seat 2: dfcfe0b3 (small blind) folded before Flop
Seat 3: Hero (big blind) folded before Flop
Seat 4: 2c58d58e folded before Flop (didn't bet)
Seat 5: 1d6fff9c folded before Flop (didn't bet)
Seat 6: e7058be8 collected ($3.1)


Poker Hand #RC94801418: Hold'em No Limit ($0.1/$0.25) - 2020/04/06 23:56:37
Table 'RushAndCash320493' 6-max Seat #1 is the button
Seat 1: 520e111e ($25 in chips)
Seat 2: Hero ($26.69 in chips)
Seat 3: d82ee9a0 ($16.62 in chips)
Seat 4: 9e9b6fda ($40.12 in chips)
Seat 5: 8e166af5 ($52.94 in chips)
Seat 6: 41ab7510 ($27.82 in chips)
Hero: posts small blind $0.1
d82ee9a0: posts big blind $0.25
*** HOLE CARDS ***
Dealt to 520e111e 
Dealt to Hero [Ks 3c]
Dealt to d82ee9a0 
Dealt to 9e9b6fda 
Dealt to 8e166af5 
Dealt to 41ab7510 
9e9b6fda: folds
8e166af5: folds
41ab7510: folds
520e111e: raises $0.25 to $0.5
Hero: folds
d82ee9a0: calls $0.25
*** FLOP *** [8d 3s 6c]
d82ee9a0: checks
520e111e: bets $0.6
d82ee9a0: calls $0.6
*** TURN *** [8d 3s 6c] [9s]
d82ee9a0: checks
520e111e: bets $1.75
d82ee9a0: folds
Uncalled bet ($1.75) returned to 520e111e
*** SHOWDOWN ***
520e111e collected $2.3 from pot
*** SUMMARY ***
Total pot $2.3
Board [8d 3s 6c 9s]
Seat 1: 520e111e (button) won ($2.3)
Seat 2: Hero (small blind) folded before Flop
Seat 3: d82ee9a0 (big blind) folded on the Turn
Seat 4: 9e9b6fda folded before Flop (didn't bet)
Seat 5: 8e166af5 folded before Flop (didn't bet)
Seat 6: 41ab7510 folded before Flop (didn't bet)


Poker Hand #RC94801429: Hold'em No Limit ($0.1/$0.25) - 2020/04/06 23:56:40
Table 'RushAndCash320495' 6-max Seat #1 is the button
Seat 1: 58b04451 ($6.98 in chips)
Seat 2: ce4e1e37 ($30.36 in chips)
Seat 3: 2ebb8f6c ($26.23 in chips)
Seat 4: 9b358964 ($27.2 in chips)
Seat 5: 55218991 ($13.05 in chips)
Seat 6: Hero ($26.59 in chips)
ce4e1e37: posts small blind $0.1
2ebb8f6c: posts big blind $0.25
*** HOLE CARDS ***
Dealt to 58b04451 
Dealt to ce4e1e37 
Dealt to 2ebb8f6c 
Dealt to 9b358964 
Dealt to 55218991 
Dealt to Hero [Ts 9d]
9b358964: folds
55218991: folds
Hero: folds
58b04451: folds
ce4e1e37: folds
Uncalled bet ($0.15) returned to 2ebb8f6c
*** SHOWDOWN ***
2ebb8f6c collected $0.2 from pot
*** SUMMARY ***
Total pot $0.2
Seat 1: 58b04451 (button) folded before Flop (didn't bet)
Seat 2: ce4e1e37 (small blind) folded before Flop
Seat 3: 2ebb8f6c (big blind) collected ($0.2)
Seat 4: 9b358964 folded before Flop (didn't bet)
Seat 5: 55218991 folded before Flop (didn't bet)
Seat 6: Hero folded before Flop (didn't bet)


Poker Hand #RC94801456: Hold'em No Limit ($0.1/$0.25) - 2020/04/06 23:56:47
Table 'RushAndCash320500' 6-max Seat #1 is the button
Seat 1: 2060075e ($25 in chips)
Seat 2: 19e4cb38 ($52.35 in chips)
Seat 3: 254b7d1e ($12.5 in chips)
Seat 4: 41459cc9 ($30.61 in chips)
Seat 5: Hero ($26.59 in chips)
Seat 6: 522e695b ($12.88 in chips)
19e4cb38: posts small blind $0.1
254b7d1e: posts big blind $0.25
*** HOLE CARDS ***
Dealt to 2060075e 
Dealt to 19e4cb38 
Dealt to 254b7d1e 
Dealt to 41459cc9 
Dealt to Hero [Ah 9d]
Dealt to 522e695b 
41459cc9: folds
Hero: folds
522e695b: folds
2060075e: folds
19e4cb38: folds
Uncalled bet ($0.15) returned to 254b7d1e
*** SHOWDOWN ***
254b7d1e collected $0.2 from pot
*** SUMMARY ***
Total pot $0.2
Seat 1: 2060075e (button) folded before Flop (didn't bet)
Seat 2: 19e4cb38 (small blind) folded before Flop
Seat 3: 254b7d1e (big blind) collected ($0.2)
Seat 4: 41459cc9 folded before Flop (didn't bet)
Seat 5: Hero folded before Flop (didn't bet)
Seat 6: 522e695b folded before Flop (didn't bet)


Poker Hand #RC94801476: Hold'em No Limit ($0.1/$0.25) - 2020/04/06 23:56:51
Table 'RushAndCash320504' 6-max Seat #1 is the button
Seat 1: Hero ($26.59 in chips)
Seat 2: a82639fc ($64.33 in chips)
Seat 3: 58b04451 ($6.88 in chips)
Seat 4: a8441d2f ($12.75 in chips)
Seat 5: dcc7f9d7 ($1.97 in chips)
Seat 6: 55218991 ($13.05 in chips)
a82639fc: posts small blind $0.1
58b04451: posts big blind $0.25
*** HOLE CARDS ***
Dealt to Hero [Kh 9d]
Dealt to a82639fc 
Dealt to 58b04451 
Dealt to a8441d2f 
Dealt to dcc7f9d7 
Dealt to 55218991 
a8441d2f: raises $0.5 to $0.75
dcc7f9d7: raises $1.22 to $1.97 and is all-in
55218991: folds
Hero: folds
a82639fc: folds
58b04451: folds
a8441d2f: calls $1.22
dcc7f9d7: shows [7c 7h]
a8441d2f: shows [Qd As]
*** FIRST FLOP *** [Qc 9s Jc]
*** FIRST TURN *** [Qc 9s Jc] [4c]
*** FIRST RIVER *** [Qc 9s Jc 4c] [9c]
*** SECOND FLOP *** [2h 5c Qh]
*** SECOND TURN *** [2h 5c Qh] [4h]
*** SECOND RIVER *** [2h 5c Qh 4h] [8s]
*** FIRST SHOWDOWN ***
dcc7f9d7 collected $2.14 from pot
*** SECOND SHOWDOWN ***
a8441d2f collected $2.14 from pot
*** SUMMARY ***
Total pot $4.29
Hand was run two times
FIRST Board [Qc 9s Jc 4c 9c]
SECOND Board [2h 5c Qh 4h 8s]
Seat 1: Hero (button) folded before Flop (didn't bet)
Seat 2: a82639fc (small blind) folded before Flop
Seat 3: 58b04451 (big blind) folded before Flop
Seat 4: a8441d2f showed [As Qd] and lost with Pair of Queens and Pair of Nines, and won ($2.14) with Pair of Queens
Seat 5: dcc7f9d7 showed [7h 7c] and won ($2.14) with Queen High Flush, and lost with Pair of Sevens
Seat 6: 55218991 folded before Flop (didn't bet)


Poker Hand #RC94801497: Hold'em No Limit ($0.1/$0.25) - 2020/04/06 23:56:56
Table 'RushAndCash320508' 6-max Seat #1 is the button
Seat 1: 35a45ce2 ($29.45 in chips)
Seat 2: c256b4a2 ($40.61 in chips)
Seat 3: cf8c7400 ($25 in chips)
Seat 4: 9e9b6fda ($40.12 in chips)
Seat 5: Hero ($26.59 in chips)
Seat 6: 928a94bb ($59.57 in chips)
c256b4a2: posts small blind $0.1
cf8c7400: posts big blind $0.25
*** HOLE CARDS ***
Dealt to 35a45ce2 
Dealt to c256b4a2 
Dealt to cf8c7400 
Dealt to 9e9b6fda 
Dealt to Hero [3d 2h]
Dealt to 928a94bb 
9e9b6fda: folds
Hero: folds
928a94bb: folds
35a45ce2: folds
c256b4a2: folds
Uncalled bet ($0.15) returned to cf8c7400
*** SHOWDOWN ***
cf8c7400 collected $0.2 from pot
*** SUMMARY ***
Total pot $0.2
Seat 1: 35a45ce2 (button) folded before Flop (didn't bet)
Seat 2: c256b4a2 (small blind) folded before Flop
Seat 3: cf8c7400 (big blind) collected ($0.2)
Seat 4: 9e9b6fda folded before Flop (didn't bet)
Seat 5: Hero folded before Flop (didn't bet)
Seat 6: 928a94bb folded before Flop (didn't bet)


Poker Hand #RC94801510: Hold'em No Limit ($0.1/$0.25) - 2020/04/06 23:56:59
Table 'RushAndCash320510' 6-max Seat #1 is the button
Seat 1: 8e166af5 ($53.04 in chips)
Seat 2: c4f91a8c ($21.62 in chips)
Seat 3: d5960dd1 ($22.69 in chips)
Seat 4: 2060075e ($25 in chips)
Seat 5: 6ee3fbae ($3.95 in chips)
Seat 6: Hero ($26.59 in chips)
c4f91a8c: posts small blind $0.1
d5960dd1: posts big blind $0.25
*** HOLE CARDS ***
Dealt to 8e166af5 
Dealt to c4f91a8c 
Dealt to d5960dd1 
Dealt to 2060075e 
Dealt to 6ee3fbae 
Dealt to Hero [2h 2c]
2060075e: folds
6ee3fbae: folds
Hero: folds
8e166af5: folds
c4f91a8c: folds
Uncalled bet ($0.15) returned to d5960dd1
*** SHOWDOWN ***
d5960dd1 collected $0.2 from pot
*** SUMMARY ***
Total pot $0.2
Seat 1: 8e166af5 (button) folded before Flop (didn't bet)
Seat 2: c4f91a8c (small blind) folded before Flop
Seat 3: d5960dd1 (big blind) collected ($0.2)
Seat 4: 2060075e folded before Flop (didn't bet)
Seat 5: 6ee3fbae folded before Flop (didn't bet)
Seat 6: Hero folded before Flop (didn't bet)


Poker Hand #RC94801525: Hold'em No Limit ($0.1/$0.25) - 2020/04/06 23:57:02
Table 'RushAndCash320513' 6-max Seat #1 is the button
Seat 1: fe7c9e7a ($28.14 in chips)
Seat 2: b5518434 ($30.83 in chips)
Seat 3: 1ecb53b7 ($12.35 in chips)
Seat 4: Hero ($26.59 in chips)
Seat 5: b9bbf733 ($25.95 in chips)
Seat 6: 58b04451 ($6.63 in chips)
b5518434: posts small blind $0.1
1ecb53b7: posts big blind $0.25
*** HOLE CARDS ***
Dealt to fe7c9e7a 
Dealt to b5518434 
Dealt to 1ecb53b7 
Dealt to Hero [Ah 4h]
Dealt to b9bbf733 
Dealt to 58b04451 
Hero: raises $0.38 to $0.63
b9bbf733: folds
58b04451: folds
fe7c9e7a: folds
b5518434: folds
1ecb53b7: folds
Uncalled bet ($0.38) returned to Hero
*** SHOWDOWN ***
Hero collected $0.6 from pot
*** SUMMARY ***
Total pot $0.6
Seat 1: fe7c9e7a (button) folded before Flop (didn't bet)
Seat 2: b5518434 (small blind) folded before Flop
Seat 3: 1ecb53b7 (big blind) folded before Flop
Seat 4: Hero collected ($0.6)
Seat 5: b9bbf733 folded before Flop (didn't bet)
Seat 6: 58b04451 folded before Flop (didn't bet)


Poker Hand #RC94801603: Hold'em No Limit ($0.1/$0.25) - 2020/04/06 23:57:20
Table 'RushAndCash320526' 6-max Seat #1 is the button
Seat 1: cf8c7400 ($25.25 in chips)
Seat 2: 90609fad ($59.98 in chips)
Seat 3: 576737c8 ($12.5 in chips)
Seat 4: 59bcbffa ($28.86 in chips)
Seat 5: 1826a10f ($11.12 in chips)
Seat 6: Hero ($26.94 in chips)
90609fad: posts small blind $0.1
576737c8: posts big blind $0.25
*** HOLE CARDS ***
Dealt to cf8c7400 
Dealt to 90609fad 
Dealt to 576737c8 
Dealt to 59bcbffa 
Dealt to 1826a10f 
Dealt to Hero [Kc 7h]
59bcbffa: folds
1826a10f: folds
Hero: folds
cf8c7400: folds
90609fad: folds
Uncalled bet ($0.15) returned to 576737c8
*** SHOWDOWN ***
576737c8 collected $0.2 from pot
*** SUMMARY ***
Total pot $0.2
Seat 1: cf8c7400 (button) folded before Flop (didn't bet)
Seat 2: 90609fad (small blind) folded before Flop
Seat 3: 576737c8 (big blind) collected ($0.2)
Seat 4: 59bcbffa folded before Flop (didn't bet)
Seat 5: 1826a10f folded before Flop (didn't bet)
Seat 6: Hero folded before Flop (didn't bet)


Poker Hand #RC94801623: Hold'em No Limit ($0.1/$0.25) - 2020/04/06 23:57:24
Table 'RushAndCash320529' 6-max Seat #1 is the button
Seat 1: b00dbb18 ($35.12 in chips)
Seat 2: 2c58d58e ($28.19 in chips)
Seat 3: d8a224aa ($46.07 in chips)
Seat 4: 59bcbffa ($28.86 in chips)
Seat 5: Hero ($26.94 in chips)
Seat 6: 90609fad ($59.88 in chips)
2c58d58e: posts small blind $0.1
d8a224aa: posts big blind $0.25
*** HOLE CARDS ***
Dealt to b00dbb18 
Dealt to 2c58d58e 
Dealt to d8a224aa 
Dealt to 59bcbffa 
Dealt to Hero [8s 5s]
Dealt to 90609fad 
59bcbffa: folds
Hero: folds
90609fad: folds
b00dbb18: folds
2c58d58e: folds
Uncalled bet ($0.15) returned to d8a224aa
*** SHOWDOWN ***
d8a224aa collected $0.2 from pot
*** SUMMARY ***
Total pot $0.2
Seat 1: b00dbb18 (button) folded before Flop (didn't bet)
Seat 2: 2c58d58e (small blind) folded before Flop
Seat 3: d8a224aa (big blind) collected ($0.2)
Seat 4: 59bcbffa folded before Flop (didn't bet)
Seat 5: Hero folded before Flop (didn't bet)
Seat 6: 90609fad folded before Flop (didn't bet)


Poker Hand #RC94801645: Hold'em No Limit ($0.1/$0.25) - 2020/04/06 23:57:29
Table 'RushAndCash320534' 6-max Seat #1 is the button
Seat 1: 35a45ce2 ($29.45 in chips)
Seat 2: 55218991 ($12.8 in chips)
Seat 3: e7058be8 ($13.99 in chips)
Seat 4: 90609fad ($59.88 in chips)
Seat 5: 2467bb49 ($63.38 in chips)
Seat 6: Hero ($26.94 in chips)
55218991: posts small blind $0.1
e7058be8: posts big blind $0.25
*** HOLE CARDS ***
Dealt to 35a45ce2 
Dealt to 55218991 
Dealt to e7058be8 
Dealt to 90609fad 
Dealt to 2467bb49 
Dealt to Hero [Js 3c]
90609fad: raises $0.5 to $0.75
2467bb49: folds
Hero: folds
35a45ce2: folds
55218991: folds
e7058be8: folds
Uncalled bet ($0.5) returned to 90609fad
*** SHOWDOWN ***
90609fad collected $0.6 from pot
*** SUMMARY ***
Total pot $0.6
Seat 1: 35a45ce2 (button) folded before Flop (didn't bet)
Seat 2: 55218991 (small blind) folded before Flop
Seat 3: e7058be8 (big blind) folded before Flop
Seat 4: 90609fad collected ($0.6)
Seat 5: 2467bb49 folded before Flop (didn't bet)
Seat 6: Hero folded before Flop (didn't bet)


Poker Hand #RC94801662: Hold'em No Limit ($0.1/$0.25) - 2020/04/06 23:57:33
Table 'RushAndCash320537' 6-max Seat #1 is the button
Seat 1: Hero ($26.94 in chips)
Seat 2: 8f2f88a4 ($54.29 in chips)
Seat 3: c37366b8 ($9.62 in chips)
Seat 4: fe7c9e7a ($28.24 in chips)
Seat 5: cf8c7400 ($25.25 in chips)
Seat 6: 604f36f0 ($7.85 in chips)
8f2f88a4: posts small blind $0.1
c37366b8: posts big blind $0.25
*** HOLE CARDS ***
Dealt to Hero [Td 8h]
Dealt to 8f2f88a4 
Dealt to c37366b8 
Dealt to fe7c9e7a 
Dealt to cf8c7400 
Dealt to 604f36f0 
fe7c9e7a: folds
cf8c7400: folds
604f36f0: raises $0.5 to $0.75
Hero: folds
8f2f88a4: folds
c37366b8: folds
Uncalled bet ($0.5) returned to 604f36f0
*** SHOWDOWN ***
604f36f0 collected $0.6 from pot
*** SUMMARY ***
Total pot $0.6
Seat 1: Hero (button) folded before Flop (didn't bet)
Seat 2: 8f2f88a4 (small blind) folded before Flop
Seat 3: c37366b8 (big blind) folded before Flop
Seat 4: fe7c9e7a folded before Flop (didn't bet)
Seat 5: cf8c7400 folded before Flop (didn't bet)
Seat 6: 604f36f0 collected ($0.6)


Poker Hand #RC94801675: Hold'em No Limit ($0.1/$0.25) - 2020/04/06 23:57:37
Table 'RushAndCash320540' 6-max Seat #1 is the button
Seat 1: 2ebb8f6c ($26.48 in chips)
Seat 2: 1826a10f ($11.12 in chips)
Seat 3: Hero ($26.94 in chips)
Seat 4: afa5143c ($33.41 in chips)
Seat 5: fe7c9e7a ($28.24 in chips)
Seat 6: 254b7d1e ($12.85 in chips)
1826a10f: posts small blind $0.1
Hero: posts big blind $0.25
*** HOLE CARDS ***
Dealt to 2ebb8f6c 
Dealt to 1826a10f 
Dealt to Hero [Js 4c]
Dealt to afa5143c 
Dealt to fe7c9e7a 
Dealt to 254b7d1e 
afa5143c: folds
fe7c9e7a: folds
254b7d1e: raises $0.5 to $0.75
2ebb8f6c: calls $0.75
1826a10f: folds
Hero: folds
*** FLOP *** [7s Ts 5h]
254b7d1e: bets $1.4
2ebb8f6c: folds
Uncalled bet ($1.4) returned to 254b7d1e
*** SHOWDOWN ***
254b7d1e collected $1.85 from pot
*** SUMMARY ***
Total pot $1.85
Board [7s Ts 5h]
Seat 1: 2ebb8f6c (button) folded on the Flop
Seat 2: 1826a10f (small blind) folded before Flop
Seat 3: Hero (big blind) folded before Flop
Seat 4: afa5143c folded before Flop (didn't bet)
Seat 5: fe7c9e7a folded before Flop (didn't bet)
Seat 6: 254b7d1e won ($1.85)


Poker Hand #RC94801700: Hold'em No Limit ($0.1/$0.25) - 2020/04/06 23:57:42
Table 'RushAndCash320545' 6-max Seat #1 is the button
Seat 1: afa5143c ($33.41 in chips)
Seat 2: e7058be8 ($13.74 in chips)
Seat 3: 58db3176 ($25 in chips)
Seat 4: a8441d2f ($12.82 in chips)
Seat 5: d5960dd1 ($22.79 in chips)
Seat 6: Hero ($26.69 in chips)
e7058be8: posts small blind $0.1
58db3176: posts big blind $0.25
*** HOLE CARDS ***
Dealt to afa5143c 
Dealt to e7058be8 
Dealt to 58db3176 
Dealt to a8441d2f 
Dealt to d5960dd1 
Dealt to Hero [Qc Td]
a8441d2f: folds
d5960dd1: folds
Hero: folds
afa5143c: raises $0.38 to $0.63
e7058be8: folds
58db3176: folds
Uncalled bet ($0.38) returned to afa5143c
*** SHOWDOWN ***
afa5143c collected $0.6 from pot
*** SUMMARY ***
Total pot $0.6
Seat 1: afa5143c (button) collected ($0.6)
Seat 2: e7058be8 (small blind) folded before Flop
Seat 3: 58db3176 (big blind) folded before Flop
Seat 4: a8441d2f folded before Flop (didn't bet)
Seat 5: d5960dd1 folded before Flop (didn't bet)
Seat 6: Hero folded before Flop (didn't bet)


Poker Hand #RC94801716: Hold'em No Limit ($0.1/$0.25) - 2020/04/06 23:57:46
Table 'RushAndCash320548' 6-max Seat #1 is the button
Seat 1: c37366b8 ($9.27 in chips)
Seat 2: Hero ($26.69 in chips)
Seat 3: cce649b7 ($48.05 in chips)
Seat 4: 604f36f0 ($8.2 in chips)
Seat 5: 576737c8 ($13.2 in chips)
Seat 6: 4244d459 ($23.29 in chips)
Hero: posts small blind $0.1
cce649b7: posts big blind $0.25
*** HOLE CARDS ***
Dealt to c37366b8 
Dealt to Hero [Ah Qh]
Dealt to cce649b7 
Dealt to 604f36f0 
Dealt to 576737c8 
Dealt to 4244d459 
604f36f0: folds
576737c8: folds
4244d459: raises $0.45 to $0.7
c37366b8: folds
Hero: raises $2.05 to $2.75
cce649b7: calls $2.5
4244d459: folds
*** FLOP *** [2d Qd 8d]
Hero: bets $4.7
cce649b7: folds
Uncalled bet ($4.7) returned to Hero
*** SHOWDOWN ***
Hero collected $6.2 from pot
*** SUMMARY ***
Total pot $6.2
Board [2d Qd 8d]
Seat 1: c37366b8 (button) folded before Flop (didn't bet)
Seat 2: Hero (small blind) won ($6.2)
Seat 3: cce649b7 (big blind) folded on the Flop
Seat 4: 604f36f0 folded before Flop (didn't bet)
Seat 5: 576737c8 folded before Flop (didn't bet)
Seat 6: 4244d459 folded before Flop


Poker Hand #RC94801971: Hold'em No Limit ($0.1/$0.25) - 2020/04/06 23:58:45
Table 'RushAndCash320592' 6-max Seat #1 is the button
Seat 1: b00dbb18 ($35.02 in chips)
Seat 2: fe7c9e7a ($25.95 in chips)
Seat 3: Hero ($29.83 in chips)
Seat 4: b5518434 ($34.5 in chips)
Seat 5: 604f36f0 ($7.95 in chips)
Seat 6: cce649b7 ($45.3 in chips)
fe7c9e7a: posts small blind $0.1
Hero: posts big blind $0.25
*** HOLE CARDS ***
Dealt to b00dbb18 
Dealt to fe7c9e7a 
Dealt to Hero [9c 8c]
Dealt to b5518434 
Dealt to 604f36f0 
Dealt to cce649b7 
b5518434: folds
604f36f0: folds
cce649b7: folds
b00dbb18: raises $0.25 to $0.5
fe7c9e7a: raises $1.9 to $2.4
Hero: folds
b00dbb18: folds
Uncalled bet ($1.9) returned to fe7c9e7a
*** SHOWDOWN ***
fe7c9e7a collected $1.25 from pot
*** SUMMARY ***
Total pot $1.25
Seat 1: b00dbb18 (button) folded before Flop
Seat 2: fe7c9e7a (small blind) collected ($1.25)
Seat 3: Hero (big blind) folded before Flop
Seat 4: b5518434 folded before Flop (didn't bet)
Seat 5: 604f36f0 folded before Flop (didn't bet)
Seat 6: cce649b7 folded before Flop (didn't bet)


Poker Hand #RC94802058: Hold'em No Limit ($0.1/$0.25) - 2020/04/06 23:59:06
Table 'RushAndCash320608' 6-max Seat #1 is the button
Seat 1: Hero ($29.58 in chips)
Seat 2: 969ce17 ($33.41 in chips)
Seat 3: 19e4cb38 ($52 in chips)
Seat 4: 2ebb8f6c ($25.48 in chips)
Seat 5: 254b7d1e ($13.51 in chips)
Seat 6: e58da42d ($35.43 in chips)
969ce17: posts small blind $0.1
19e4cb38: posts big blind $0.25
*** HOLE CARDS ***
Dealt to Hero [As Kd]
Dealt to 969ce17 
Dealt to 19e4cb38 
Dealt to 2ebb8f6c 
Dealt to 254b7d1e 
Dealt to e58da42d 
2ebb8f6c: folds
254b7d1e: folds
e58da42d: folds
Hero: raises $0.38 to $0.63
969ce17: folds
19e4cb38: folds
Uncalled bet ($0.38) returned to Hero
*** SHOWDOWN ***
Hero collected $0.6 from pot
*** SUMMARY ***
Total pot $0.6
Seat 1: Hero (button) collected ($0.6)
Seat 2: 969ce17 (small blind) folded before Flop
Seat 3: 19e4cb38 (big blind) folded before Flop
Seat 4: 2ebb8f6c folded before Flop (didn't bet)
Seat 5: 254b7d1e folded before Flop (didn't bet)
Seat 6: e58da42d folded before Flop (didn't bet)


Poker Hand #RC94802106: Hold'em No Limit ($0.1/$0.25) - 2020/04/06 23:59:16
Table 'RushAndCash320618' 6-max Seat #1 is the button
Seat 1: dfcfe0b3 ($51.13 in chips)
Seat 2: 522e695b ($14 in chips)
Seat 3: b215699c ($50.53 in chips)
Seat 4: Hero ($29.93 in chips)
Seat 5: 2fdc01e0 ($25.35 in chips)
Seat 6: b96956e4 ($27.5 in chips)
522e695b: posts small blind $0.1
b215699c: posts big blind $0.25
*** HOLE CARDS ***
Dealt to dfcfe0b3 
Dealt to 522e695b 
Dealt to b215699c 
Dealt to Hero [Ts 2c]
Dealt to 2fdc01e0 
Dealt to b96956e4 
Hero: folds
2fdc01e0: raises $0.38 to $0.63
b96956e4: folds
dfcfe0b3: raises $1.37 to $2
522e695b: folds
b215699c: calls $1.75
2fdc01e0: calls $1.37
*** FLOP *** [2h 6h 8s]
b215699c: checks
2fdc01e0: checks
dfcfe0b3: bets $2.7
b215699c: raises $3.7 to $6.4
2fdc01e0: folds
dfcfe0b3: calls $3.7
*** TURN *** [2h 6h 8s] [4s]
b215699c: bets $10
dfcfe0b3: calls $10
*** RIVER *** [2h 6h 8s 4s] [5h]
b215699c: checks
dfcfe0b3: bets $32.73 and is all-in
b215699c: folds
Uncalled bet ($32.73) returned to dfcfe0b3
*** SHOWDOWN ***
dfcfe0b3 collected $38.9 from pot
*** SUMMARY ***
Total pot $38.9
Board [2h 6h 8s 4s 5h]
Seat 1: dfcfe0b3 (button) won ($38.9)
Seat 2: 522e695b (small blind) folded before Flop
Seat 3: b215699c (big blind) folded on the River
Seat 4: Hero folded before Flop (didn't bet)
Seat 5: 2fdc01e0 folded on the Flop
Seat 6: b96956e4 folded before Flop (didn't bet)


Poker Hand #RC94802122: Hold'em No Limit ($0.1/$0.25) - 2020/04/06 23:59:20
Table 'RushAndCash320621' 6-max Seat #1 is the button
Seat 1: cf8c7400 ($25.35 in chips)
Seat 2: e767af3b ($25 in chips)
Seat 3: bc200877 ($11.93 in chips)
Seat 4: Hero ($29.93 in chips)
Seat 5: ba032eea ($71.9 in chips)
Seat 6: b00dbb18 ($34.52 in chips)
e767af3b: posts small blind $0.1
bc200877: posts big blind $0.25
*** HOLE CARDS ***
Dealt to cf8c7400 
Dealt to e767af3b 
Dealt to bc200877 
Dealt to Hero [9s 4h]
Dealt to ba032eea 
Dealt to b00dbb18 
Hero: folds
ba032eea: folds
b00dbb18: folds
cf8c7400: raises $0.38 to $0.63
e767af3b: folds
bc200877: raises $1.37 to $2
cf8c7400: folds
Uncalled bet ($1.37) returned to bc200877
*** SHOWDOWN ***
bc200877 collected $1.36 from pot
*** SUMMARY ***
Total pot $1.36
Seat 1: cf8c7400 (button) folded before Flop
Seat 2: e767af3b (small blind) folded before Flop
Seat 3: bc200877 (big blind) collected ($1.36)
Seat 4: Hero folded before Flop (didn't bet)
Seat 5: ba032eea folded before Flop (didn't bet)
Seat 6: b00dbb18 folded before Flop (didn't bet)


Poker Hand #RC94802141: Hold'em No Limit ($0.1/$0.25) - 2020/04/06 23:59:24
Table 'RushAndCash320625' 6-max Seat #1 is the button
Seat 1: cc4afcf8 ($9.83 in chips)
Seat 2: Hero ($29.93 in chips)
Seat 3: 90609fad ($59.53 in chips)
Seat 4: 8c980f3 ($12.85 in chips)
Seat 5: ca69da65 ($35.91 in chips)
Seat 6: e58da42d ($35.08 in chips)
Hero: posts small blind $0.1
90609fad: posts big blind $0.25
*** HOLE CARDS ***
Dealt to cc4afcf8 
Dealt to Hero [Ad 7c]
Dealt to 90609fad 
Dealt to 8c980f3 
Dealt to ca69da65 
Dealt to e58da42d 
8c980f3: folds
ca69da65: folds
e58da42d: folds
cc4afcf8: raises $0.38 to $0.63
Hero: folds
90609fad: folds
Uncalled bet ($0.38) returned to cc4afcf8
*** SHOWDOWN ***
cc4afcf8 collected $0.6 from pot
*** SUMMARY ***
Total pot $0.6
Seat 1: cc4afcf8 (button) collected ($0.6)
Seat 2: Hero (small blind) folded before Flop
Seat 3: 90609fad (big blind) folded before Flop
Seat 4: 8c980f3 folded before Flop (didn't bet)
Seat 5: ca69da65 folded before Flop (didn't bet)
Seat 6: e58da42d folded before Flop (didn't bet)


Poker Hand #RC94802173: Hold'em No Limit ($0.1/$0.25) - 2020/04/06 23:59:32
Table 'RushAndCash320630' 6-max Seat #1 is the button
Seat 1: 72fa991e ($34.09 in chips)
Seat 2: ba032eea ($71.9 in chips)
Seat 3: Hero ($29.83 in chips)
Seat 4: dcc7f9d7 ($12 in chips)
Seat 5: 2904eaa2 ($29.01 in chips)
Seat 6: 90609fad ($59.28 in chips)
ba032eea: posts small blind $0.1
Hero: posts big blind $0.25
*** HOLE CARDS ***
Dealt to 72fa991e 
Dealt to ba032eea 
Dealt to Hero [Qc 9c]
Dealt to dcc7f9d7 
Dealt to 2904eaa2 
Dealt to 90609fad 
dcc7f9d7: folds
2904eaa2: folds
90609fad: folds
72fa991e: raises $0.38 to $0.63
ba032eea: folds
Hero: folds
Uncalled bet ($0.38) returned to 72fa991e
*** SHOWDOWN ***
72fa991e collected $0.6 from pot
*** SUMMARY ***
Total pot $0.6
Seat 1: 72fa991e (button) collected ($0.6)
Seat 2: ba032eea (small blind) folded before Flop
Seat 3: Hero (big blind) folded before Flop
Seat 4: dcc7f9d7 folded before Flop (didn't bet)
Seat 5: 2904eaa2 folded before Flop (didn't bet)
Seat 6: 90609fad folded before Flop (didn't bet)


Poker Hand #RC94802188: Hold'em No Limit ($0.1/$0.25) - 2020/04/06 23:59:37
Table 'RushAndCash320634' 6-max Seat #1 is the button
Seat 1: 16bf75ab ($22.75 in chips)
Seat 2: Hero ($29.58 in chips)
Seat 3: 969ce17 ($33.21 in chips)
Seat 4: 1826a10f ($11.12 in chips)
Seat 5: d533e96a ($12.5 in chips)
Seat 6: 8466ae26 ($46.89 in chips)
Hero: posts small blind $0.1
969ce17: posts big blind $0.25
*** HOLE CARDS ***
Dealt to 16bf75ab 
Dealt to Hero [As Kc]
Dealt to 969ce17 
Dealt to 1826a10f 
Dealt to d533e96a 
Dealt to 8466ae26 
1826a10f: folds
d533e96a: folds
8466ae26: folds
16bf75ab: raises $0.5 to $0.75
Hero: raises $2.5 to $3.25
969ce17: folds
16bf75ab: folds
Uncalled bet ($2.5) returned to Hero
*** SHOWDOWN ***
Hero collected $1.75 from pot
*** SUMMARY ***
Total pot $1.75
Seat 1: 16bf75ab (button) folded before Flop
Seat 2: Hero (small blind) collected ($1.75)
Seat 3: 969ce17 (big blind) folded before Flop
Seat 4: 1826a10f folded before Flop (didn't bet)
Seat 5: d533e96a folded before Flop (didn't bet)
Seat 6: 8466ae26 folded before Flop (didn't bet)


Poker Hand #RC94802323: Hold'em No Limit ($0.1/$0.25) - 2020/04/07 00:00:08
Table 'RushAndCash320654' 6-max Seat #1 is the button
Seat 1: 2c58d58e ($24.75 in chips)
Seat 2: 90609fad ($59.63 in chips)
Seat 3: 19e4cb38 ($51.3 in chips)
Seat 4: Hero ($30.5 in chips)
Seat 5: 16bf75ab ($22 in chips)
Seat 6: 5e03da34 ($92.6 in chips)
90609fad: posts small blind $0.1
19e4cb38: posts big blind $0.25
*** HOLE CARDS ***
Dealt to 2c58d58e 
Dealt to 90609fad 
Dealt to 19e4cb38 
Dealt to Hero [Kd 4d]
Dealt to 16bf75ab 
Dealt to 5e03da34 
Hero: folds
16bf75ab: folds
5e03da34: folds
2c58d58e: raises $0.5 to $0.75
90609fad: folds
19e4cb38: folds
Uncalled bet ($0.5) returned to 2c58d58e
*** SHOWDOWN ***
2c58d58e collected $0.6 from pot
*** SUMMARY ***
Total pot $0.6
Seat 1: 2c58d58e (button) collected ($0.6)
Seat 2: 90609fad (small blind) folded before Flop
Seat 3: 19e4cb38 (big blind) folded before Flop
Seat 4: Hero folded before Flop (didn't bet)
Seat 5: 16bf75ab folded before Flop (didn't bet)
Seat 6: 5e03da34 folded before Flop (didn't bet)


Poker Hand #RC94802340: Hold'em No Limit ($0.1/$0.25) - 2020/04/07 00:00:12
Table 'RushAndCash320657' 6-max Seat #1 is the button
Seat 1: dcc7f9d7 ($11.65 in chips)
Seat 2: c4f91a8c ($20.72 in chips)
Seat 3: Hero ($30.5 in chips)
Seat 4: 16bf75ab ($22 in chips)
Seat 5: 2ebb8f6c ($28.12 in chips)
Seat 6: 5b5fe518 ($30.46 in chips)
c4f91a8c: posts small blind $0.1
Hero: posts big blind $0.25
*** HOLE CARDS ***
Dealt to dcc7f9d7 
Dealt to c4f91a8c 
Dealt to Hero [5s 3s]
Dealt to 16bf75ab 
Dealt to 2ebb8f6c 
Dealt to 5b5fe518 
16bf75ab: folds
2ebb8f6c: folds
5b5fe518: folds
dcc7f9d7: raises $0.25 to $0.5
c4f91a8c: folds
Hero: folds
Uncalled bet ($0.25) returned to dcc7f9d7
*** SHOWDOWN ***
dcc7f9d7 collected $0.6 from pot
*** SUMMARY ***
Total pot $0.6
Seat 1: dcc7f9d7 (button) collected ($0.6)
Seat 2: c4f91a8c (small blind) folded before Flop
Seat 3: Hero (big blind) folded before Flop
Seat 4: 16bf75ab folded before Flop (didn't bet)
Seat 5: 2ebb8f6c folded before Flop (didn't bet)
Seat 6: 5b5fe518 folded before Flop (didn't bet)


Poker Hand #RC94802361: Hold'em No Limit ($0.1/$0.25) - 2020/04/07 00:00:17
Table 'RushAndCash320662' 6-max Seat #1 is the button
Seat 1: 1ecb53b7 ($7.89 in chips)
Seat 2: ba032eea ($71.8 in chips)
Seat 3: b5518434 ($36.71 in chips)
Seat 4: Hero ($30.25 in chips)
Seat 5: 90609fad ($59.53 in chips)
Seat 6: e58da42d ($35.08 in chips)
ba032eea: posts small blind $0.1
b5518434: posts big blind $0.25
*** HOLE CARDS ***
Dealt to 1ecb53b7 
Dealt to ba032eea 
Dealt to b5518434 
Dealt to Hero [7s 6s]
Dealt to 90609fad 
Dealt to e58da42d 
Hero: folds
90609fad: folds
e58da42d: folds
1ecb53b7: folds
ba032eea: folds
Uncalled bet ($0.15) returned to b5518434
*** SHOWDOWN ***
b5518434 collected $0.2 from pot
*** SUMMARY ***
Total pot $0.2
Seat 1: 1ecb53b7 (button) folded before Flop (didn't bet)
Seat 2: ba032eea (small blind) folded before Flop
Seat 3: b5518434 (big blind) collected ($0.2)
Seat 4: Hero folded before Flop (didn't bet)
Seat 5: 90609fad folded before Flop (didn't bet)
Seat 6: e58da42d folded before Flop (didn't bet)


Poker Hand #RC94802395: Hold'em No Limit ($0.1/$0.25) - 2020/04/07 00:00:24
Table 'RushAndCash320668' 6-max Seat #1 is the button
Seat 1: Hero ($30.25 in chips)
Seat 2: 312f6846 ($40.87 in chips)
Seat 3: 16bf75ab ($22 in chips)
Seat 4: 2467bb49 ($61.13 in chips)
Seat 5: 36ac4586 ($40.36 in chips)
Seat 6: dcc7f9d7 ($12 in chips)
312f6846: posts small blind $0.1
16bf75ab: posts big blind $0.25
*** HOLE CARDS ***
Dealt to Hero [Qd 4c]
Dealt to 312f6846 
Dealt to 16bf75ab 
Dealt to 2467bb49 
Dealt to 36ac4586 
Dealt to dcc7f9d7 
2467bb49: raises $0.38 to $0.63
36ac4586: folds
dcc7f9d7: folds
Hero: folds
312f6846: folds
16bf75ab: folds
Uncalled bet ($0.38) returned to 2467bb49
*** SHOWDOWN ***
2467bb49 collected $0.6 from pot
*** SUMMARY ***
Total pot $0.6
Seat 1: Hero (button) folded before Flop (didn't bet)
Seat 2: 312f6846 (small blind) folded before Flop
Seat 3: 16bf75ab (big blind) folded before Flop
Seat 4: 2467bb49 collected ($0.6)
Seat 5: 36ac4586 folded before Flop (didn't bet)
Seat 6: dcc7f9d7 folded before Flop (didn't bet)


Poker Hand #RC94802444: Hold'em No Limit ($0.1/$0.25) - 2020/04/07 00:00:35
Table 'RushAndCash320678' 6-max Seat #1 is the button
Seat 1: dcc7f9d7 ($12 in chips)
Seat 2: 2fdc01e0 ($25.1 in chips)
Seat 3: 1d6fff9c ($25 in chips)
Seat 4: Hero ($30.25 in chips)
Seat 5: 969ce17 ($33.31 in chips)
Seat 6: d5960dd1 ($22.44 in chips)
2fdc01e0: posts small blind $0.1
1d6fff9c: posts big blind $0.25
*** HOLE CARDS ***
Dealt to dcc7f9d7 
Dealt to 2fdc01e0 
Dealt to 1d6fff9c 
Dealt to Hero [6c 5h]
Dealt to 969ce17 
Dealt to d5960dd1 
Hero: folds
969ce17: folds
d5960dd1: raises $0.5 to $0.75
dcc7f9d7: folds
2fdc01e0: folds
1d6fff9c: folds
Uncalled bet ($0.5) returned to d5960dd1
*** SHOWDOWN ***
d5960dd1 collected $0.6 from pot
*** SUMMARY ***
Total pot $0.6
Seat 1: dcc7f9d7 (button) folded before Flop (didn't bet)
Seat 2: 2fdc01e0 (small blind) folded before Flop
Seat 3: 1d6fff9c (big blind) folded before Flop
Seat 4: Hero folded before Flop (didn't bet)
Seat 5: 969ce17 folded before Flop (didn't bet)
Seat 6: d5960dd1 collected ($0.6)


Poker Hand #RC94802461: Hold'em No Limit ($0.1/$0.25) - 2020/04/07 00:00:39
Table 'RushAndCash320681' 6-max Seat #1 is the button
Seat 1: 8466ae26 ($46.79 in chips)
Seat 2: bc200877 ($12.85 in chips)
Seat 3: 8c980f3 ($12.85 in chips)
Seat 4: 928a94bb ($50.28 in chips)
Seat 5: 99d6d386 ($25.1 in chips)
Seat 6: Hero ($30.25 in chips)
bc200877: posts small blind $0.1
8c980f3: posts big blind $0.25
*** HOLE CARDS ***
Dealt to 8466ae26 
Dealt to bc200877 
Dealt to 8c980f3 
Dealt to 928a94bb 
Dealt to 99d6d386 
Dealt to Hero [Tc 5d]
928a94bb: folds
99d6d386: folds
Hero: folds
8466ae26: raises $0.38 to $0.63
bc200877: folds
8c980f3: folds
Uncalled bet ($0.38) returned to 8466ae26
*** SHOWDOWN ***
8466ae26 collected $0.6 from pot
*** SUMMARY ***
Total pot $0.6
Seat 1: 8466ae26 (button) collected ($0.6)
Seat 2: bc200877 (small blind) folded before Flop
Seat 3: 8c980f3 (big blind) folded before Flop
Seat 4: 928a94bb folded before Flop (didn't bet)
Seat 5: 99d6d386 folded before Flop (didn't bet)
Seat 6: Hero folded before Flop (didn't bet)


Poker Hand #RC94802477: Hold'em No Limit ($0.1/$0.25) - 2020/04/07 00:00:43
Table 'RushAndCash320684' 6-max Seat #1 is the button
Seat 1: a82639fc ($65.32 in chips)
Seat 2: 90609fad ($59.63 in chips)
Seat 3: 8f2f88a4 ($53.64 in chips)
Seat 4: 2467bb49 ($61.48 in chips)
Seat 5: Hero ($30.25 in chips)
Seat 6: 41ab7510 ($25 in chips)
90609fad: posts small blind $0.1
8f2f88a4: posts big blind $0.25
*** HOLE CARDS ***
Dealt to a82639fc 
Dealt to 90609fad 
Dealt to 8f2f88a4 
Dealt to 2467bb49 
Dealt to Hero [Qc 4s]
Dealt to 41ab7510 
2467bb49: raises $0.38 to $0.63
Hero: folds
41ab7510: folds
a82639fc: folds
90609fad: folds
8f2f88a4: folds
Uncalled bet ($0.38) returned to 2467bb49
*** SHOWDOWN ***
2467bb49 collected $0.6 from pot
*** SUMMARY ***
Total pot $0.6
Seat 1: a82639fc (button) folded before Flop (didn't bet)
Seat 2: 90609fad (small blind) folded before Flop
Seat 3: 8f2f88a4 (big blind) folded before Flop
Seat 4: 2467bb49 collected ($0.6)
Seat 5: Hero folded before Flop (didn't bet)
Seat 6: 41ab7510 folded before Flop (didn't bet)


Poker Hand #RC94802491: Hold'em No Limit ($0.1/$0.25) - 2020/04/07 00:00:46
Table 'RushAndCash320688' 6-max Seat #1 is the button
Seat 1: b00dbb18 ($34.07 in chips)
Seat 2: 99d6d386 ($25.1 in chips)
Seat 3: e58da42d ($34.83 in chips)
Seat 4: d8a224aa ($48.31 in chips)
Seat 5: 522e695b ($13.55 in chips)
Seat 6: Hero ($30.25 in chips)
99d6d386: posts small blind $0.1
e58da42d: posts big blind $0.25
*** HOLE CARDS ***
Dealt to b00dbb18 
Dealt to 99d6d386 
Dealt to e58da42d 
Dealt to d8a224aa 
Dealt to 522e695b 
Dealt to Hero [6c 5c]
d8a224aa: folds
522e695b: raises $0.63 to $0.88
Hero: folds
b00dbb18: raises $1.62 to $2.5
99d6d386: folds
e58da42d: folds
522e695b: calls $1.62
*** FLOP *** [Kc 7d 2d]
522e695b: checks
b00dbb18: bets $2.2
522e695b: folds
Uncalled bet ($2.2) returned to b00dbb18
*** SHOWDOWN ***
b00dbb18 collected $5.35 from pot
*** SUMMARY ***
Total pot $5.35
Board [Kc 7d 2d]
Seat 1: b00dbb18 (button) won ($5.35)
Seat 2: 99d6d386 (small blind) folded before Flop
Seat 3: e58da42d (big blind) folded before Flop
Seat 4: d8a224aa folded before Flop (didn't bet)
Seat 5: 522e695b folded on the Flop
Seat 6: Hero folded before Flop (didn't bet)


Poker Hand #RC94802533: Hold'em No Limit ($0.1/$0.25) - 2020/04/07 00:00:58
Table 'RushAndCash320696' 6-max Seat #1 is the button
Seat 1: 59bcbffa ($29.88 in chips)
Seat 2: 576737c8 ($14.43 in chips)
Seat 3: Hero ($30.25 in chips)
Seat 4: 9b358964 ($25.22 in chips)
Seat 5: b5518434 ($36.71 in chips)
Seat 6: a82639fc ($65.89 in chips)
576737c8: posts small blind $0.1
Hero: posts big blind $0.25
*** HOLE CARDS ***
Dealt to 59bcbffa 
Dealt to 576737c8 
Dealt to Hero [5h 5d]
Dealt to 9b358964 
Dealt to b5518434 
Dealt to a82639fc 
9b358964: raises $0.38 to $0.63
b5518434: folds
a82639fc: folds
59bcbffa: folds
576737c8: folds
Hero: calls $0.38
*** FLOP *** [Qc Kc 6h]
Hero: checks
9b358964: checks
*** TURN *** [Qc Kc 6h] [Kd]
Hero: checks
9b358964: bets $0.5
Hero: folds
Uncalled bet ($0.5) returned to 9b358964
*** SHOWDOWN ***
9b358964 collected $1.36 from pot
*** SUMMARY ***
Total pot $1.36
Board [Qc Kc 6h Kd]
Seat 1: 59bcbffa (button) folded before Flop (didn't bet)
Seat 2: 576737c8 (small blind) folded before Flop
Seat 3: Hero (big blind) folded on the Turn
Seat 4: 9b358964 won ($1.36)
Seat 5: b5518434 folded before Flop (didn't bet)
Seat 6: a82639fc folded before Flop (didn't bet)


Poker Hand #RC94802773: Hold'em No Limit ($0.1/$0.25) - 2020/04/07 00:01:52
Table 'RushAndCash320742' 6-max Seat #1 is the button
Seat 1: 9b358964 ($25.89 in chips)
Seat 2: Hero ($29.62 in chips)
Seat 3: 16bf75ab ($22.77 in chips)
Seat 4: 41ab7510 ($25.1 in chips)
Seat 5: bc200877 ($12.5 in chips)
Seat 6: 2467bb49 ($61.73 in chips)
Hero: posts small blind $0.1
16bf75ab: posts big blind $0.25
*** HOLE CARDS ***
Dealt to 9b358964 
Dealt to Hero [Ts 2d]
Dealt to 16bf75ab 
Dealt to 41ab7510 
Dealt to bc200877 
Dealt to 2467bb49 
41ab7510: folds
bc200877: raises $0.5 to $0.75
2467bb49: folds
9b358964: folds
Hero: folds
16bf75ab: calls $0.5
*** FLOP *** [7c Jc As]
16bf75ab: checks
bc200877: bets $0.6
16bf75ab: folds
Uncalled bet ($0.6) returned to bc200877
*** SHOWDOWN ***
bc200877 collected $1.6 from pot
*** SUMMARY ***
Total pot $1.6
Board [7c Jc As]
Seat 1: 9b358964 (button) folded before Flop (didn't bet)
Seat 2: Hero (small blind) folded before Flop
Seat 3: 16bf75ab (big blind) folded on the Flop
Seat 4: 41ab7510 folded before Flop (didn't bet)
Seat 5: bc200877 won ($1.6)
Seat 6: 2467bb49 folded before Flop (didn't bet)


