Poker Hand #RC95078905: Hold'em No Limit ($0.1/$0.25) - 2020/04/07 15:03:55
Table 'RushAndCash363022' 6-max Seat #1 is the button
Seat 1: 9f803cc2 ($25.25 in chips)
Seat 2: 2d45ce80 ($10.38 in chips)
Seat 3: Hero ($25 in chips)
Seat 4: 29100105 ($25.81 in chips)
Seat 5: 65837850 ($147.15 in chips)
Seat 6: 2609e300 ($13.37 in chips)
2d45ce80: posts small blind $0.1
Hero: posts big blind $0.25
*** HOLE CARDS ***
Dealt to 9f803cc2 
Dealt to 2d45ce80 
Dealt to Hero [7c 6h]
Dealt to 29100105 
Dealt to 65837850 
Dealt to 2609e300 
29100105: folds
65837850: folds
2609e300: folds
9f803cc2: folds
2d45ce80: folds
Uncalled bet ($0.15) returned to Hero
*** SHOWDOWN ***
Hero collected $0.2 from pot
*** SUMMARY ***
Total pot $0.2
Seat 1: 9f803cc2 (button) folded before Flop (didn't bet)
Seat 2: 2d45ce80 (small blind) folded before Flop
Seat 3: Hero (big blind) collected ($0.2)
Seat 4: 29100105 folded before Flop (didn't bet)
Seat 5: 65837850 folded before Flop (didn't bet)
Seat 6: 2609e300 folded before Flop (didn't bet)


Poker Hand #RC95078979: Hold'em No Limit ($0.1/$0.25) - 2020/04/07 15:04:04
Table 'RushAndCash363030' 6-max Seat #1 is the button
Seat 1: 65837850 ($147.15 in chips)
Seat 2: Hero ($25 in chips)
Seat 3: fe3f48f4 ($25.25 in chips)
Seat 4: 45920dbc ($52.5 in chips)
Seat 5: f322483e ($26.38 in chips)
Seat 6: 50ccb9a1 ($23.77 in chips)
Hero: posts small blind $0.1
fe3f48f4: posts big blind $0.25
*** HOLE CARDS ***
Dealt to 65837850 
Dealt to Hero [7h 4c]
Dealt to fe3f48f4 
Dealt to 45920dbc 
Dealt to f322483e 
Dealt to 50ccb9a1 
45920dbc: folds
f322483e: folds
50ccb9a1: folds
65837850: folds
Hero: raises $0.5 to $0.75
fe3f48f4: raises $1.55 to $2.3
Hero: folds
Uncalled bet ($1.55) returned to fe3f48f4
*** SHOWDOWN ***
fe3f48f4 collected $1.5 from pot
*** SUMMARY ***
Total pot $1.5
Seat 1: 65837850 (button) folded before Flop (didn't bet)
Seat 2: Hero (small blind) folded before Flop
Seat 3: fe3f48f4 (big blind) collected ($1.5)
Seat 4: 45920dbc folded before Flop (didn't bet)
Seat 5: f322483e folded before Flop (didn't bet)
Seat 6: 50ccb9a1 folded before Flop (didn't bet)


Poker Hand #RC95079165: Hold'em No Limit ($0.1/$0.25) - 2020/04/07 15:04:27
Table 'RushAndCash363049' 6-max Seat #1 is the button
Seat 1: Hero ($25.35 in chips)
Seat 2: 2dd038c3 ($11.5 in chips)
Seat 3: f322483e ($26.28 in chips)
Seat 4: fe3f48f4 ($25.93 in chips)
Seat 5: 62eebc49 ($107.62 in chips)
Seat 6: 2c9e9ffe ($18.52 in chips)
2dd038c3: posts small blind $0.1
f322483e: posts big blind $0.25
*** HOLE CARDS ***
Dealt to Hero [7c 5h]
Dealt to 2dd038c3 
Dealt to f322483e 
Dealt to fe3f48f4 
Dealt to 62eebc49 
Dealt to 2c9e9ffe 
fe3f48f4: folds
62eebc49: folds
2c9e9ffe: folds
Hero: folds
2dd038c3: folds
Uncalled bet ($0.15) returned to f322483e
*** SHOWDOWN ***
f322483e collected $0.2 from pot
*** SUMMARY ***
Total pot $0.2
Seat 1: Hero (button) folded before Flop (didn't bet)
Seat 2: 2dd038c3 (small blind) folded before Flop
Seat 3: f322483e (big blind) collected ($0.2)
Seat 4: fe3f48f4 folded before Flop (didn't bet)
Seat 5: 62eebc49 folded before Flop (didn't bet)
Seat 6: 2c9e9ffe folded before Flop (didn't bet)


Poker Hand #RC95079208: Hold'em No Limit ($0.1/$0.25) - 2020/04/07 15:04:32
Table 'RushAndCash363054' 6-max Seat #1 is the button
Seat 1: fe3f48f4 ($25.93 in chips)
Seat 2: 9f803cc2 ($25.35 in chips)
Seat 3: da0bf932 ($12 in chips)
Seat 4: Hero ($25.35 in chips)
Seat 5: fc8a29ea ($69.67 in chips)
Seat 6: 704c37d9 ($57.66 in chips)
9f803cc2: posts small blind $0.1
da0bf932: posts big blind $0.25
*** HOLE CARDS ***
Dealt to fe3f48f4 
Dealt to 9f803cc2 
Dealt to da0bf932 
Dealt to Hero [4s 2h]
Dealt to fc8a29ea 
Dealt to 704c37d9 
Hero: folds
fc8a29ea: folds
704c37d9: folds
fe3f48f4: folds
9f803cc2: raises $0.5 to $0.75
da0bf932: folds
Uncalled bet ($0.5) returned to 9f803cc2
*** SHOWDOWN ***
9f803cc2 collected $0.5 from pot
*** SUMMARY ***
Total pot $0.5
Seat 1: fe3f48f4 (button) folded before Flop (didn't bet)
Seat 2: 9f803cc2 (small blind) collected ($0.5)
Seat 3: da0bf932 (big blind) folded before Flop
Seat 4: Hero folded before Flop (didn't bet)
Seat 5: fc8a29ea folded before Flop (didn't bet)
Seat 6: 704c37d9 folded before Flop (didn't bet)


Poker Hand #RC95079302: Hold'em No Limit ($0.1/$0.25) - 2020/04/07 15:04:42
Table 'RushAndCash363066' 6-max Seat #1 is the button
Seat 1: bbb85b3f ($29.59 in chips)
Seat 2: f685ff74 ($80.13 in chips)
Seat 3: 6d46dd9d ($25.54 in chips)
Seat 4: Hero ($25.35 in chips)
Seat 5: bec2d88d ($25.26 in chips)
Seat 6: 96eec3de ($35.24 in chips)
f685ff74: posts small blind $0.1
6d46dd9d: posts big blind $0.25
*** HOLE CARDS ***
Dealt to bbb85b3f 
Dealt to f685ff74 
Dealt to 6d46dd9d 
Dealt to Hero [Tc 2d]
Dealt to bec2d88d 
Dealt to 96eec3de 
Hero: folds
bec2d88d: folds
96eec3de: raises $0.38 to $0.63
bbb85b3f: folds
f685ff74: calls $0.53
6d46dd9d: folds
*** FLOP *** [Th Ts 8d]
f685ff74: checks
96eec3de: checks
*** TURN *** [Th Ts 8d] [5s]
f685ff74: bets $0.8
96eec3de: calls $0.8
*** RIVER *** [Th Ts 8d 5s] [Qs]
f685ff74: checks
96eec3de: checks
f685ff74: shows [6c 6s] (Pair of Tens and Pair of Sixes)
96eec3de: shows [9c 9s] (Pair of Tens and Pair of Nines)
*** SHOWDOWN ***
96eec3de collected $3.11 from pot
*** SUMMARY ***
Total pot $3.11
Board [Th Ts 8d 5s Qs]
Seat 1: bbb85b3f (button) folded before Flop (didn't bet)
Seat 2: f685ff74 (small blind) showed [6s 6c] and lost with Pair of Tens and Pair of Sixes
Seat 3: 6d46dd9d (big blind) folded before Flop
Seat 4: Hero folded before Flop (didn't bet)
Seat 5: bec2d88d folded before Flop (didn't bet)
Seat 6: 96eec3de showed [9s 9c] and won ($3.11) with Pair of Tens and Pair of Nines


Poker Hand #RC95079335: Hold'em No Limit ($0.1/$0.25) - 2020/04/07 15:04:46
Table 'RushAndCash363070' 6-max Seat #1 is the button
Seat 1: 2609e300 ($13.02 in chips)
Seat 2: 50ccb9a1 ($23.87 in chips)
Seat 3: accea393 ($40.81 in chips)
Seat 4: Hero ($25.35 in chips)
Seat 5: 605bdd57 ($12.5 in chips)
Seat 6: d84d476b ($27.36 in chips)
50ccb9a1: posts small blind $0.1
accea393: posts big blind $0.25
*** HOLE CARDS ***
Dealt to 2609e300 
Dealt to 50ccb9a1 
Dealt to accea393 
Dealt to Hero [4h 2d]
Dealt to 605bdd57 
Dealt to d84d476b 
Hero: folds
605bdd57: folds
d84d476b: folds
2609e300: folds
50ccb9a1: raises $0.5 to $0.75
accea393: folds
Uncalled bet ($0.5) returned to 50ccb9a1
*** SHOWDOWN ***
50ccb9a1 collected $0.5 from pot
*** SUMMARY ***
Total pot $0.5
Seat 1: 2609e300 (button) folded before Flop (didn't bet)
Seat 2: 50ccb9a1 (small blind) collected ($0.5)
Seat 3: accea393 (big blind) folded before Flop
Seat 4: Hero folded before Flop (didn't bet)
Seat 5: 605bdd57 folded before Flop (didn't bet)
Seat 6: d84d476b folded before Flop (didn't bet)


Poker Hand #RC95079364: Hold'em No Limit ($0.1/$0.25) - 2020/04/07 15:04:49
Table 'RushAndCash363073' 6-max Seat #1 is the button
Seat 1: 36017ad1 ($26.04 in chips)
Seat 2: accea393 ($40.56 in chips)
Seat 3: bfa55601 ($12.5 in chips)
Seat 4: cae4d8ce ($12 in chips)
Seat 5: 45920dbc ($52.75 in chips)
Seat 6: Hero ($25.35 in chips)
accea393: posts small blind $0.1
bfa55601: posts big blind $0.25
*** HOLE CARDS ***
Dealt to 36017ad1 
Dealt to accea393 
Dealt to bfa55601 
Dealt to cae4d8ce 
Dealt to 45920dbc 
Dealt to Hero [9s 4c]
cae4d8ce: folds
45920dbc: folds
Hero: folds
36017ad1: raises $0.38 to $0.63
accea393: folds
bfa55601: folds
Uncalled bet ($0.38) returned to 36017ad1
*** SHOWDOWN ***
36017ad1 collected $0.6 from pot
*** SUMMARY ***
Total pot $0.6
Seat 1: 36017ad1 (button) collected ($0.6)
Seat 2: accea393 (small blind) folded before Flop
Seat 3: bfa55601 (big blind) folded before Flop
Seat 4: cae4d8ce folded before Flop (didn't bet)
Seat 5: 45920dbc folded before Flop (didn't bet)
Seat 6: Hero folded before Flop (didn't bet)


Poker Hand #RC95079397: Hold'em No Limit ($0.1/$0.25) - 2020/04/07 15:04:54
Table 'RushAndCash363077' 6-max Seat #1 is the button
Seat 1: cae4d8ce ($12 in chips)
Seat 2: d80f1bfd ($12.95 in chips)
Seat 3: Hero ($25.35 in chips)
Seat 4: 79cc211c ($25.35 in chips)
Seat 5: d84d476b ($27.36 in chips)
Seat 6: d07b3de1 ($25.68 in chips)
d80f1bfd: posts small blind $0.1
Hero: posts big blind $0.25
*** HOLE CARDS ***
Dealt to cae4d8ce 
Dealt to d80f1bfd 
Dealt to Hero [9d 3c]
Dealt to 79cc211c 
Dealt to d84d476b 
Dealt to d07b3de1 
79cc211c: folds
d84d476b: raises $0.38 to $0.63
d07b3de1: raises $1.49 to $2.12
cae4d8ce: folds
d80f1bfd: folds
Hero: folds
d84d476b: raises $3.88 to $6
d07b3de1: raises $19.68 to $25.68 and is all-in
d84d476b: folds
Uncalled bet ($19.68) returned to d07b3de1
*** SHOWDOWN ***
d07b3de1 collected $12.35 from pot
*** SUMMARY ***
Total pot $12.35
Seat 1: cae4d8ce (button) folded before Flop (didn't bet)
Seat 2: d80f1bfd (small blind) folded before Flop
Seat 3: Hero (big blind) folded before Flop
Seat 4: 79cc211c folded before Flop (didn't bet)
Seat 5: d84d476b folded before Flop
Seat 6: d07b3de1 collected ($12.35)


Poker Hand #RC95079465: Hold'em No Limit ($0.1/$0.25) - 2020/04/07 15:05:03
Table 'RushAndCash363087' 6-max Seat #1 is the button
Seat 1: acf1a889 ($17.27 in chips)
Seat 2: Hero ($25.1 in chips)
Seat 3: d2986703 ($32.35 in chips)
Seat 4: 466b8e5e ($12.6 in chips)
Seat 5: f322483e ($27.39 in chips)
Seat 6: 3cfd7308 ($31.78 in chips)
Hero: posts small blind $0.1
d2986703: posts big blind $0.25
*** HOLE CARDS ***
Dealt to acf1a889 
Dealt to Hero [Jc 5c]
Dealt to d2986703 
Dealt to 466b8e5e 
Dealt to f322483e 
Dealt to 3cfd7308 
466b8e5e: folds
f322483e: folds
3cfd7308: folds
acf1a889: folds
Hero: folds
Uncalled bet ($0.15) returned to d2986703
*** SHOWDOWN ***
d2986703 collected $0.2 from pot
*** SUMMARY ***
Total pot $0.2
Seat 1: acf1a889 (button) folded before Flop (didn't bet)
Seat 2: Hero (small blind) folded before Flop
Seat 3: d2986703 (big blind) collected ($0.2)
Seat 4: 466b8e5e folded before Flop (didn't bet)
Seat 5: f322483e folded before Flop (didn't bet)
Seat 6: 3cfd7308 folded before Flop (didn't bet)


Poker Hand #RC95079496: Hold'em No Limit ($0.1/$0.25) - 2020/04/07 15:05:07
Table 'RushAndCash363091' 6-max Seat #1 is the button
Seat 1: Hero ($25 in chips)
Seat 2: 887f8eab ($7.7 in chips)
Seat 3: 74937d40 ($36.52 in chips)
Seat 4: 3ff56a6c ($27.48 in chips)
Seat 5: 50ccb9a1 ($24.12 in chips)
Seat 6: 181171f9 ($60.58 in chips)
887f8eab: posts small blind $0.1
74937d40: posts big blind $0.25
*** HOLE CARDS ***
Dealt to Hero [Qs Jc]
Dealt to 887f8eab 
Dealt to 74937d40 
Dealt to 3ff56a6c 
Dealt to 50ccb9a1 
Dealt to 181171f9 
3ff56a6c: folds
50ccb9a1: folds
181171f9: folds
Hero: raises $0.38 to $0.63
887f8eab: folds
74937d40: folds
Uncalled bet ($0.38) returned to Hero
*** SHOWDOWN ***
Hero collected $0.6 from pot
*** SUMMARY ***
Total pot $0.6
Seat 1: Hero (button) collected ($0.6)
Seat 2: 887f8eab (small blind) folded before Flop
Seat 3: 74937d40 (big blind) folded before Flop
Seat 4: 3ff56a6c folded before Flop (didn't bet)
Seat 5: 50ccb9a1 folded before Flop (didn't bet)
Seat 6: 181171f9 folded before Flop (didn't bet)


Poker Hand #RC95079642: Hold'em No Limit ($0.1/$0.25) - 2020/04/07 15:05:26
Table 'RushAndCash363110' 6-max Seat #1 is the button
Seat 1: 90ddca47 ($25.11 in chips)
Seat 2: b5d592d2 ($11.54 in chips)
Seat 3: 32953d2a ($13.4 in chips)
Seat 4: d2986703 ($32.45 in chips)
Seat 5: 18075352 ($27.14 in chips)
Seat 6: Hero ($25.35 in chips)
b5d592d2: posts small blind $0.1
32953d2a: posts big blind $0.25
*** HOLE CARDS ***
Dealt to 90ddca47 
Dealt to b5d592d2 
Dealt to 32953d2a 
Dealt to d2986703 
Dealt to 18075352 
Dealt to Hero [Jc 7c]
d2986703: folds
18075352: folds
Hero: raises $0.38 to $0.63
90ddca47: folds
b5d592d2: folds
32953d2a: folds
Uncalled bet ($0.38) returned to Hero
*** SHOWDOWN ***
Hero collected $0.6 from pot
*** SUMMARY ***
Total pot $0.6
Seat 1: 90ddca47 (button) folded before Flop (didn't bet)
Seat 2: b5d592d2 (small blind) folded before Flop
Seat 3: 32953d2a (big blind) folded before Flop
Seat 4: d2986703 folded before Flop (didn't bet)
Seat 5: 18075352 folded before Flop (didn't bet)
Seat 6: Hero collected ($0.6)


Poker Hand #RC95079835: Hold'em No Limit ($0.1/$0.25) - 2020/04/07 15:05:53
Table 'RushAndCash363136' 6-max Seat #1 is the button
Seat 1: 5794e88f ($26.01 in chips)
Seat 2: 7ed3ab6b ($44.93 in chips)
Seat 3: 528a07f8 ($33.28 in chips)
Seat 4: 2609e300 ($12.84 in chips)
Seat 5: 476775f5 ($14.67 in chips)
Seat 6: Hero ($25.7 in chips)
7ed3ab6b: posts small blind $0.1
528a07f8: posts big blind $0.25
*** HOLE CARDS ***
Dealt to 5794e88f 
Dealt to 7ed3ab6b 
Dealt to 528a07f8 
Dealt to 2609e300 
Dealt to 476775f5 
Dealt to Hero [Ad 8d]
2609e300: folds
476775f5: folds
Hero: raises $0.38 to $0.63
5794e88f: folds
7ed3ab6b: folds
528a07f8: folds
Uncalled bet ($0.38) returned to Hero
*** SHOWDOWN ***
Hero collected $0.6 from pot
*** SUMMARY ***
Total pot $0.6
Seat 1: 5794e88f (button) folded before Flop (didn't bet)
Seat 2: 7ed3ab6b (small blind) folded before Flop
Seat 3: 528a07f8 (big blind) folded before Flop
Seat 4: 2609e300 folded before Flop (didn't bet)
Seat 5: 476775f5 folded before Flop (didn't bet)
Seat 6: Hero collected ($0.6)


Poker Hand #RC95080015: Hold'em No Limit ($0.1/$0.25) - 2020/04/07 15:06:13
Table 'RushAndCash363165' 6-max Seat #1 is the button
Seat 1: 528a07f8 ($33.03 in chips)
Seat 2: 62eebc49 ($109.22 in chips)
Seat 3: 41064a47 ($12.5 in chips)
Seat 4: a4ba858f ($25 in chips)
Seat 5: Hero ($26.05 in chips)
Seat 6: 53486dcf ($11.65 in chips)
62eebc49: posts small blind $0.1
41064a47: posts big blind $0.25
*** HOLE CARDS ***
Dealt to 528a07f8 
Dealt to 62eebc49 
Dealt to 41064a47 
Dealt to a4ba858f 
Dealt to Hero [7h 5d]
Dealt to 53486dcf 
a4ba858f: folds
Hero: folds
53486dcf: folds
528a07f8: folds
62eebc49: calls $0.15
41064a47: checks
*** FLOP *** [2h Kc 4s]
62eebc49: bets $0.25
41064a47: folds
Uncalled bet ($0.25) returned to 62eebc49
*** SHOWDOWN ***
62eebc49 collected $0.5 from pot
*** SUMMARY ***
Total pot $0.5
Board [2h Kc 4s]
Seat 1: 528a07f8 (button) folded before Flop (didn't bet)
Seat 2: 62eebc49 (small blind) won ($0.5)
Seat 3: 41064a47 (big blind) folded on the Flop
Seat 4: a4ba858f folded before Flop (didn't bet)
Seat 5: Hero folded before Flop (didn't bet)
Seat 6: 53486dcf folded before Flop (didn't bet)


Poker Hand #RC95080051: Hold'em No Limit ($0.1/$0.25) - 2020/04/07 15:06:18
Table 'RushAndCash363170' 6-max Seat #1 is the button
Seat 1: 45920dbc ($52.75 in chips)
Seat 2: Hero ($26.05 in chips)
Seat 3: a4ba858f ($25 in chips)
Seat 4: 7c935d24 ($25 in chips)
Seat 5: 8c86f461 ($32.27 in chips)
Seat 6: 53486dcf ($11.65 in chips)
Hero: posts small blind $0.1
a4ba858f: posts big blind $0.25
*** HOLE CARDS ***
Dealt to 45920dbc 
Dealt to Hero [Jc 6s]
Dealt to a4ba858f 
Dealt to 7c935d24 
Dealt to 8c86f461 
Dealt to 53486dcf 
7c935d24: folds
8c86f461: raises $0.38 to $0.63
53486dcf: folds
45920dbc: folds
Hero: folds
a4ba858f: folds
Uncalled bet ($0.38) returned to 8c86f461
*** SHOWDOWN ***
8c86f461 collected $0.6 from pot
*** SUMMARY ***
Total pot $0.6
Seat 1: 45920dbc (button) folded before Flop (didn't bet)
Seat 2: Hero (small blind) folded before Flop
Seat 3: a4ba858f (big blind) folded before Flop
Seat 4: 7c935d24 folded before Flop (didn't bet)
Seat 5: 8c86f461 collected ($0.6)
Seat 6: 53486dcf folded before Flop (didn't bet)


Poker Hand #RC95080095: Hold'em No Limit ($0.1/$0.25) - 2020/04/07 15:06:23
Table 'RushAndCash363177' 6-max Seat #1 is the button
Seat 1: 2d45ce80 ($9.58 in chips)
Seat 2: a4ba858f ($25 in chips)
Seat 3: Hero ($25.95 in chips)
Seat 4: ce59b684 ($35.09 in chips)
Seat 5: dbf6981f ($41.57 in chips)
Seat 6: caa68458 ($25.35 in chips)
a4ba858f: posts small blind $0.1
Hero: posts big blind $0.25
*** HOLE CARDS ***
Dealt to 2d45ce80 
Dealt to a4ba858f 
Dealt to Hero [8c 3h]
Dealt to ce59b684 
Dealt to dbf6981f 
Dealt to caa68458 
ce59b684: folds
dbf6981f: folds
caa68458: folds
2d45ce80: folds
a4ba858f: raises $0.5 to $0.75
Hero: folds
Uncalled bet ($0.5) returned to a4ba858f
*** SHOWDOWN ***
a4ba858f collected $0.5 from pot
*** SUMMARY ***
Total pot $0.5
Seat 1: 2d45ce80 (button) folded before Flop (didn't bet)
Seat 2: a4ba858f (small blind) collected ($0.5)
Seat 3: Hero (big blind) folded before Flop
Seat 4: ce59b684 folded before Flop (didn't bet)
Seat 5: dbf6981f folded before Flop (didn't bet)
Seat 6: caa68458 folded before Flop (didn't bet)


Poker Hand #RC95080126: Hold'em No Limit ($0.1/$0.25) - 2020/04/07 15:06:26
Table 'RushAndCash363181' 6-max Seat #1 is the button
Seat 1: Hero ($25.7 in chips)
Seat 2: 3cfd7308 ($31.78 in chips)
Seat 3: af84e661 ($12.2 in chips)
Seat 4: cb835642 ($29.68 in chips)
Seat 5: 6d46dd9d ($25.1 in chips)
Seat 6: 466b8e5e ($12.85 in chips)
3cfd7308: posts small blind $0.1
af84e661: posts big blind $0.25
*** HOLE CARDS ***
Dealt to Hero [Kh 5c]
Dealt to 3cfd7308 
Dealt to af84e661 
Dealt to cb835642 
Dealt to 6d46dd9d 
Dealt to 466b8e5e 
cb835642: folds
6d46dd9d: raises $0.5 to $0.75
466b8e5e: folds
Hero: folds
3cfd7308: folds
af84e661: folds
Uncalled bet ($0.5) returned to 6d46dd9d
*** SHOWDOWN ***
6d46dd9d collected $0.6 from pot
*** SUMMARY ***
Total pot $0.6
Seat 1: Hero (button) folded before Flop (didn't bet)
Seat 2: 3cfd7308 (small blind) folded before Flop
Seat 3: af84e661 (big blind) folded before Flop
Seat 4: cb835642 folded before Flop (didn't bet)
Seat 5: 6d46dd9d collected ($0.6)
Seat 6: 466b8e5e folded before Flop (didn't bet)


Poker Hand #RC95080159: Hold'em No Limit ($0.1/$0.25) - 2020/04/07 15:06:31
Table 'RushAndCash363185' 6-max Seat #1 is the button
Seat 1: cb835642 ($29.68 in chips)
Seat 2: 3ff56a6c ($25 in chips)
Seat 3: 20b62793 ($67.51 in chips)
Seat 4: 41064a47 ($12.5 in chips)
Seat 5: Hero ($25.7 in chips)
Seat 6: 18075352 ($27.14 in chips)
3ff56a6c: posts small blind $0.1
20b62793: posts big blind $0.25
*** HOLE CARDS ***
Dealt to cb835642 
Dealt to 3ff56a6c 
Dealt to 20b62793 
Dealt to 41064a47 
Dealt to Hero [7d 6d]
Dealt to 18075352 
41064a47: folds
Hero: raises $0.38 to $0.63
18075352: folds
cb835642: folds
3ff56a6c: folds
20b62793: calls $0.38
*** FLOP *** [3s 7h 7s]
20b62793: bets $1.1
Hero: raises $1.2 to $2.3
20b62793: calls $1.2
*** TURN *** [3s 7h 7s] [Ah]
20b62793: bets $2
Hero: raises $7.5 to $9.5
20b62793: folds
Uncalled bet ($7.5) returned to Hero
*** SHOWDOWN ***
Hero collected $9.96 from pot
*** SUMMARY ***
Total pot $9.96
Board [3s 7h 7s Ah]
Seat 1: cb835642 (button) folded before Flop (didn't bet)
Seat 2: 3ff56a6c (small blind) folded before Flop
Seat 3: 20b62793 (big blind) folded on the Turn
Seat 4: 41064a47 folded before Flop (didn't bet)
Seat 5: Hero won ($9.96)
Seat 6: 18075352 folded before Flop (didn't bet)


Poker Hand #RC95080498: Hold'em No Limit ($0.1/$0.25) - 2020/04/07 15:07:15
Table 'RushAndCash363234' 6-max Seat #1 is the button
Seat 1: 7ed3ab6b ($44.48 in chips)
Seat 2: 2dd038c3 ($8.04 in chips)
Seat 3: ace893c0 ($25 in chips)
Seat 4: Hero ($29.99 in chips)
Seat 5: 9a31a923 ($12.5 in chips)
Seat 6: d84d476b ($25.57 in chips)
2dd038c3: posts small blind $0.1
ace893c0: posts big blind $0.25
*** HOLE CARDS ***
Dealt to 7ed3ab6b 
Dealt to 2dd038c3 
Dealt to ace893c0 
Dealt to Hero [7c 4s]
Dealt to 9a31a923 
Dealt to d84d476b 
Hero: folds
9a31a923: folds
d84d476b: folds
7ed3ab6b: raises $0.38 to $0.63
2dd038c3: folds
ace893c0: folds
Uncalled bet ($0.38) returned to 7ed3ab6b
*** SHOWDOWN ***
7ed3ab6b collected $0.6 from pot
*** SUMMARY ***
Total pot $0.6
Seat 1: 7ed3ab6b (button) collected ($0.6)
Seat 2: 2dd038c3 (small blind) folded before Flop
Seat 3: ace893c0 (big blind) folded before Flop
Seat 4: Hero folded before Flop (didn't bet)
Seat 5: 9a31a923 folded before Flop (didn't bet)
Seat 6: d84d476b folded before Flop (didn't bet)


Poker Hand #RC95080522: Hold'em No Limit ($0.1/$0.25) - 2020/04/07 15:07:18
Table 'RushAndCash363238' 6-max Seat #1 is the button
Seat 1: ba64e1 ($11.3 in chips)
Seat 2: 18075352 ($27.24 in chips)
Seat 3: dbf6981f ($40.94 in chips)
Seat 4: accea393 ($41.02 in chips)
Seat 5: 704c37d9 ($57.86 in chips)
Seat 6: Hero ($29.99 in chips)
18075352: posts small blind $0.1
dbf6981f: posts big blind $0.25
*** HOLE CARDS ***
Dealt to ba64e1 
Dealt to 18075352 
Dealt to dbf6981f 
Dealt to accea393 
Dealt to 704c37d9 
Dealt to Hero [Ad 4s]
accea393: raises $0.5 to $0.75
704c37d9: folds
Hero: folds
ba64e1: folds
18075352: folds
dbf6981f: folds
Uncalled bet ($0.5) returned to accea393
*** SHOWDOWN ***
accea393 collected $0.6 from pot
*** SUMMARY ***
Total pot $0.6
Seat 1: ba64e1 (button) folded before Flop (didn't bet)
Seat 2: 18075352 (small blind) folded before Flop
Seat 3: dbf6981f (big blind) folded before Flop
Seat 4: accea393 collected ($0.6)
Seat 5: 704c37d9 folded before Flop (didn't bet)
Seat 6: Hero folded before Flop (didn't bet)


Poker Hand #RC95080547: Hold'em No Limit ($0.1/$0.25) - 2020/04/07 15:07:21
Table 'RushAndCash363242' 6-max Seat #1 is the button
Seat 1: 79cc211c ($24.22 in chips)
Seat 2: ace893c0 ($24.75 in chips)
Seat 3: Hero ($29.99 in chips)
Seat 4: 704a7fcf ($29.41 in chips)
Seat 5: 528a07f8 ($33.13 in chips)
Seat 6: d80f1bfd ($12.5 in chips)
ace893c0: posts small blind $0.1
Hero: posts big blind $0.25
*** HOLE CARDS ***
Dealt to 79cc211c 
Dealt to ace893c0 
Dealt to Hero [Ad Js]
Dealt to 704a7fcf 
Dealt to 528a07f8 
Dealt to d80f1bfd 
704a7fcf: folds
528a07f8: folds
d80f1bfd: folds
79cc211c: folds
ace893c0: folds
Uncalled bet ($0.15) returned to Hero
*** SHOWDOWN ***
Hero collected $0.2 from pot
*** SUMMARY ***
Total pot $0.2
Seat 1: 79cc211c (button) folded before Flop (didn't bet)
Seat 2: ace893c0 (small blind) folded before Flop
Seat 3: Hero (big blind) collected ($0.2)
Seat 4: 704a7fcf folded before Flop (didn't bet)
Seat 5: 528a07f8 folded before Flop (didn't bet)
Seat 6: d80f1bfd folded before Flop (didn't bet)


Poker Hand #RC95080641: Hold'em No Limit ($0.1/$0.25) - 2020/04/07 15:07:31
Table 'RushAndCash363256' 6-max Seat #1 is the button
Seat 1: da0bf932 ($13.99 in chips)
Seat 2: Hero ($30.09 in chips)
Seat 3: 2c9e9ffe ($18.99 in chips)
Seat 4: 7c935d24 ($26.47 in chips)
Seat 5: 476775f5 ($14.81 in chips)
Seat 6: 704c37d9 ($57.86 in chips)
Hero: posts small blind $0.1
2c9e9ffe: posts big blind $0.25
*** HOLE CARDS ***
Dealt to da0bf932 
Dealt to Hero [7c 6h]
Dealt to 2c9e9ffe 
Dealt to 7c935d24 
Dealt to 476775f5 
Dealt to 704c37d9 
7c935d24: folds
476775f5: folds
704c37d9: raises $0.38 to $0.63
da0bf932: raises $1.37 to $2
Hero: folds
2c9e9ffe: folds
704c37d9: calls $1.37
*** FLOP *** [5d 8d As]
704c37d9: checks
da0bf932: bets $3.3
704c37d9: folds
Uncalled bet ($3.3) returned to da0bf932
*** SHOWDOWN ***
da0bf932 collected $4.35 from pot
*** SUMMARY ***
Total pot $4.35
Board [5d 8d As]
Seat 1: da0bf932 (button) won ($4.35)
Seat 2: Hero (small blind) folded before Flop
Seat 3: 2c9e9ffe (big blind) folded before Flop
Seat 4: 7c935d24 folded before Flop (didn't bet)
Seat 5: 476775f5 folded before Flop (didn't bet)
Seat 6: 704c37d9 folded on the Flop


Poker Hand #RC95080671: Hold'em No Limit ($0.1/$0.25) - 2020/04/07 15:07:35
Table 'RushAndCash363262' 6-max Seat #1 is the button
Seat 1: a2f2938c ($32.47 in chips)
Seat 2: a6fc3bd6 ($28.87 in chips)
Seat 3: 966446c2 ($22.66 in chips)
Seat 4: 103129d8 ($23.32 in chips)
Seat 5: Hero ($29.99 in chips)
Seat 6: d59ed63d ($11.37 in chips)
a6fc3bd6: posts small blind $0.1
966446c2: posts big blind $0.25
*** HOLE CARDS ***
Dealt to a2f2938c 
Dealt to a6fc3bd6 
Dealt to 966446c2 
Dealt to 103129d8 
Dealt to Hero [Js 9h]
Dealt to d59ed63d 
103129d8: folds
Hero: folds
d59ed63d: folds
a2f2938c: raises $0.38 to $0.63
a6fc3bd6: raises $1.87 to $2.5
966446c2: folds
a2f2938c: raises $3.87 to $6.37
a6fc3bd6: folds
Uncalled bet ($3.87) returned to a2f2938c
*** SHOWDOWN ***
a2f2938c collected $5.25 from pot
*** SUMMARY ***
Total pot $5.25
Seat 1: a2f2938c (button) collected ($5.25)
Seat 2: a6fc3bd6 (small blind) folded before Flop
Seat 3: 966446c2 (big blind) folded before Flop
Seat 4: 103129d8 folded before Flop (didn't bet)
Seat 5: Hero folded before Flop (didn't bet)
Seat 6: d59ed63d folded before Flop (didn't bet)


Poker Hand #RC95080701: Hold'em No Limit ($0.1/$0.25) - 2020/04/07 15:07:39
Table 'RushAndCash363265' 6-max Seat #1 is the button
Seat 1: 4dd920ba ($25 in chips)
Seat 2: e1071a91 ($24.22 in chips)
Seat 3: 605bdd57 ($12.5 in chips)
Seat 4: 9f803cc2 ($26.17 in chips)
Seat 5: dbf6981f ($40.69 in chips)
Seat 6: Hero ($29.99 in chips)
e1071a91: posts small blind $0.1
605bdd57: posts big blind $0.25
*** HOLE CARDS ***
Dealt to 4dd920ba 
Dealt to e1071a91 
Dealt to 605bdd57 
Dealt to 9f803cc2 
Dealt to dbf6981f 
Dealt to Hero [2h 2c]
9f803cc2: folds
dbf6981f: folds
Hero: raises $0.38 to $0.63
4dd920ba: folds
e1071a91: folds
605bdd57: folds
Uncalled bet ($0.38) returned to Hero
*** SHOWDOWN ***
Hero collected $0.6 from pot
*** SUMMARY ***
Total pot $0.6
Seat 1: 4dd920ba (button) folded before Flop (didn't bet)
Seat 2: e1071a91 (small blind) folded before Flop
Seat 3: 605bdd57 (big blind) folded before Flop
Seat 4: 9f803cc2 folded before Flop (didn't bet)
Seat 5: dbf6981f folded before Flop (didn't bet)
Seat 6: Hero collected ($0.6)


Poker Hand #RC95080892: Hold'em No Limit ($0.1/$0.25) - 2020/04/07 15:08:03
Table 'RushAndCash363292' 6-max Seat #1 is the button
Seat 1: Hero ($30.34 in chips)
Seat 2: bbb85b3f ($25.68 in chips)
Seat 3: 466b8e5e ($12.5 in chips)
Seat 4: cb835642 ($28.05 in chips)
Seat 5: ba64e1 ($12.7 in chips)
Seat 6: e1071a91 ($24.12 in chips)
bbb85b3f: posts small blind $0.1
466b8e5e: posts big blind $0.25
*** HOLE CARDS ***
Dealt to Hero [Ac Qh]
Dealt to bbb85b3f 
Dealt to 466b8e5e 
Dealt to cb835642 
Dealt to ba64e1 
Dealt to e1071a91 
cb835642: folds
ba64e1: raises $0.25 to $0.5
e1071a91: folds
Hero: raises $1.55 to $2.05
bbb85b3f: folds
466b8e5e: folds
ba64e1: folds
Uncalled bet ($1.55) returned to Hero
*** SHOWDOWN ***
Hero collected $1.35 from pot
*** SUMMARY ***
Total pot $1.35
Seat 1: Hero (button) collected ($1.35)
Seat 2: bbb85b3f (small blind) folded before Flop
Seat 3: 466b8e5e (big blind) folded before Flop
Seat 4: cb835642 folded before Flop (didn't bet)
Seat 5: ba64e1 folded before Flop
Seat 6: e1071a91 folded before Flop (didn't bet)


Poker Hand #RC95081133: Hold'em No Limit ($0.1/$0.25) - 2020/04/07 15:08:31
Table 'RushAndCash363329' 6-max Seat #1 is the button
Seat 1: 96eec3de ($36.69 in chips)
Seat 2: d07b3de1 ($30.52 in chips)
Seat 3: ace893c0 ($25.9 in chips)
Seat 4: dbf6981f ($42.35 in chips)
Seat 5: 704c37d9 ($55.76 in chips)
Seat 6: Hero ($31.13 in chips)
d07b3de1: posts small blind $0.1
ace893c0: posts big blind $0.25
*** HOLE CARDS ***
Dealt to 96eec3de 
Dealt to d07b3de1 
Dealt to ace893c0 
Dealt to dbf6981f 
Dealt to 704c37d9 
Dealt to Hero [9c 3h]
dbf6981f: folds
704c37d9: raises $0.38 to $0.63
Hero: folds
96eec3de: calls $0.63
d07b3de1: folds
ace893c0: folds
*** FLOP *** [2s 8d 2c]
704c37d9: checks
96eec3de: checks
*** TURN *** [2s 8d 2c] [4h]
704c37d9: checks
96eec3de: bets $0.9
704c37d9: calls $0.9
*** RIVER *** [2s 8d 2c 4h] [Ts]
704c37d9: checks
96eec3de: bets $0.95
704c37d9: folds
Uncalled bet ($0.95) returned to 96eec3de
*** SHOWDOWN ***
96eec3de collected $3.41 from pot
*** SUMMARY ***
Total pot $3.41
Board [2s 8d 2c 4h Ts]
Seat 1: 96eec3de (button) won ($3.41)
Seat 2: d07b3de1 (small blind) folded before Flop
Seat 3: ace893c0 (big blind) folded before Flop
Seat 4: dbf6981f folded before Flop (didn't bet)
Seat 5: 704c37d9 folded on the River
Seat 6: Hero folded before Flop (didn't bet)


Poker Hand #RC95081173: Hold'em No Limit ($0.1/$0.25) - 2020/04/07 15:08:36
Table 'RushAndCash363335' 6-max Seat #1 is the button
Seat 1: b5d592d2 ($12.26 in chips)
Seat 2: deb69778 ($31.88 in chips)
Seat 3: Hero ($31.13 in chips)
Seat 4: dbf6981f ($42.35 in chips)
Seat 5: 7bf7c8c9 ($28.61 in chips)
Seat 6: 3f5f9735 ($19 in chips)
deb69778: posts small blind $0.1
Hero: posts big blind $0.25
*** HOLE CARDS ***
Dealt to b5d592d2 
Dealt to deb69778 
Dealt to Hero [5h 5d]
Dealt to dbf6981f 
Dealt to 7bf7c8c9 
Dealt to 3f5f9735 
dbf6981f: folds
7bf7c8c9: folds
3f5f9735: folds
b5d592d2: folds
deb69778: raises $0.5 to $0.75
Hero: calls $0.5
*** FLOP *** [9d Qc 2d]
deb69778: checks
Hero: checks
*** TURN *** [9d Qc 2d] [Js]
deb69778: checks
Hero: bets $1.2
deb69778: folds
Uncalled bet ($1.2) returned to Hero
*** SHOWDOWN ***
Hero collected $1.5 from pot
*** SUMMARY ***
Total pot $1.5
Board [9d Qc 2d Js]
Seat 1: b5d592d2 (button) folded before Flop (didn't bet)
Seat 2: deb69778 (small blind) folded on the Turn
Seat 3: Hero (big blind) won ($1.5)
Seat 4: dbf6981f folded before Flop (didn't bet)
Seat 5: 7bf7c8c9 folded before Flop (didn't bet)
Seat 6: 3f5f9735 folded before Flop (didn't bet)


Poker Hand #RC95081579: Hold'em No Limit ($0.1/$0.25) - 2020/04/07 15:09:25
Table 'RushAndCash363395' 6-max Seat #1 is the button
Seat 1: 4dd920ba ($25 in chips)
Seat 2: Hero ($31.81 in chips)
Seat 3: 5794e88f ($27 in chips)
Seat 4: 887f8eab ($4 in chips)
Seat 5: ba64e1 ($12.1 in chips)
Seat 6: 518d077e ($25.35 in chips)
Hero: posts small blind $0.1
5794e88f: posts big blind $0.25
*** HOLE CARDS ***
Dealt to 4dd920ba 
Dealt to Hero [Jc 3h]
Dealt to 5794e88f 
Dealt to 887f8eab 
Dealt to ba64e1 
Dealt to 518d077e 
887f8eab: folds
ba64e1: raises $0.25 to $0.5
518d077e: folds
4dd920ba: folds
Hero: folds
5794e88f: folds
Uncalled bet ($0.25) returned to ba64e1
*** SHOWDOWN ***
ba64e1 collected $0.6 from pot
*** SUMMARY ***
Total pot $0.6
Seat 1: 4dd920ba (button) folded before Flop (didn't bet)
Seat 2: Hero (small blind) folded before Flop
Seat 3: 5794e88f (big blind) folded before Flop
Seat 4: 887f8eab folded before Flop (didn't bet)
Seat 5: ba64e1 collected ($0.6)
Seat 6: 518d077e folded before Flop (didn't bet)


Poker Hand #RC95081616: Hold'em No Limit ($0.1/$0.25) - 2020/04/07 15:09:29
Table 'RushAndCash363400' 6-max Seat #1 is the button
Seat 1: Hero ($31.71 in chips)
Seat 2: 704a7fcf ($29.26 in chips)
Seat 3: d59ed63d ($10.77 in chips)
Seat 4: 605bdd57 ($12.5 in chips)
Seat 5: 2609e300 ($12.5 in chips)
Seat 6: 50ccb9a1 ($22.06 in chips)
704a7fcf: posts small blind $0.1
d59ed63d: posts big blind $0.25
*** HOLE CARDS ***
Dealt to Hero [Ah 8c]
Dealt to 704a7fcf 
Dealt to d59ed63d 
Dealt to 605bdd57 
Dealt to 2609e300 
Dealt to 50ccb9a1 
605bdd57: folds
2609e300: folds
50ccb9a1: folds
Hero: raises $0.38 to $0.63
704a7fcf: folds
d59ed63d: folds
Uncalled bet ($0.38) returned to Hero
*** SHOWDOWN ***
Hero collected $0.6 from pot
*** SUMMARY ***
Total pot $0.6
Seat 1: Hero (button) collected ($0.6)
Seat 2: 704a7fcf (small blind) folded before Flop
Seat 3: d59ed63d (big blind) folded before Flop
Seat 4: 605bdd57 folded before Flop (didn't bet)
Seat 5: 2609e300 folded before Flop (didn't bet)
Seat 6: 50ccb9a1 folded before Flop (didn't bet)


Poker Hand #RC95081876: Hold'em No Limit ($0.1/$0.25) - 2020/04/07 15:10:01
Table 'RushAndCash363433' 6-max Seat #1 is the button
Seat 1: 8c86f461 ($32.06 in chips)
Seat 2: 258d376e ($26.34 in chips)
Seat 3: 605bdd57 ($12.5 in chips)
Seat 4: da0bf932 ($16.13 in chips)
Seat 5: ace893c0 ($25.15 in chips)
Seat 6: Hero ($32.06 in chips)
258d376e: posts small blind $0.1
605bdd57: posts big blind $0.25
*** HOLE CARDS ***
Dealt to 8c86f461 
Dealt to 258d376e 
Dealt to 605bdd57 
Dealt to da0bf932 
Dealt to ace893c0 
Dealt to Hero [8d 3h]
da0bf932: folds
ace893c0: folds
Hero: folds
8c86f461: folds
258d376e: raises $0.5 to $0.75
605bdd57: folds
Uncalled bet ($0.5) returned to 258d376e
*** SHOWDOWN ***
258d376e collected $0.5 from pot
*** SUMMARY ***
Total pot $0.5
Seat 1: 8c86f461 (button) folded before Flop (didn't bet)
Seat 2: 258d376e (small blind) collected ($0.5)
Seat 3: 605bdd57 (big blind) folded before Flop
Seat 4: da0bf932 folded before Flop (didn't bet)
Seat 5: ace893c0 folded before Flop (didn't bet)
Seat 6: Hero folded before Flop (didn't bet)


Poker Hand #RC95081912: Hold'em No Limit ($0.1/$0.25) - 2020/04/07 15:10:05
Table 'RushAndCash363439' 6-max Seat #1 is the button
Seat 1: 74937d40 ($42.89 in chips)
Seat 2: 324d8e1d ($25 in chips)
Seat 3: b5d592d2 ($12.26 in chips)
Seat 4: 9a31a923 ($12.85 in chips)
Seat 5: acf1a889 ($14.59 in chips)
Seat 6: Hero ($32.06 in chips)
324d8e1d: posts small blind $0.1
b5d592d2: posts big blind $0.25
*** HOLE CARDS ***
Dealt to 74937d40 
Dealt to 324d8e1d 
Dealt to b5d592d2 
Dealt to 9a31a923 
Dealt to acf1a889 
Dealt to Hero [8h 4h]
9a31a923: raises $0.38 to $0.63
acf1a889: folds
Hero: folds
74937d40: folds
324d8e1d: folds
b5d592d2: folds
Uncalled bet ($0.38) returned to 9a31a923
*** SHOWDOWN ***
9a31a923 collected $0.6 from pot
*** SUMMARY ***
Total pot $0.6
Seat 1: 74937d40 (button) folded before Flop (didn't bet)
Seat 2: 324d8e1d (small blind) folded before Flop
Seat 3: b5d592d2 (big blind) folded before Flop
Seat 4: 9a31a923 collected ($0.6)
Seat 5: acf1a889 folded before Flop (didn't bet)
Seat 6: Hero folded before Flop (didn't bet)


Poker Hand #RC95081937: Hold'em No Limit ($0.1/$0.25) - 2020/04/07 15:10:08
Table 'RushAndCash363443' 6-max Seat #1 is the button
Seat 1: e4c4c11e ($12.85 in chips)
Seat 2: da0bf932 ($15.88 in chips)
Seat 3: 9f803cc2 ($41.89 in chips)
Seat 4: Hero ($32.06 in chips)
Seat 5: 7bf7c8c9 ($28.26 in chips)
Seat 6: f322483e ($27.9 in chips)
da0bf932: posts small blind $0.1
9f803cc2: posts big blind $0.25
*** HOLE CARDS ***
Dealt to e4c4c11e 
Dealt to da0bf932 
Dealt to 9f803cc2 
Dealt to Hero [Js Th]
Dealt to 7bf7c8c9 
Dealt to f322483e 
Hero: folds
7bf7c8c9: folds
f322483e: raises $0.38 to $0.63
e4c4c11e: folds
da0bf932: folds
9f803cc2: folds
Uncalled bet ($0.38) returned to f322483e
*** SHOWDOWN ***
f322483e collected $0.6 from pot
*** SUMMARY ***
Total pot $0.6
Seat 1: e4c4c11e (button) folded before Flop (didn't bet)
Seat 2: da0bf932 (small blind) folded before Flop
Seat 3: 9f803cc2 (big blind) folded before Flop
Seat 4: Hero folded before Flop (didn't bet)
Seat 5: 7bf7c8c9 folded before Flop (didn't bet)
Seat 6: f322483e collected ($0.6)


Poker Hand #RC95081964: Hold'em No Limit ($0.1/$0.25) - 2020/04/07 15:10:11
Table 'RushAndCash363447' 6-max Seat #1 is the button
Seat 1: Hero ($32.06 in chips)
Seat 2: 1a41ed0b ($26.02 in chips)
Seat 3: d2986703 ($37.2 in chips)
Seat 4: dbf6981f ($36.55 in chips)
Seat 5: 41064a47 ($13.74 in chips)
Seat 6: 95083363 ($30.57 in chips)
1a41ed0b: posts small blind $0.1
d2986703: posts big blind $0.25
*** HOLE CARDS ***
Dealt to Hero [Qs 9s]
Dealt to 1a41ed0b 
Dealt to d2986703 
Dealt to dbf6981f 
Dealt to 41064a47 
Dealt to 95083363 
dbf6981f: folds
41064a47: folds
95083363: folds
Hero: raises $0.38 to $0.63
1a41ed0b: folds
d2986703: folds
Uncalled bet ($0.38) returned to Hero
*** SHOWDOWN ***
Hero collected $0.6 from pot
*** SUMMARY ***
Total pot $0.6
Seat 1: Hero (button) collected ($0.6)
Seat 2: 1a41ed0b (small blind) folded before Flop
Seat 3: d2986703 (big blind) folded before Flop
Seat 4: dbf6981f folded before Flop (didn't bet)
Seat 5: 41064a47 folded before Flop (didn't bet)
Seat 6: 95083363 folded before Flop (didn't bet)


Poker Hand #RC95082083: Hold'em No Limit ($0.1/$0.25) - 2020/04/07 15:10:26
Table 'RushAndCash363464' 6-max Seat #1 is the button
Seat 1: 36017ad1 ($25 in chips)
Seat 2: 103129d8 ($20.74 in chips)
Seat 3: Hero ($32.41 in chips)
Seat 4: e4c4c11e ($12.5 in chips)
Seat 5: 528a07f8 ($31.9 in chips)
Seat 6: 704a7fcf ($29.41 in chips)
103129d8: posts small blind $0.1
Hero: posts big blind $0.25
*** HOLE CARDS ***
Dealt to 36017ad1 
Dealt to 103129d8 
Dealt to Hero [Ah 6c]
Dealt to e4c4c11e 
Dealt to 528a07f8 
Dealt to 704a7fcf 
e4c4c11e: raises $0.5 to $0.75
528a07f8: folds
704a7fcf: folds
36017ad1: calls $0.75
103129d8: folds
Hero: folds
*** FLOP *** [Ad 3h Ac]
e4c4c11e: bets $1
36017ad1: calls $1
*** TURN *** [Ad 3h Ac] [Ks]
e4c4c11e: checks
36017ad1: bets $1.25
e4c4c11e: folds
Uncalled bet ($1.25) returned to 36017ad1
*** SHOWDOWN ***
36017ad1 collected $3.85 from pot
*** SUMMARY ***
Total pot $3.85
Board [Ad 3h Ac Ks]
Seat 1: 36017ad1 (button) won ($3.85)
Seat 2: 103129d8 (small blind) folded before Flop
Seat 3: Hero (big blind) folded before Flop
Seat 4: e4c4c11e folded on the Turn
Seat 5: 528a07f8 folded before Flop (didn't bet)
Seat 6: 704a7fcf folded before Flop (didn't bet)


Poker Hand #RC95082149: Hold'em No Limit ($0.1/$0.25) - 2020/04/07 15:10:33
Table 'RushAndCash363474' 6-max Seat #1 is the button
Seat 1: 4ab4e4a3 ($30.76 in chips)
Seat 2: 54c211fb ($25 in chips)
Seat 3: 3ff56a6c ($23.64 in chips)
Seat 4: Hero ($32.16 in chips)
Seat 5: 9a31a923 ($12.85 in chips)
Seat 6: 103129d8 ($20.64 in chips)
54c211fb: posts small blind $0.1
3ff56a6c: posts big blind $0.25
*** HOLE CARDS ***
Dealt to 4ab4e4a3 
Dealt to 54c211fb 
Dealt to 3ff56a6c 
Dealt to Hero [Qs Th]
Dealt to 9a31a923 
Dealt to 103129d8 
Hero: folds
9a31a923: folds
103129d8: calls $0.25
4ab4e4a3: folds
54c211fb: calls $0.15
3ff56a6c: checks
*** FLOP *** [Ah 7h 3d]
54c211fb: checks
3ff56a6c: checks
103129d8: bets $0.8
54c211fb: folds
3ff56a6c: calls $0.8
*** TURN *** [Ah 7h 3d] [4c]
3ff56a6c: checks
103129d8: bets $1.2
3ff56a6c: calls $1.2
*** RIVER *** [Ah 7h 3d 4c] [Qd]
3ff56a6c: checks
103129d8: checks
3ff56a6c: shows [5h 4s] (Pair of Fours)
103129d8: shows [2h 3h] (Pair of Treys)
*** SHOWDOWN ***
3ff56a6c collected $4.75 from pot
*** SUMMARY ***
Total pot $4.75
Board [Ah 7h 3d 4c Qd]
Seat 1: 4ab4e4a3 (button) folded before Flop (didn't bet)
Seat 2: 54c211fb (small blind) folded on the Flop
Seat 3: 3ff56a6c (big blind) showed [5h 4s] and won ($4.75) with Pair of Fours
Seat 4: Hero folded before Flop (didn't bet)
Seat 5: 9a31a923 folded before Flop (didn't bet)
Seat 6: 103129d8 showed [3h 2h] and lost with Pair of Treys


Poker Hand #RC95082174: Hold'em No Limit ($0.1/$0.25) - 2020/04/07 15:10:36
Table 'RushAndCash363478' 6-max Seat #1 is the button
Seat 1: af84e661 ($8.72 in chips)
Seat 2: Hero ($32.16 in chips)
Seat 3: 289f2e46 ($41.68 in chips)
Seat 4: 96eec3de ($40.77 in chips)
Seat 5: e1071a91 ($28.43 in chips)
Seat 6: c86cf70b ($35.02 in chips)
Hero: posts small blind $0.1
289f2e46: posts big blind $0.25
*** HOLE CARDS ***
Dealt to af84e661 
Dealt to Hero [7c 5c]
Dealt to 289f2e46 
Dealt to 96eec3de 
Dealt to e1071a91 
Dealt to c86cf70b 
96eec3de: folds
e1071a91: raises $0.5 to $0.75
c86cf70b: folds
af84e661: folds
Hero: folds
289f2e46: folds
Uncalled bet ($0.5) returned to e1071a91
*** SHOWDOWN ***
e1071a91 collected $0.6 from pot
*** SUMMARY ***
Total pot $0.6
Seat 1: af84e661 (button) folded before Flop (didn't bet)
Seat 2: Hero (small blind) folded before Flop
Seat 3: 289f2e46 (big blind) folded before Flop
Seat 4: 96eec3de folded before Flop (didn't bet)
Seat 5: e1071a91 collected ($0.6)
Seat 6: c86cf70b folded before Flop (didn't bet)


Poker Hand #RC95082226: Hold'em No Limit ($0.1/$0.25) - 2020/04/07 15:10:42
Table 'RushAndCash363486' 6-max Seat #1 is the button
Seat 1: 18633f97 ($11.65 in chips)
Seat 2: c88456c4 ($14.37 in chips)
Seat 3: 45920dbc ($51.96 in chips)
Seat 4: Hero ($32.06 in chips)
Seat 5: 476775f5 ($15.16 in chips)
Seat 6: e131407f ($29.82 in chips)
c88456c4: posts small blind $0.1
45920dbc: posts big blind $0.25
*** HOLE CARDS ***
Dealt to 18633f97 
Dealt to c88456c4 
Dealt to 45920dbc 
Dealt to Hero [Jd 8d]
Dealt to 476775f5 
Dealt to e131407f 
Hero: folds
476775f5: folds
e131407f: raises $0.25 to $0.5
18633f97: folds
c88456c4: folds
45920dbc: calls $0.25
*** FLOP *** [2h Qd 3d]
45920dbc: checks
e131407f: checks
*** TURN *** [2h Qd 3d] [Ah]
45920dbc: checks
e131407f: checks
*** RIVER *** [2h Qd 3d Ah] [9d]
45920dbc: checks
e131407f: checks
45920dbc: shows [Kh Qs] (Pair of Queens)
e131407f: shows [7s 6s] (Ace-High)
*** SHOWDOWN ***
45920dbc collected $1.1 from pot
*** SUMMARY ***
Total pot $1.1
Board [2h Qd 3d Ah 9d]
Seat 1: 18633f97 (button) folded before Flop (didn't bet)
Seat 2: c88456c4 (small blind) folded before Flop
Seat 3: 45920dbc (big blind) showed [Kh Qs] and won ($1.1) with Pair of Queens
Seat 4: Hero folded before Flop (didn't bet)
Seat 5: 476775f5 folded before Flop (didn't bet)
Seat 6: e131407f showed [7s 6s] and lost with Ace-High


Poker Hand #RC95082251: Hold'em No Limit ($0.1/$0.25) - 2020/04/07 15:10:45
Table 'RushAndCash363490' 6-max Seat #1 is the button
Seat 1: 32953d2a ($14.42 in chips)
Seat 2: 1a41ed0b ($25.67 in chips)
Seat 3: 1780ed6 ($25 in chips)
Seat 4: 9a31a923 ($12.85 in chips)
Seat 5: Hero ($32.06 in chips)
Seat 6: 2dd038c3 ($6.78 in chips)
1a41ed0b: posts small blind $0.1
1780ed6: posts big blind $0.25
*** HOLE CARDS ***
Dealt to 32953d2a 
Dealt to 1a41ed0b 
Dealt to 1780ed6 
Dealt to 9a31a923 
Dealt to Hero [Tc 4c]
Dealt to 2dd038c3 
9a31a923: folds
Hero: folds
2dd038c3: folds
32953d2a: raises $0.38 to $0.63
1a41ed0b: calls $0.53
1780ed6: folds
*** FLOP *** [9h 6h 5d]
1a41ed0b: bets $0.8
32953d2a: calls $0.8
*** TURN *** [9h 6h 5d] [Qh]
1a41ed0b: checks
32953d2a: bets $2.4
1a41ed0b: raises $5.8 to $8.2
32953d2a: raises $4.79 to $12.99 and is all-in
1a41ed0b: calls $4.79
32953d2a: shows [8h Jh] (Queen High Flush)
1a41ed0b: shows [Kh 7h] (King High Flush)
*** RIVER *** [9h 6h 5d Qh] [Qd]
*** SHOWDOWN ***
1a41ed0b collected $29.09 from pot
*** SUMMARY ***
Total pot $29.09
Board [9h 6h 5d Qh Qd]
Seat 1: 32953d2a (button) showed [Jh 8h] and lost with Queen High Flush
Seat 2: 1a41ed0b (small blind) showed [Kh 7h] and won ($29.09) with King High Flush
Seat 3: 1780ed6 (big blind) folded before Flop
Seat 4: 9a31a923 folded before Flop (didn't bet)
Seat 5: Hero folded before Flop (didn't bet)
Seat 6: 2dd038c3 folded before Flop (didn't bet)


Poker Hand #RC95082282: Hold'em No Limit ($0.1/$0.25) - 2020/04/07 15:10:49
Table 'RushAndCash363494' 6-max Seat #1 is the button
Seat 1: cae4d8ce ($13.09 in chips)
Seat 2: Hero ($32.06 in chips)
Seat 3: b431c8b6 ($25 in chips)
Seat 4: cfe992dd ($25 in chips)
Seat 5: d07b3de1 ($31.44 in chips)
Seat 6: 7c935d24 ($25 in chips)
Hero: posts small blind $0.1
b431c8b6: posts big blind $0.25
*** HOLE CARDS ***
Dealt to cae4d8ce 
Dealt to Hero [As 8d]
Dealt to b431c8b6 
Dealt to cfe992dd 
Dealt to d07b3de1 
Dealt to 7c935d24 
cfe992dd: folds
d07b3de1: folds
7c935d24: folds
cae4d8ce: folds
Hero: folds
Uncalled bet ($0.15) returned to b431c8b6
*** SHOWDOWN ***
b431c8b6 collected $0.2 from pot
*** SUMMARY ***
Total pot $0.2
Seat 1: cae4d8ce (button) folded before Flop (didn't bet)
Seat 2: Hero (small blind) folded before Flop
Seat 3: b431c8b6 (big blind) collected ($0.2)
Seat 4: cfe992dd folded before Flop (didn't bet)
Seat 5: d07b3de1 folded before Flop (didn't bet)
Seat 6: 7c935d24 folded before Flop (didn't bet)


Poker Hand #RC95082309: Hold'em No Limit ($0.1/$0.25) - 2020/04/07 15:10:53
Table 'RushAndCash363498' 6-max Seat #1 is the button
Seat 1: d6f2a39c ($11.97 in chips)
Seat 2: 181171f9 ($69.34 in chips)
Seat 3: Hero ($31.96 in chips)
Seat 4: 7c935d24 ($25 in chips)
Seat 5: cc092a76 ($8.61 in chips)
Seat 6: 20b62793 ($78.47 in chips)
181171f9: posts small blind $0.1
Hero: posts big blind $0.25
*** HOLE CARDS ***
Dealt to d6f2a39c 
Dealt to 181171f9 
Dealt to Hero [8d 3s]
Dealt to 7c935d24 
Dealt to cc092a76 
Dealt to 20b62793 
7c935d24: folds
cc092a76: calls $0.25
20b62793: folds
d6f2a39c: folds
181171f9: calls $0.15
Hero: checks
*** FLOP *** [Jc Ac Js]
181171f9: checks
Hero: checks
cc092a76: checks
*** TURN *** [Jc Ac Js] [6h]
181171f9: checks
Hero: checks
cc092a76: bets $0.4
181171f9: folds
Hero: folds
Uncalled bet ($0.4) returned to cc092a76
*** SHOWDOWN ***
cc092a76 collected $0.75 from pot
*** SUMMARY ***
Total pot $0.75
Board [Jc Ac Js 6h]
Seat 1: d6f2a39c (button) folded before Flop (didn't bet)
Seat 2: 181171f9 (small blind) folded on the Turn
Seat 3: Hero (big blind) folded on the Turn
Seat 4: 7c935d24 folded before Flop (didn't bet)
Seat 5: cc092a76 won ($0.75)
Seat 6: 20b62793 folded before Flop (didn't bet)


Poker Hand #RC95082333: Hold'em No Limit ($0.1/$0.25) - 2020/04/07 15:10:56
Table 'RushAndCash363503' 6-max Seat #1 is the button
Seat 1: Hero ($31.71 in chips)
Seat 2: a6fc3bd6 ($25.41 in chips)
Seat 3: 258d376e ($26.59 in chips)
Seat 4: bfa55601 ($13.42 in chips)
Seat 5: 4ab4e4a3 ($30.76 in chips)
Seat 6: c88456c4 ($14.62 in chips)
a6fc3bd6: posts small blind $0.1
258d376e: posts big blind $0.25
*** HOLE CARDS ***
Dealt to Hero [Ah 5s]
Dealt to a6fc3bd6 
Dealt to 258d376e 
Dealt to bfa55601 
Dealt to 4ab4e4a3 
Dealt to c88456c4 
bfa55601: folds
4ab4e4a3: folds
c88456c4: folds
Hero: folds
a6fc3bd6: raises $0.5 to $0.75
258d376e: calls $0.5
*** FLOP *** [7h 8c Js]
a6fc3bd6: bets $1
258d376e: calls $1
*** TURN *** [7h 8c Js] [3h]
a6fc3bd6: bets $2.5
258d376e: folds
Uncalled bet ($2.5) returned to a6fc3bd6
*** SHOWDOWN ***
a6fc3bd6 collected $3.5 from pot
*** SUMMARY ***
Total pot $3.5
Board [7h 8c Js 3h]
Seat 1: Hero (button) folded before Flop (didn't bet)
Seat 2: a6fc3bd6 (small blind) won ($3.5)
Seat 3: 258d376e (big blind) folded on the Turn
Seat 4: bfa55601 folded before Flop (didn't bet)
Seat 5: 4ab4e4a3 folded before Flop (didn't bet)
Seat 6: c88456c4 folded before Flop (didn't bet)


Poker Hand #RC95082395: Hold'em No Limit ($0.1/$0.25) - 2020/04/07 15:11:03
Table 'RushAndCash363512' 6-max Seat #1 is the button
Seat 1: d84d476b ($23.61 in chips)
Seat 2: f44f8c27 ($36.11 in chips)
Seat 3: 275e7f74 ($28.21 in chips)
Seat 4: da0bf932 ($15.78 in chips)
Seat 5: Hero ($31.71 in chips)
Seat 6: e814b201 ($29.54 in chips)
f44f8c27: posts small blind $0.1
275e7f74: posts big blind $0.25
*** HOLE CARDS ***
Dealt to d84d476b 
Dealt to f44f8c27 
Dealt to 275e7f74 
Dealt to da0bf932 
Dealt to Hero [Qh 2s]
Dealt to e814b201 
da0bf932: folds
Hero: folds
e814b201: folds
d84d476b: folds
f44f8c27: raises $0.5 to $0.75
275e7f74: calls $0.5
*** FLOP *** [3c 6d 4h]
f44f8c27: checks
275e7f74: checks
*** TURN *** [3c 6d 4h] [9c]
f44f8c27: checks
275e7f74: bets $1
f44f8c27: folds
Uncalled bet ($1) returned to 275e7f74
*** SHOWDOWN ***
275e7f74 collected $1.5 from pot
*** SUMMARY ***
Total pot $1.5
Board [3c 6d 4h 9c]
Seat 1: d84d476b (button) folded before Flop (didn't bet)
Seat 2: f44f8c27 (small blind) folded on the Turn
Seat 3: 275e7f74 (big blind) won ($1.5)
Seat 4: da0bf932 folded before Flop (didn't bet)
Seat 5: Hero folded before Flop (didn't bet)
Seat 6: e814b201 folded before Flop (didn't bet)


Poker Hand #RC95082422: Hold'em No Limit ($0.1/$0.25) - 2020/04/07 15:11:07
Table 'RushAndCash363517' 6-max Seat #1 is the button
Seat 1: bf64de7f ($12 in chips)
Seat 2: 90ddca47 ($26.36 in chips)
Seat 3: 432498db ($25 in chips)
Seat 4: Hero ($31.71 in chips)
Seat 5: b5d592d2 ($12.01 in chips)
Seat 6: f9ba2d22 ($25.22 in chips)
90ddca47: posts small blind $0.1
432498db: posts big blind $0.25
*** HOLE CARDS ***
Dealt to bf64de7f 
Dealt to 90ddca47 
Dealt to 432498db 
Dealt to Hero [As 4s]
Dealt to b5d592d2 
Dealt to f9ba2d22 
Hero: raises $0.38 to $0.63
b5d592d2: folds
f9ba2d22: folds
bf64de7f: folds
90ddca47: folds
432498db: folds
Uncalled bet ($0.38) returned to Hero
*** SHOWDOWN ***
Hero collected $0.6 from pot
*** SUMMARY ***
Total pot $0.6
Seat 1: bf64de7f (button) folded before Flop (didn't bet)
Seat 2: 90ddca47 (small blind) folded before Flop
Seat 3: 432498db (big blind) folded before Flop
Seat 4: Hero collected ($0.6)
Seat 5: b5d592d2 folded before Flop (didn't bet)
Seat 6: f9ba2d22 folded before Flop (didn't bet)


Poker Hand #RC95082525: Hold'em No Limit ($0.1/$0.25) - 2020/04/07 15:11:19
Table 'RushAndCash363532' 6-max Seat #1 is the button
Seat 1: a4ba858f ($30.65 in chips)
Seat 2: 887f8eab ($3.75 in chips)
Seat 3: 454abe8b ($26.16 in chips)
Seat 4: Hero ($32.06 in chips)
Seat 5: 2609e300 ($12.5 in chips)
Seat 6: d84d476b ($23.61 in chips)
887f8eab: posts small blind $0.1
454abe8b: posts big blind $0.25
*** HOLE CARDS ***
Dealt to a4ba858f 
Dealt to 887f8eab 
Dealt to 454abe8b 
Dealt to Hero [Kd 8c]
Dealt to 2609e300 
Dealt to d84d476b 
Hero: folds
2609e300: folds
d84d476b: folds
a4ba858f: folds
887f8eab: folds
Uncalled bet ($0.15) returned to 454abe8b
*** SHOWDOWN ***
454abe8b collected $0.2 from pot
*** SUMMARY ***
Total pot $0.2
Seat 1: a4ba858f (button) folded before Flop (didn't bet)
Seat 2: 887f8eab (small blind) folded before Flop
Seat 3: 454abe8b (big blind) collected ($0.2)
Seat 4: Hero folded before Flop (didn't bet)
Seat 5: 2609e300 folded before Flop (didn't bet)
Seat 6: d84d476b folded before Flop (didn't bet)


Poker Hand #RC95082563: Hold'em No Limit ($0.1/$0.25) - 2020/04/07 15:11:24
Table 'RushAndCash363536' 6-max Seat #1 is the button
Seat 1: 1780ed6 ($25 in chips)
Seat 2: 466b8e5e ($12.6 in chips)
Seat 3: 8ebd1db4 ($32.01 in chips)
Seat 4: d84d476b ($23.61 in chips)
Seat 5: a4ba858f ($30.65 in chips)
Seat 6: Hero ($32.06 in chips)
466b8e5e: posts small blind $0.1
8ebd1db4: posts big blind $0.25
*** HOLE CARDS ***
Dealt to 1780ed6 
Dealt to 466b8e5e 
Dealt to 8ebd1db4 
Dealt to d84d476b 
Dealt to a4ba858f 
Dealt to Hero [8s 5s]
d84d476b: raises $0.38 to $0.63
a4ba858f: folds
Hero: folds
1780ed6: folds
466b8e5e: folds
8ebd1db4: folds
Uncalled bet ($0.38) returned to d84d476b
*** SHOWDOWN ***
d84d476b collected $0.6 from pot
*** SUMMARY ***
Total pot $0.6
Seat 1: 1780ed6 (button) folded before Flop (didn't bet)
Seat 2: 466b8e5e (small blind) folded before Flop
Seat 3: 8ebd1db4 (big blind) folded before Flop
Seat 4: d84d476b collected ($0.6)
Seat 5: a4ba858f folded before Flop (didn't bet)
Seat 6: Hero folded before Flop (didn't bet)


Poker Hand #RC95082593: Hold'em No Limit ($0.1/$0.25) - 2020/04/07 15:11:27
Table 'RushAndCash363539' 6-max Seat #1 is the button
Seat 1: fe3f48f4 ($25.36 in chips)
Seat 2: b5d592d2 ($11.76 in chips)
Seat 3: a4ba858f ($30.65 in chips)
Seat 4: 18075352 ($27.91 in chips)
Seat 5: Hero ($32.06 in chips)
Seat 6: 3cfd7308 ($39.68 in chips)
b5d592d2: posts small blind $0.1
a4ba858f: posts big blind $0.25
*** HOLE CARDS ***
Dealt to fe3f48f4 
Dealt to b5d592d2 
Dealt to a4ba858f 
Dealt to 18075352 
Dealt to Hero [9s 6s]
Dealt to 3cfd7308 
18075352: folds
Hero: folds
3cfd7308: folds
fe3f48f4: folds
b5d592d2: folds
Uncalled bet ($0.15) returned to a4ba858f
*** SHOWDOWN ***
a4ba858f collected $0.2 from pot
*** SUMMARY ***
Total pot $0.2
Seat 1: fe3f48f4 (button) folded before Flop (didn't bet)
Seat 2: b5d592d2 (small blind) folded before Flop
Seat 3: a4ba858f (big blind) collected ($0.2)
Seat 4: 18075352 folded before Flop (didn't bet)
Seat 5: Hero folded before Flop (didn't bet)
Seat 6: 3cfd7308 folded before Flop (didn't bet)


Poker Hand #RC95082621: Hold'em No Limit ($0.1/$0.25) - 2020/04/07 15:11:30
Table 'RushAndCash363543' 6-max Seat #1 is the button
Seat 1: 103129d8 ($18.39 in chips)
Seat 2: 8db504d0 ($25.06 in chips)
Seat 3: Hero ($32.06 in chips)
Seat 4: 3ff56a6c ($25.91 in chips)
Seat 5: b431c8b6 ($25 in chips)
Seat 6: 79cc211c ($24.45 in chips)
8db504d0: posts small blind $0.1
Hero: posts big blind $0.25
*** HOLE CARDS ***
Dealt to 103129d8 
Dealt to 8db504d0 
Dealt to Hero [Jc 2d]
Dealt to 3ff56a6c 
Dealt to b431c8b6 
Dealt to 79cc211c 
3ff56a6c: folds
b431c8b6: folds
79cc211c: folds
103129d8: folds
8db504d0: raises $0.25 to $0.5
Hero: folds
Uncalled bet ($0.25) returned to 8db504d0
*** SHOWDOWN ***
8db504d0 collected $0.5 from pot
*** SUMMARY ***
Total pot $0.5
Seat 1: 103129d8 (button) folded before Flop (didn't bet)
Seat 2: 8db504d0 (small blind) collected ($0.5)
Seat 3: Hero (big blind) folded before Flop
Seat 4: 3ff56a6c folded before Flop (didn't bet)
Seat 5: b431c8b6 folded before Flop (didn't bet)
Seat 6: 79cc211c folded before Flop (didn't bet)


Poker Hand #RC95082657: Hold'em No Limit ($0.1/$0.25) - 2020/04/07 15:11:34
Table 'RushAndCash363550' 6-max Seat #1 is the button
Seat 1: bda1b4ce ($28.14 in chips)
Seat 2: 7c0ffa93 ($24.75 in chips)
Seat 3: 2c9e9ffe ($10.04 in chips)
Seat 4: af84e661 ($8.82 in chips)
Seat 5: Hero ($31.81 in chips)
Seat 6: fe3f48f4 ($25.36 in chips)
7c0ffa93: posts small blind $0.1
2c9e9ffe: posts big blind $0.25
*** HOLE CARDS ***
Dealt to bda1b4ce 
Dealt to 7c0ffa93 
Dealt to 2c9e9ffe 
Dealt to af84e661 
Dealt to Hero [Ks 7c]
Dealt to fe3f48f4 
af84e661: folds
Hero: folds
fe3f48f4: folds
bda1b4ce: folds
7c0ffa93: folds
Uncalled bet ($0.15) returned to 2c9e9ffe
*** SHOWDOWN ***
2c9e9ffe collected $0.2 from pot
*** SUMMARY ***
Total pot $0.2
Seat 1: bda1b4ce (button) folded before Flop (didn't bet)
Seat 2: 7c0ffa93 (small blind) folded before Flop
Seat 3: 2c9e9ffe (big blind) collected ($0.2)
Seat 4: af84e661 folded before Flop (didn't bet)
Seat 5: Hero folded before Flop (didn't bet)
Seat 6: fe3f48f4 folded before Flop (didn't bet)


Poker Hand #RC95082683: Hold'em No Limit ($0.1/$0.25) - 2020/04/07 15:11:38
Table 'RushAndCash363555' 6-max Seat #1 is the button
Seat 1: 7c935d24 ($25.9 in chips)
Seat 2: Hero ($31.81 in chips)
Seat 3: e1071a91 ($28.15 in chips)
Seat 4: b431c8b6 ($25 in chips)
Seat 5: bbb85b3f ($25 in chips)
Seat 6: 518d077e ($27.93 in chips)
Hero: posts small blind $0.1
e1071a91: posts big blind $0.25
*** HOLE CARDS ***
Dealt to 7c935d24 
Dealt to Hero [Qs Th]
Dealt to e1071a91 
Dealt to b431c8b6 
Dealt to bbb85b3f 
Dealt to 518d077e 
b431c8b6: folds
bbb85b3f: folds
518d077e: folds
7c935d24: folds
Hero: folds
Uncalled bet ($0.15) returned to e1071a91
*** SHOWDOWN ***
e1071a91 collected $0.2 from pot
*** SUMMARY ***
Total pot $0.2
Seat 1: 7c935d24 (button) folded before Flop (didn't bet)
Seat 2: Hero (small blind) folded before Flop
Seat 3: e1071a91 (big blind) collected ($0.2)
Seat 4: b431c8b6 folded before Flop (didn't bet)
Seat 5: bbb85b3f folded before Flop (didn't bet)
Seat 6: 518d077e folded before Flop (didn't bet)


Poker Hand #RC95082718: Hold'em No Limit ($0.1/$0.25) - 2020/04/07 15:11:42
Table 'RushAndCash363560' 6-max Seat #1 is the button
Seat 1: cc092a76 ($9.08 in chips)
Seat 2: b431c8b6 ($25 in chips)
Seat 3: 8db504d0 ($25.31 in chips)
Seat 4: Hero ($31.71 in chips)
Seat 5: cae4d8ce ($12.84 in chips)
Seat 6: 6736194e ($24.12 in chips)
b431c8b6: posts small blind $0.1
8db504d0: posts big blind $0.25
*** HOLE CARDS ***
Dealt to cc092a76 
Dealt to b431c8b6 
Dealt to 8db504d0 
Dealt to Hero [7d 4d]
Dealt to cae4d8ce 
Dealt to 6736194e 
Hero: folds
cae4d8ce: folds
6736194e: folds
cc092a76: calls $0.25
b431c8b6: raises $1.05 to $1.3
8db504d0: folds
cc092a76: folds
Uncalled bet ($1.05) returned to b431c8b6
*** SHOWDOWN ***
b431c8b6 collected $0.75 from pot
*** SUMMARY ***
Total pot $0.75
Seat 1: cc092a76 (button) folded before Flop
Seat 2: b431c8b6 (small blind) collected ($0.75)
Seat 3: 8db504d0 (big blind) folded before Flop
Seat 4: Hero folded before Flop (didn't bet)
Seat 5: cae4d8ce folded before Flop (didn't bet)
Seat 6: 6736194e folded before Flop (didn't bet)


Poker Hand #RC95082748: Hold'em No Limit ($0.1/$0.25) - 2020/04/07 15:11:46
Table 'RushAndCash363565' 6-max Seat #1 is the button
Seat 1: 8db504d0 ($25.06 in chips)
Seat 2: 8c86f461 ($32.56 in chips)
Seat 3: Hero ($31.71 in chips)
Seat 4: 518d077e ($27.93 in chips)
Seat 5: bd460ce3 ($28.2 in chips)
Seat 6: 103129d8 ($18.29 in chips)
8c86f461: posts small blind $0.1
Hero: posts big blind $0.25
*** HOLE CARDS ***
Dealt to 8db504d0 
Dealt to 8c86f461 
Dealt to Hero [As 4c]
Dealt to 518d077e 
Dealt to bd460ce3 
Dealt to 103129d8 
518d077e: folds
bd460ce3: raises $0.38 to $0.63
103129d8: folds
8db504d0: folds
8c86f461: folds
Hero: folds
Uncalled bet ($0.38) returned to bd460ce3
*** SHOWDOWN ***
bd460ce3 collected $0.6 from pot
*** SUMMARY ***
Total pot $0.6
Seat 1: 8db504d0 (button) folded before Flop (didn't bet)
Seat 2: 8c86f461 (small blind) folded before Flop
Seat 3: Hero (big blind) folded before Flop
Seat 4: 518d077e folded before Flop (didn't bet)
Seat 5: bd460ce3 collected ($0.6)
Seat 6: 103129d8 folded before Flop (didn't bet)


Poker Hand #RC95082778: Hold'em No Limit ($0.1/$0.25) - 2020/04/07 15:11:50
Table 'RushAndCash363569' 6-max Seat #1 is the button
Seat 1: Hero ($31.46 in chips)
Seat 2: 24a8e574 ($29.47 in chips)
Seat 3: 6736194e ($24.12 in chips)
Seat 4: 432498db ($25 in chips)
Seat 5: 8db504d0 ($25.06 in chips)
Seat 6: d84d476b ($24.06 in chips)
24a8e574: posts small blind $0.1
6736194e: posts big blind $0.25
*** HOLE CARDS ***
Dealt to Hero [Kd 4s]
Dealt to 24a8e574 
Dealt to 6736194e 
Dealt to 432498db 
Dealt to 8db504d0 
Dealt to d84d476b 
432498db: raises $0.35 to $0.6
8db504d0: folds
d84d476b: folds
Hero: folds
24a8e574: folds
6736194e: calls $0.35
*** FLOP *** [5s 2h Td]
6736194e: checks
432498db: bets $0.5
6736194e: raises $0.5 to $1
432498db: calls $0.5
*** TURN *** [5s 2h Td] [5h]
6736194e: checks
432498db: bets $2.5
6736194e: folds
Uncalled bet ($2.5) returned to 432498db
*** SHOWDOWN ***
432498db collected $3.3 from pot
*** SUMMARY ***
Total pot $3.3
Board [5s 2h Td 5h]
Seat 1: Hero (button) folded before Flop (didn't bet)
Seat 2: 24a8e574 (small blind) folded before Flop
Seat 3: 6736194e (big blind) folded on the Turn
Seat 4: 432498db won ($3.3)
Seat 5: 8db504d0 folded before Flop (didn't bet)
Seat 6: d84d476b folded before Flop (didn't bet)


Poker Hand #RC95082800: Hold'em No Limit ($0.1/$0.25) - 2020/04/07 15:11:52
Table 'RushAndCash363572' 6-max Seat #1 is the button
Seat 1: Hero ($31.46 in chips)
Seat 2: 18633f97 ($13.06 in chips)
Seat 3: d05d0db2 ($25 in chips)
Seat 4: 7bf7c8c9 ($25 in chips)
Seat 5: fc8a29ea ($83.39 in chips)
Seat 6: 103129d8 ($18.29 in chips)
18633f97: posts small blind $0.1
d05d0db2: posts big blind $0.25
*** HOLE CARDS ***
Dealt to Hero [Tc 5d]
Dealt to 18633f97 
Dealt to d05d0db2 
Dealt to 7bf7c8c9 
Dealt to fc8a29ea 
Dealt to 103129d8 
7bf7c8c9: folds
fc8a29ea: folds
103129d8: folds
Hero: folds
18633f97: folds
Uncalled bet ($0.15) returned to d05d0db2
*** SHOWDOWN ***
d05d0db2 collected $0.2 from pot
*** SUMMARY ***
Total pot $0.2
Seat 1: Hero (button) folded before Flop (didn't bet)
Seat 2: 18633f97 (small blind) folded before Flop
Seat 3: d05d0db2 (big blind) collected ($0.2)
Seat 4: 7bf7c8c9 folded before Flop (didn't bet)
Seat 5: fc8a29ea folded before Flop (didn't bet)
Seat 6: 103129d8 folded before Flop (didn't bet)


Poker Hand #RC95082841: Hold'em No Limit ($0.1/$0.25) - 2020/04/07 15:11:58
Table 'RushAndCash363578' 6-max Seat #1 is the button
Seat 1: 258d376e ($25 in chips)
Seat 2: Hero ($31.46 in chips)
Seat 3: 7bf7c8c9 ($25 in chips)
Seat 4: 90ddca47 ($26.01 in chips)
Seat 5: 61ad32d ($12.5 in chips)
Seat 6: 3ff56a6c ($25.81 in chips)
Hero: posts small blind $0.1
7bf7c8c9: posts big blind $0.25
*** HOLE CARDS ***
Dealt to 258d376e 
Dealt to Hero [9d 5d]
Dealt to 7bf7c8c9 
Dealt to 90ddca47 
Dealt to 61ad32d 
Dealt to 3ff56a6c 
90ddca47: folds
61ad32d: folds
3ff56a6c: raises $0.38 to $0.63
258d376e: folds
Hero: folds
7bf7c8c9: folds
Uncalled bet ($0.38) returned to 3ff56a6c
*** SHOWDOWN ***
3ff56a6c collected $0.6 from pot
*** SUMMARY ***
Total pot $0.6
Seat 1: 258d376e (button) folded before Flop (didn't bet)
Seat 2: Hero (small blind) folded before Flop
Seat 3: 7bf7c8c9 (big blind) folded before Flop
Seat 4: 90ddca47 folded before Flop (didn't bet)
Seat 5: 61ad32d folded before Flop (didn't bet)
Seat 6: 3ff56a6c collected ($0.6)


Poker Hand #RC95082874: Hold'em No Limit ($0.1/$0.25) - 2020/04/07 15:12:02
Table 'RushAndCash363583' 6-max Seat #1 is the button
Seat 1: 7c0ffa93 ($24.65 in chips)
Seat 2: 65837850 ($134.17 in chips)
Seat 3: 8db504d0 ($25.06 in chips)
Seat 4: Hero ($31.36 in chips)
Seat 5: 61ad32d ($12.5 in chips)
Seat 6: 54c211fb ($25 in chips)
65837850: posts small blind $0.1
8db504d0: posts big blind $0.25
*** HOLE CARDS ***
Dealt to 7c0ffa93 
Dealt to 65837850 
Dealt to 8db504d0 
Dealt to Hero [Jc 3s]
Dealt to 61ad32d 
Dealt to 54c211fb 
Hero: folds
61ad32d: folds
54c211fb: folds
7c0ffa93: folds
65837850: folds
Uncalled bet ($0.15) returned to 8db504d0
*** SHOWDOWN ***
8db504d0 collected $0.2 from pot
*** SUMMARY ***
Total pot $0.2
Seat 1: 7c0ffa93 (button) folded before Flop (didn't bet)
Seat 2: 65837850 (small blind) folded before Flop
Seat 3: 8db504d0 (big blind) collected ($0.2)
Seat 4: Hero folded before Flop (didn't bet)
Seat 5: 61ad32d folded before Flop (didn't bet)
Seat 6: 54c211fb folded before Flop (didn't bet)


Poker Hand #RC95082901: Hold'em No Limit ($0.1/$0.25) - 2020/04/07 15:12:05
Table 'RushAndCash363587' 6-max Seat #1 is the button
Seat 1: e131407f ($29.42 in chips)
Seat 2: c86cf70b ($33.04 in chips)
Seat 3: 61ad32d ($12.5 in chips)
Seat 4: 324d8e1d ($25 in chips)
Seat 5: Hero ($31.36 in chips)
Seat 6: 605bdd57 ($12.5 in chips)
c86cf70b: posts small blind $0.1
61ad32d: posts big blind $0.25
*** HOLE CARDS ***
Dealt to e131407f 
Dealt to c86cf70b 
Dealt to 61ad32d 
Dealt to 324d8e1d 
Dealt to Hero [4d 2h]
Dealt to 605bdd57 
324d8e1d: folds
Hero: folds
605bdd57: folds
e131407f: raises $0.25 to $0.5
c86cf70b: raises $1.5 to $2
61ad32d: folds
e131407f: calls $1.5
*** FLOP *** [6c 9s 3s]
c86cf70b: bets $1.5
e131407f: folds
Uncalled bet ($1.5) returned to c86cf70b
*** SHOWDOWN ***
c86cf70b collected $4.25 from pot
*** SUMMARY ***
Total pot $4.25
Board [6c 9s 3s]
Seat 1: e131407f (button) folded on the Flop
Seat 2: c86cf70b (small blind) won ($4.25)
Seat 3: 61ad32d (big blind) folded before Flop
Seat 4: 324d8e1d folded before Flop (didn't bet)
Seat 5: Hero folded before Flop (didn't bet)
Seat 6: 605bdd57 folded before Flop (didn't bet)


Poker Hand #RC95082931: Hold'em No Limit ($0.1/$0.25) - 2020/04/07 15:12:09
Table 'RushAndCash363591' 6-max Seat #1 is the button
Seat 1: Hero ($31.36 in chips)
Seat 2: a75a3d24 ($25 in chips)
Seat 3: 89387862 ($27.75 in chips)
Seat 4: e814b201 ($29.19 in chips)
Seat 5: fc8a29ea ($83.49 in chips)
Seat 6: 704c37d9 ($53.5 in chips)
a75a3d24: posts small blind $0.1
89387862: posts big blind $0.25
*** HOLE CARDS ***
Dealt to Hero [Qh 5d]
Dealt to a75a3d24 
Dealt to 89387862 
Dealt to e814b201 
Dealt to fc8a29ea 
Dealt to 704c37d9 
e814b201: raises $0.25 to $0.5
fc8a29ea: folds
704c37d9: folds
Hero: folds
a75a3d24: folds
89387862: folds
Uncalled bet ($0.25) returned to e814b201
*** SHOWDOWN ***
e814b201 collected $0.6 from pot
*** SUMMARY ***
Total pot $0.6
Seat 1: Hero (button) folded before Flop (didn't bet)
Seat 2: a75a3d24 (small blind) folded before Flop
Seat 3: 89387862 (big blind) folded before Flop
Seat 4: e814b201 collected ($0.6)
Seat 5: fc8a29ea folded before Flop (didn't bet)
Seat 6: 704c37d9 folded before Flop (didn't bet)


Poker Hand #RC95082964: Hold'em No Limit ($0.1/$0.25) - 2020/04/07 15:12:14
Table 'RushAndCash363596' 6-max Seat #1 is the button
Seat 1: 95083363 ($29.07 in chips)
Seat 2: 4dd920ba ($25 in chips)
Seat 3: Hero ($31.36 in chips)
Seat 4: d6f2a39c ($11.62 in chips)
Seat 5: fc8a29ea ($83.49 in chips)
Seat 6: d84d476b ($23.96 in chips)
4dd920ba: posts small blind $0.1
Hero: posts big blind $0.25
*** HOLE CARDS ***
Dealt to 95083363 
Dealt to 4dd920ba 
Dealt to Hero [Ah Kd]
Dealt to d6f2a39c 
Dealt to fc8a29ea 
Dealt to d84d476b 
d6f2a39c: folds
fc8a29ea: folds
d84d476b: folds
95083363: raises $0.25 to $0.5
4dd920ba: folds
Hero: raises $1.7 to $2.2
95083363: folds
Uncalled bet ($1.7) returned to Hero
*** SHOWDOWN ***
Hero collected $1.1 from pot
*** SUMMARY ***
Total pot $1.1
Seat 1: 95083363 (button) folded before Flop
Seat 2: 4dd920ba (small blind) folded before Flop
Seat 3: Hero (big blind) collected ($1.1)
Seat 4: d6f2a39c folded before Flop (didn't bet)
Seat 5: fc8a29ea folded before Flop (didn't bet)
Seat 6: d84d476b folded before Flop (didn't bet)


Poker Hand #RC95083213: Hold'em No Limit ($0.1/$0.25) - 2020/04/07 15:12:45
Table 'RushAndCash363631' 6-max Seat #1 is the button
Seat 1: 7ac43878 ($18.09 in chips)
Seat 2: 5d360146 ($12 in chips)
Seat 3: 2609e300 ($12.5 in chips)
Seat 4: Hero ($31.91 in chips)
Seat 5: 8b8d197c ($25 in chips)
Seat 6: 45920dbc ($52.26 in chips)
5d360146: posts small blind $0.1
2609e300: posts big blind $0.25
*** HOLE CARDS ***
Dealt to 7ac43878 
Dealt to 5d360146 
Dealt to 2609e300 
Dealt to Hero [9s 3d]
Dealt to 8b8d197c 
Dealt to 45920dbc 
Hero: folds
8b8d197c: folds
45920dbc: raises $0.38 to $0.63
7ac43878: calls $0.63
5d360146: folds
2609e300: folds
*** FLOP *** [Jd 8s 5s]
45920dbc: checks
7ac43878: bets $0.9
45920dbc: folds
Uncalled bet ($0.9) returned to 7ac43878
*** SHOWDOWN ***
7ac43878 collected $1.61 from pot
*** SUMMARY ***
Total pot $1.61
Board [Jd 8s 5s]
Seat 1: 7ac43878 (button) won ($1.61)
Seat 2: 5d360146 (small blind) folded before Flop
Seat 3: 2609e300 (big blind) folded before Flop
Seat 4: Hero folded before Flop (didn't bet)
Seat 5: 8b8d197c folded before Flop (didn't bet)
Seat 6: 45920dbc folded on the Flop


Poker Hand #RC95083251: Hold'em No Limit ($0.1/$0.25) - 2020/04/07 15:12:49
Table 'RushAndCash363636' 6-max Seat #1 is the button
Seat 1: 8b8d197c ($25 in chips)
Seat 2: Hero ($31.91 in chips)
Seat 3: be711e9d ($29.32 in chips)
Seat 4: 258d376e ($25 in chips)
Seat 5: 5d360146 ($11.9 in chips)
Seat 6: accea393 ($41.97 in chips)
Hero: posts small blind $0.1
be711e9d: posts big blind $0.25
*** HOLE CARDS ***
Dealt to 8b8d197c 
Dealt to Hero [Kh 7h]
Dealt to be711e9d 
Dealt to 258d376e 
Dealt to 5d360146 
Dealt to accea393 
258d376e: folds
5d360146: folds
accea393: folds
8b8d197c: folds
Hero: raises $0.5 to $0.75
be711e9d: folds
Uncalled bet ($0.5) returned to Hero
*** SHOWDOWN ***
Hero collected $0.5 from pot
*** SUMMARY ***
Total pot $0.5
Seat 1: 8b8d197c (button) folded before Flop (didn't bet)
Seat 2: Hero (small blind) collected ($0.5)
Seat 3: be711e9d (big blind) folded before Flop
Seat 4: 258d376e folded before Flop (didn't bet)
Seat 5: 5d360146 folded before Flop (didn't bet)
Seat 6: accea393 folded before Flop (didn't bet)


Poker Hand #RC95083367: Hold'em No Limit ($0.1/$0.25) - 2020/04/07 15:13:03
Table 'RushAndCash363656' 6-max Seat #1 is the button
Seat 1: 90ddca47 ($31.42 in chips)
Seat 2: 36017ad1 ($33.01 in chips)
Seat 3: 20c221eb ($12 in chips)
Seat 4: 32953d2a ($13.2 in chips)
Seat 5: Hero ($32.16 in chips)
Seat 6: 289f2e46 ($40.98 in chips)
36017ad1: posts small blind $0.1
20c221eb: posts big blind $0.25
*** HOLE CARDS ***
Dealt to 90ddca47 
Dealt to 36017ad1 
Dealt to 20c221eb 
Dealt to 32953d2a 
Dealt to Hero [Qs Jc]
Dealt to 289f2e46 
32953d2a: folds
Hero: raises $0.38 to $0.63
289f2e46: folds
90ddca47: folds
36017ad1: calls $0.53
20c221eb: folds
*** FLOP *** [9c 8d Ks]
36017ad1: checks
Hero: bets $0.5
36017ad1: folds
Uncalled bet ($0.5) returned to Hero
*** SHOWDOWN ***
Hero collected $1.51 from pot
*** SUMMARY ***
Total pot $1.51
Board [9c 8d Ks]
Seat 1: 90ddca47 (button) folded before Flop (didn't bet)
Seat 2: 36017ad1 (small blind) folded on the Flop
Seat 3: 20c221eb (big blind) folded before Flop
Seat 4: 32953d2a folded before Flop (didn't bet)
Seat 5: Hero won ($1.51)
Seat 6: 289f2e46 folded before Flop (didn't bet)


Poker Hand #RC95083570: Hold'em No Limit ($0.1/$0.25) - 2020/04/07 15:13:28
Table 'RushAndCash363687' 6-max Seat #1 is the button
Seat 1: 79cc211c ($25.78 in chips)
Seat 2: c88456c4 ($13.99 in chips)
Seat 3: fe3f48f4 ($27.19 in chips)
Seat 4: 3ff56a6c ($25.56 in chips)
Seat 5: 91c71347 ($25.35 in chips)
Seat 6: Hero ($32.97 in chips)
c88456c4: posts small blind $0.1
fe3f48f4: posts big blind $0.25
*** HOLE CARDS ***
Dealt to 79cc211c 
Dealt to c88456c4 
Dealt to fe3f48f4 
Dealt to 3ff56a6c 
Dealt to 91c71347 
Dealt to Hero [Ac 5c]
3ff56a6c: folds
91c71347: folds
Hero: raises $0.38 to $0.63
79cc211c: folds
c88456c4: raises $1.57 to $2.2
fe3f48f4: folds
Hero: folds
Uncalled bet ($1.57) returned to c88456c4
*** SHOWDOWN ***
c88456c4 collected $1.51 from pot
*** SUMMARY ***
Total pot $1.51
Seat 1: 79cc211c (button) folded before Flop (didn't bet)
Seat 2: c88456c4 (small blind) collected ($1.51)
Seat 3: fe3f48f4 (big blind) folded before Flop
Seat 4: 3ff56a6c folded before Flop (didn't bet)
Seat 5: 91c71347 folded before Flop (didn't bet)
Seat 6: Hero folded before Flop


Poker Hand #RC95083698: Hold'em No Limit ($0.1/$0.25) - 2020/04/07 15:13:44
Table 'RushAndCash363704' 6-max Seat #1 is the button
Seat 1: 3f5f9735 ($19.82 in chips)
Seat 2: bda1b4ce ($25 in chips)
Seat 3: Hero ($32.34 in chips)
Seat 4: 7ac43878 ($18.99 in chips)
Seat 5: 82ace6d5 ($25 in chips)
Seat 6: 518d077e ($25.35 in chips)
bda1b4ce: posts small blind $0.1
Hero: posts big blind $0.25
*** HOLE CARDS ***
Dealt to 3f5f9735 
Dealt to bda1b4ce 
Dealt to Hero [6h 4h]
Dealt to 7ac43878 
Dealt to 82ace6d5 
Dealt to 518d077e 
7ac43878: calls $0.25
82ace6d5: folds
518d077e: folds
3f5f9735: folds
bda1b4ce: calls $0.15
Hero: checks
*** FLOP *** [2s Jd 5c]
bda1b4ce: checks
Hero: checks
7ac43878: bets $0.8
bda1b4ce: folds
Hero: calls $0.8
*** TURN *** [2s Jd 5c] [2d]
Hero: checks
7ac43878: checks
*** RIVER *** [2s Jd 5c 2d] [4c]
Hero: checks
7ac43878: bets $2.4
Hero: folds
Uncalled bet ($2.4) returned to 7ac43878
*** SHOWDOWN ***
7ac43878 collected $2.35 from pot
*** SUMMARY ***
Total pot $2.35
Board [2s Jd 5c 2d 4c]
Seat 1: 3f5f9735 (button) folded before Flop (didn't bet)
Seat 2: bda1b4ce (small blind) folded on the Flop
Seat 3: Hero (big blind) folded on the River
Seat 4: 7ac43878 won ($2.35)
Seat 5: 82ace6d5 folded before Flop (didn't bet)
Seat 6: 518d077e folded before Flop (didn't bet)


Poker Hand #RC95084076: Hold'em No Limit ($0.1/$0.25) - 2020/04/07 15:14:34
Table 'RushAndCash363769' 6-max Seat #1 is the button
Seat 1: d07b3de1 ($32.12 in chips)
Seat 2: Hero ($31.29 in chips)
Seat 3: 7ed3ab6b ($51.13 in chips)
Seat 4: 50ccb9a1 ($21.71 in chips)
Seat 5: 20c221eb ($14.19 in chips)
Seat 6: caa68458 ($25 in chips)
Hero: posts small blind $0.1
7ed3ab6b: posts big blind $0.25
*** HOLE CARDS ***
Dealt to d07b3de1 
Dealt to Hero [Ah Qs]
Dealt to 7ed3ab6b 
Dealt to 50ccb9a1 
Dealt to 20c221eb 
Dealt to caa68458 
50ccb9a1: folds
20c221eb: folds
caa68458: folds
d07b3de1: folds
Hero: raises $0.5 to $0.75
7ed3ab6b: raises $1.5 to $2.25
Hero: raises $3.45 to $5.7
7ed3ab6b: calls $3.45
*** FLOP *** [Td 3d 8d]
Hero: bets $8.6
7ed3ab6b: calls $8.6
*** TURN *** [Td 3d 8d] [7s]
Hero: checks
7ed3ab6b: checks
*** RIVER *** [Td 3d 8d 7s] [6d]
Hero: checks
7ed3ab6b: bets $9.5
Hero: folds
Uncalled bet ($9.5) returned to 7ed3ab6b
*** SHOWDOWN ***
7ed3ab6b collected $28.6 from pot
*** SUMMARY ***
Total pot $28.6
Board [Td 3d 8d 7s 6d]
Seat 1: d07b3de1 (button) folded before Flop (didn't bet)
Seat 2: Hero (small blind) folded on the River
Seat 3: 7ed3ab6b (big blind) won ($28.6)
Seat 4: 50ccb9a1 folded before Flop (didn't bet)
Seat 5: 20c221eb folded before Flop (didn't bet)
Seat 6: caa68458 folded before Flop (didn't bet)


Poker Hand #RC95084617: Hold'em No Limit ($0.1/$0.25) - 2020/04/07 15:15:43
Table 'RushAndCash363860' 6-max Seat #1 is the button
Seat 1: Hero ($25 in chips)
Seat 2: 832cd074 ($25 in chips)
Seat 3: bda1b4ce ($25.35 in chips)
Seat 4: d07b3de1 ($31.87 in chips)
Seat 5: 7ed3ab6b ($64.43 in chips)
Seat 6: bbb85b3f ($38.61 in chips)
832cd074: posts small blind $0.1
bda1b4ce: posts big blind $0.25
*** HOLE CARDS ***
Dealt to Hero [Ts 3h]
Dealt to 832cd074 
Dealt to bda1b4ce 
Dealt to d07b3de1 
Dealt to 7ed3ab6b 
Dealt to bbb85b3f 
d07b3de1: folds
7ed3ab6b: raises $0.38 to $0.63
bbb85b3f: folds
Hero: folds
832cd074: folds
bda1b4ce: folds
Uncalled bet ($0.38) returned to 7ed3ab6b
*** SHOWDOWN ***
7ed3ab6b collected $0.6 from pot
*** SUMMARY ***
Total pot $0.6
Seat 1: Hero (button) folded before Flop (didn't bet)
Seat 2: 832cd074 (small blind) folded before Flop
Seat 3: bda1b4ce (big blind) folded before Flop
Seat 4: d07b3de1 folded before Flop (didn't bet)
Seat 5: 7ed3ab6b collected ($0.6)
Seat 6: bbb85b3f folded before Flop (didn't bet)


Poker Hand #RC95084652: Hold'em No Limit ($0.1/$0.25) - 2020/04/07 15:15:47
Table 'RushAndCash363867' 6-max Seat #1 is the button
Seat 1: 2dd038c3 ($10.36 in chips)
Seat 2: a2f2938c ($25 in chips)
Seat 3: 3c96062f ($33.84 in chips)
Seat 4: 74937d40 ($31 in chips)
Seat 5: Hero ($25 in chips)
Seat 6: 3423a84d ($21.92 in chips)
a2f2938c: posts small blind $0.1
3c96062f: posts big blind $0.25
*** HOLE CARDS ***
Dealt to 2dd038c3 
Dealt to a2f2938c 
Dealt to 3c96062f 
Dealt to 74937d40 
Dealt to Hero [Js Jh]
Dealt to 3423a84d 
74937d40: folds
Hero: raises $0.38 to $0.63
3423a84d: folds
2dd038c3: folds
a2f2938c: folds
3c96062f: folds
Uncalled bet ($0.38) returned to Hero
*** SHOWDOWN ***
Hero collected $0.6 from pot
*** SUMMARY ***
Total pot $0.6
Seat 1: 2dd038c3 (button) folded before Flop (didn't bet)
Seat 2: a2f2938c (small blind) folded before Flop
Seat 3: 3c96062f (big blind) folded before Flop
Seat 4: 74937d40 folded before Flop (didn't bet)
Seat 5: Hero collected ($0.6)
Seat 6: 3423a84d folded before Flop (didn't bet)


Poker Hand #RC95084823: Hold'em No Limit ($0.1/$0.25) - 2020/04/07 15:16:10
Table 'RushAndCash363895' 6-max Seat #1 is the button
Seat 1: 7e4944ca ($25.15 in chips)
Seat 2: 32953d2a ($13.15 in chips)
Seat 3: 3423a84d ($21.42 in chips)
Seat 4: 4dd920ba ($25.74 in chips)
Seat 5: Hero ($25.35 in chips)
Seat 6: a2f2938c ($25 in chips)
32953d2a: posts small blind $0.1
3423a84d: posts big blind $0.25
*** HOLE CARDS ***
Dealt to 7e4944ca 
Dealt to 32953d2a 
Dealt to 3423a84d 
Dealt to 4dd920ba 
Dealt to Hero [5s 4h]
Dealt to a2f2938c 
4dd920ba: folds
Hero: folds
a2f2938c: folds
7e4944ca: folds
32953d2a: calls $0.15
3423a84d: checks
*** FLOP *** [3c 5c 8h]
32953d2a: checks
3423a84d: checks
*** TURN *** [3c 5c 8h] [9h]
32953d2a: checks
3423a84d: checks
*** RIVER *** [3c 5c 8h 9h] [8d]
32953d2a: checks
3423a84d: checks
32953d2a: shows [6c 6d] (Pair of Eights and Pair of Sixes)
3423a84d: shows [7c Th] (Pair of Eights)
*** SHOWDOWN ***
32953d2a collected $0.5 from pot
*** SUMMARY ***
Total pot $0.5
Board [3c 5c 8h 9h 8d]
Seat 1: 7e4944ca (button) folded before Flop (didn't bet)
Seat 2: 32953d2a (small blind) showed [6d 6c] and won ($0.5) with Pair of Eights and Pair of Sixes
Seat 3: 3423a84d (big blind) showed [Th 7c] and lost with Pair of Eights
Seat 4: 4dd920ba folded before Flop (didn't bet)
Seat 5: Hero folded before Flop (didn't bet)
Seat 6: a2f2938c folded before Flop (didn't bet)


Poker Hand #RC95084858: Hold'em No Limit ($0.1/$0.25) - 2020/04/07 15:16:13
Table 'RushAndCash363902' 6-max Seat #1 is the button
Seat 1: Hero ($25.35 in chips)
Seat 2: 3423a84d ($21.17 in chips)
Seat 3: 65837850 ($135.77 in chips)
Seat 4: bec2d88d ($30.39 in chips)
Seat 5: a75a3d24 ($32.73 in chips)
Seat 6: 7e4944ca ($25.15 in chips)
3423a84d: posts small blind $0.1
65837850: posts big blind $0.25
*** HOLE CARDS ***
Dealt to Hero [7c 4s]
Dealt to 3423a84d 
Dealt to 65837850 
Dealt to bec2d88d 
Dealt to a75a3d24 
Dealt to 7e4944ca 
bec2d88d: folds
a75a3d24: folds
7e4944ca: folds
Hero: folds
3423a84d: calls $0.15
65837850: raises $0.65 to $0.9
3423a84d: calls $0.65
*** FLOP *** [3s 2c Kd]
3423a84d: checks
65837850: bets $0.9
3423a84d: calls $0.9
*** TURN *** [3s 2c Kd] [Kc]
3423a84d: checks
65837850: bets $2.1
3423a84d: calls $2.1
*** RIVER *** [3s 2c Kd Kc] [Kh]
3423a84d: checks
65837850: checks
3423a84d: shows [7d Ad] (Three Kings)
65837850: shows [6h 8h] (Three Kings)
*** SHOWDOWN ***
3423a84d collected $7.8 from pot
*** SUMMARY ***
Total pot $7.8
Board [3s 2c Kd Kc Kh]
Seat 1: Hero (button) folded before Flop (didn't bet)
Seat 2: 3423a84d (small blind) showed [Ad 7d] and won ($7.8) with Three Kings
Seat 3: 65837850 (big blind) showed [8h 6h] and lost with Three Kings
Seat 4: bec2d88d folded before Flop (didn't bet)
Seat 5: a75a3d24 folded before Flop (didn't bet)
Seat 6: 7e4944ca folded before Flop (didn't bet)


Poker Hand #RC95084892: Hold'em No Limit ($0.1/$0.25) - 2020/04/07 15:16:18
Table 'RushAndCash363907' 6-max Seat #1 is the button
Seat 1: 49b3e425 ($12.52 in chips)
Seat 2: Hero ($25.35 in chips)
Seat 3: ce59b684 ($32.98 in chips)
Seat 4: b431c8b6 ($25 in chips)
Seat 5: 432498db ($25 in chips)
Seat 6: 61ad32d ($12.5 in chips)
Hero: posts small blind $0.1
ce59b684: posts big blind $0.25
*** HOLE CARDS ***
Dealt to 49b3e425 
Dealt to Hero [8c 2s]
Dealt to ce59b684 
Dealt to b431c8b6 
Dealt to 432498db 
Dealt to 61ad32d 
b431c8b6: folds
432498db: folds
61ad32d: folds
49b3e425: raises $0.25 to $0.5
Hero: folds
ce59b684: folds
Uncalled bet ($0.25) returned to 49b3e425
*** SHOWDOWN ***
49b3e425 collected $0.6 from pot
*** SUMMARY ***
Total pot $0.6
Seat 1: 49b3e425 (button) collected ($0.6)
Seat 2: Hero (small blind) folded before Flop
Seat 3: ce59b684 (big blind) folded before Flop
Seat 4: b431c8b6 folded before Flop (didn't bet)
Seat 5: 432498db folded before Flop (didn't bet)
Seat 6: 61ad32d folded before Flop (didn't bet)


Poker Hand #RC95084920: Hold'em No Limit ($0.1/$0.25) - 2020/04/07 15:16:21
Table 'RushAndCash363911' 6-max Seat #1 is the button
Seat 1: 832cd074 ($25 in chips)
Seat 2: fe5b2431 ($12.5 in chips)
Seat 3: 36017ad1 ($32.73 in chips)
Seat 4: a75a3d24 ($32.73 in chips)
Seat 5: 5794e88f ($38.64 in chips)
Seat 6: Hero ($25.25 in chips)
fe5b2431: posts small blind $0.1
36017ad1: posts big blind $0.25
*** HOLE CARDS ***
Dealt to 832cd074 
Dealt to fe5b2431 
Dealt to 36017ad1 
Dealt to a75a3d24 
Dealt to 5794e88f 
Dealt to Hero [7c 4d]
a75a3d24: folds
5794e88f: raises $0.38 to $0.63
Hero: folds
832cd074: folds
fe5b2431: folds
36017ad1: folds
Uncalled bet ($0.38) returned to 5794e88f
*** SHOWDOWN ***
5794e88f collected $0.6 from pot
*** SUMMARY ***
Total pot $0.6
Seat 1: 832cd074 (button) folded before Flop (didn't bet)
Seat 2: fe5b2431 (small blind) folded before Flop
Seat 3: 36017ad1 (big blind) folded before Flop
Seat 4: a75a3d24 folded before Flop (didn't bet)
Seat 5: 5794e88f collected ($0.6)
Seat 6: Hero folded before Flop (didn't bet)


Poker Hand #RC95084955: Hold'em No Limit ($0.1/$0.25) - 2020/04/07 15:16:25
Table 'RushAndCash363917' 6-max Seat #1 is the button
Seat 1: 1780ed6 ($56.08 in chips)
Seat 2: cae4d8ce ($10.04 in chips)
Seat 3: a75a3d24 ($32.73 in chips)
Seat 4: 94e745c ($22.9 in chips)
Seat 5: Hero ($25.25 in chips)
Seat 6: 275e7f74 ($28.04 in chips)
cae4d8ce: posts small blind $0.1
a75a3d24: posts big blind $0.25
*** HOLE CARDS ***
Dealt to 1780ed6 
Dealt to cae4d8ce 
Dealt to a75a3d24 
Dealt to 94e745c 
Dealt to Hero [Qd 2h]
Dealt to 275e7f74 
94e745c: folds
Hero: folds
275e7f74: folds
1780ed6: folds
cae4d8ce: raises $0.38 to $0.63
a75a3d24: folds
Uncalled bet ($0.38) returned to cae4d8ce
*** SHOWDOWN ***
cae4d8ce collected $0.5 from pot
*** SUMMARY ***
Total pot $0.5
Seat 1: 1780ed6 (button) folded before Flop (didn't bet)
Seat 2: cae4d8ce (small blind) collected ($0.5)
Seat 3: a75a3d24 (big blind) folded before Flop
Seat 4: 94e745c folded before Flop (didn't bet)
Seat 5: Hero folded before Flop (didn't bet)
Seat 6: 275e7f74 folded before Flop (didn't bet)


Poker Hand #RC95084986: Hold'em No Limit ($0.1/$0.25) - 2020/04/07 15:16:28
Table 'RushAndCash363922' 6-max Seat #1 is the button
Seat 1: a4ba858f ($31.82 in chips)
Seat 2: 3cfd7308 ($40.7 in chips)
Seat 3: Hero ($25.25 in chips)
Seat 4: acf1a889 ($12.5 in chips)
Seat 5: 6736194e ($23.26 in chips)
Seat 6: 5d360146 ($9.52 in chips)
3cfd7308: posts small blind $0.1
Hero: posts big blind $0.25
*** HOLE CARDS ***
Dealt to a4ba858f 
Dealt to 3cfd7308 
Dealt to Hero [Kh 5c]
Dealt to acf1a889 
Dealt to 6736194e 
Dealt to 5d360146 
acf1a889: folds
6736194e: folds
5d360146: folds
a4ba858f: folds
3cfd7308: folds
Uncalled bet ($0.15) returned to Hero
*** SHOWDOWN ***
Hero collected $0.2 from pot
*** SUMMARY ***
Total pot $0.2
Seat 1: a4ba858f (button) folded before Flop (didn't bet)
Seat 2: 3cfd7308 (small blind) folded before Flop
Seat 3: Hero (big blind) collected ($0.2)
Seat 4: acf1a889 folded before Flop (didn't bet)
Seat 5: 6736194e folded before Flop (didn't bet)
Seat 6: 5d360146 folded before Flop (didn't bet)


Poker Hand #RC95085038: Hold'em No Limit ($0.1/$0.25) - 2020/04/07 15:16:34
Table 'RushAndCash363932' 6-max Seat #1 is the button
Seat 1: 603fb192 ($14.66 in chips)
Seat 2: deb69778 ($30.27 in chips)
Seat 3: 258d376e ($26.02 in chips)
Seat 4: Hero ($25 in chips)
Seat 5: 89387862 ($25 in chips)
Seat 6: 18075352 ($22.09 in chips)
deb69778: posts small blind $0.1
258d376e: posts big blind $0.25
*** HOLE CARDS ***
Dealt to 603fb192 
Dealt to deb69778 
Dealt to 258d376e 
Dealt to Hero [Kc 9s]
Dealt to 89387862 
Dealt to 18075352 
Hero: folds
89387862: folds
18075352: folds
603fb192: raises $0.38 to $0.63
deb69778: folds
258d376e: calls $0.38
*** FLOP *** [4s 2h Th]
258d376e: checks
603fb192: bets $0.7
258d376e: calls $0.7
*** TURN *** [4s 2h Th] [Jc]
258d376e: checks
603fb192: bets $3
258d376e: folds
Uncalled bet ($3) returned to 603fb192
*** SHOWDOWN ***
603fb192 collected $2.76 from pot
*** SUMMARY ***
Total pot $2.76
Board [4s 2h Th Jc]
Seat 1: 603fb192 (button) won ($2.76)
Seat 2: deb69778 (small blind) folded before Flop
Seat 3: 258d376e (big blind) folded on the Turn
Seat 4: Hero folded before Flop (didn't bet)
Seat 5: 89387862 folded before Flop (didn't bet)
Seat 6: 18075352 folded before Flop (didn't bet)


Poker Hand #RC95085069: Hold'em No Limit ($0.1/$0.25) - 2020/04/07 15:16:39
Table 'RushAndCash363937' 6-max Seat #1 is the button
Seat 1: 3c96062f ($32.86 in chips)
Seat 2: ce59b684 ($32.48 in chips)
Seat 3: 7e4944ca ($25.15 in chips)
Seat 4: Hero ($25 in chips)
Seat 5: bfa55601 ($13.1 in chips)
Seat 6: 18075352 ($22.09 in chips)
ce59b684: posts small blind $0.1
7e4944ca: posts big blind $0.25
*** HOLE CARDS ***
Dealt to 3c96062f 
Dealt to ce59b684 
Dealt to 7e4944ca 
Dealt to Hero [Th 3h]
Dealt to bfa55601 
Dealt to 18075352 
Hero: folds
bfa55601: folds
18075352: folds
3c96062f: folds
ce59b684: folds
Uncalled bet ($0.15) returned to 7e4944ca
*** SHOWDOWN ***
7e4944ca collected $0.2 from pot
*** SUMMARY ***
Total pot $0.2
Seat 1: 3c96062f (button) folded before Flop (didn't bet)
Seat 2: ce59b684 (small blind) folded before Flop
Seat 3: 7e4944ca (big blind) collected ($0.2)
Seat 4: Hero folded before Flop (didn't bet)
Seat 5: bfa55601 folded before Flop (didn't bet)
Seat 6: 18075352 folded before Flop (didn't bet)


Poker Hand #RC95085138: Hold'em No Limit ($0.1/$0.25) - 2020/04/07 15:16:46
Table 'RushAndCash363949' 6-max Seat #1 is the button
Seat 1: af84e661 ($5.77 in chips)
Seat 2: 3c96062f ($32.61 in chips)
Seat 3: e1071a91 ($32.98 in chips)
Seat 4: 9f138297 ($31.68 in chips)
Seat 5: Hero ($25.35 in chips)
Seat 6: a6fc3bd6 ($27.89 in chips)
3c96062f: posts small blind $0.1
e1071a91: posts big blind $0.25
*** HOLE CARDS ***
Dealt to af84e661 
Dealt to 3c96062f 
Dealt to e1071a91 
Dealt to 9f138297 
Dealt to Hero [Qs 8d]
Dealt to a6fc3bd6 
9f138297: raises $0.25 to $0.5
Hero: folds
a6fc3bd6: folds
af84e661: folds
3c96062f: folds
e1071a91: calls $0.25
*** FLOP *** [Jc 9s Ad]
e1071a91: checks
9f138297: bets $0.6
e1071a91: folds
Uncalled bet ($0.6) returned to 9f138297
*** SHOWDOWN ***
9f138297 collected $1.1 from pot
*** SUMMARY ***
Total pot $1.1
Board [Jc 9s Ad]
Seat 1: af84e661 (button) folded before Flop (didn't bet)
Seat 2: 3c96062f (small blind) folded before Flop
Seat 3: e1071a91 (big blind) folded on the Flop
Seat 4: 9f138297 won ($1.1)
Seat 5: Hero folded before Flop (didn't bet)
Seat 6: a6fc3bd6 folded before Flop (didn't bet)


Poker Hand #RC95085181: Hold'em No Limit ($0.1/$0.25) - 2020/04/07 15:16:52
Table 'RushAndCash363956' 6-max Seat #1 is the button
Seat 1: 27485ddf ($15.76 in chips)
Seat 2: bf64de7f ($10.52 in chips)
Seat 3: ce2bf8ea ($25 in chips)
Seat 4: Hero ($25.35 in chips)
Seat 5: 895c14a7 ($12.5 in chips)
Seat 6: fd9dacc9 ($32.85 in chips)
bf64de7f: posts small blind $0.1
ce2bf8ea: posts big blind $0.25
*** HOLE CARDS ***
Dealt to 27485ddf 
Dealt to bf64de7f 
Dealt to ce2bf8ea 
Dealt to Hero [Kh 9c]
Dealt to 895c14a7 
Dealt to fd9dacc9 
Hero: folds
895c14a7: folds
fd9dacc9: folds
27485ddf: folds
bf64de7f: raises $0.25 to $0.5
ce2bf8ea: calls $0.25
*** FLOP *** [Kd Qh 2c]
bf64de7f: checks
ce2bf8ea: bets $0.5
bf64de7f: folds
Uncalled bet ($0.5) returned to ce2bf8ea
*** SHOWDOWN ***
ce2bf8ea collected $1 from pot
*** SUMMARY ***
Total pot $1
Board [Kd Qh 2c]
Seat 1: 27485ddf (button) folded before Flop (didn't bet)
Seat 2: bf64de7f (small blind) folded on the Flop
Seat 3: ce2bf8ea (big blind) won ($1)
Seat 4: Hero folded before Flop (didn't bet)
Seat 5: 895c14a7 folded before Flop (didn't bet)
Seat 6: fd9dacc9 folded before Flop (didn't bet)


Poker Hand #RC95085208: Hold'em No Limit ($0.1/$0.25) - 2020/04/07 15:16:56
Table 'RushAndCash363960' 6-max Seat #1 is the button
Seat 1: be711e9d ($29.11 in chips)
Seat 2: d84d476b ($26.39 in chips)
Seat 3: Hero ($25.35 in chips)
Seat 4: 8ebd1db4 ($30.6 in chips)
Seat 5: 45920dbc ($42.4 in chips)
Seat 6: d07b3de1 ($31.42 in chips)
d84d476b: posts small blind $0.1
Hero: posts big blind $0.25
*** HOLE CARDS ***
Dealt to be711e9d 
Dealt to d84d476b 
Dealt to Hero [Ad 5h]
Dealt to 8ebd1db4 
Dealt to 45920dbc 
Dealt to d07b3de1 
8ebd1db4: folds
45920dbc: folds
d07b3de1: folds
be711e9d: raises $0.38 to $0.63
d84d476b: raises $1.87 to $2.5
Hero: folds
be711e9d: folds
Uncalled bet ($1.87) returned to d84d476b
*** SHOWDOWN ***
d84d476b collected $1.51 from pot
*** SUMMARY ***
Total pot $1.51
Seat 1: be711e9d (button) folded before Flop
Seat 2: d84d476b (small blind) collected ($1.51)
Seat 3: Hero (big blind) folded before Flop
Seat 4: 8ebd1db4 folded before Flop (didn't bet)
Seat 5: 45920dbc folded before Flop (didn't bet)
Seat 6: d07b3de1 folded before Flop (didn't bet)


Poker Hand #RC95085249: Hold'em No Limit ($0.1/$0.25) - 2020/04/07 15:17:01
Table 'RushAndCash363966' 6-max Seat #1 is the button
Seat 1: 3c96062f ($32.86 in chips)
Seat 2: Hero ($25.1 in chips)
Seat 3: af84e661 ($5.77 in chips)
Seat 4: 1a2581ce ($25 in chips)
Seat 5: 7c0ffa93 ($28.99 in chips)
Seat 6: e6c023d1 ($37.9 in chips)
Hero: posts small blind $0.1
af84e661: posts big blind $0.25
*** HOLE CARDS ***
Dealt to 3c96062f 
Dealt to Hero [Ts 6d]
Dealt to af84e661 
Dealt to 1a2581ce 
Dealt to 7c0ffa93 
Dealt to e6c023d1 
1a2581ce: folds
7c0ffa93: folds
e6c023d1: raises $0.38 to $0.63
3c96062f: folds
Hero: folds
af84e661: folds
Uncalled bet ($0.38) returned to e6c023d1
*** SHOWDOWN ***
e6c023d1 collected $0.6 from pot
*** SUMMARY ***
Total pot $0.6
Seat 1: 3c96062f (button) folded before Flop (didn't bet)
Seat 2: Hero (small blind) folded before Flop
Seat 3: af84e661 (big blind) folded before Flop
Seat 4: 1a2581ce folded before Flop (didn't bet)
Seat 5: 7c0ffa93 folded before Flop (didn't bet)
Seat 6: e6c023d1 collected ($0.6)


Poker Hand #RC95085277: Hold'em No Limit ($0.1/$0.25) - 2020/04/07 15:17:05
Table 'RushAndCash363970' 6-max Seat #1 is the button
Seat 1: Hero ($25 in chips)
Seat 2: ce59b684 ($32.13 in chips)
Seat 3: acf1a889 ($12.5 in chips)
Seat 4: fd9dacc9 ($32.85 in chips)
Seat 5: 29100105 ($35.39 in chips)
Seat 6: fe5b2431 ($12.85 in chips)
ce59b684: posts small blind $0.1
acf1a889: posts big blind $0.25
*** HOLE CARDS ***
Dealt to Hero [Qs 3d]
Dealt to ce59b684 
Dealt to acf1a889 
Dealt to fd9dacc9 
Dealt to 29100105 
Dealt to fe5b2431 
fd9dacc9: folds
29100105: folds
fe5b2431: folds
Hero: folds
ce59b684: folds
Uncalled bet ($0.15) returned to acf1a889
*** SHOWDOWN ***
acf1a889 collected $0.2 from pot
*** SUMMARY ***
Total pot $0.2
Seat 1: Hero (button) folded before Flop (didn't bet)
Seat 2: ce59b684 (small blind) folded before Flop
Seat 3: acf1a889 (big blind) collected ($0.2)
Seat 4: fd9dacc9 folded before Flop (didn't bet)
Seat 5: 29100105 folded before Flop (didn't bet)
Seat 6: fe5b2431 folded before Flop (didn't bet)


Poker Hand #RC95085308: Hold'em No Limit ($0.1/$0.25) - 2020/04/07 15:17:09
Table 'RushAndCash363974' 6-max Seat #1 is the button
Seat 1: 2609e300 ($13.08 in chips)
Seat 2: 44495cc2 ($44.78 in chips)
Seat 3: 528a07f8 ($35.2 in chips)
Seat 4: 1780ed6 ($55.63 in chips)
Seat 5: cae4d8ce ($10.04 in chips)
Seat 6: Hero ($25 in chips)
44495cc2: posts small blind $0.1
528a07f8: posts big blind $0.25
*** HOLE CARDS ***
Dealt to 2609e300 
Dealt to 44495cc2 
Dealt to 528a07f8 
Dealt to 1780ed6 
Dealt to cae4d8ce 
Dealt to Hero [7h 5s]
1780ed6: folds
cae4d8ce: folds
Hero: folds
2609e300: folds
44495cc2: folds
Uncalled bet ($0.15) returned to 528a07f8
*** SHOWDOWN ***
528a07f8 collected $0.2 from pot
*** SUMMARY ***
Total pot $0.2
Seat 1: 2609e300 (button) folded before Flop (didn't bet)
Seat 2: 44495cc2 (small blind) folded before Flop
Seat 3: 528a07f8 (big blind) collected ($0.2)
Seat 4: 1780ed6 folded before Flop (didn't bet)
Seat 5: cae4d8ce folded before Flop (didn't bet)
Seat 6: Hero folded before Flop (didn't bet)


Poker Hand #RC95085390: Hold'em No Limit ($0.1/$0.25) - 2020/04/07 15:17:19
Table 'RushAndCash363988' 6-max Seat #1 is the button
Seat 1: deb69778 ($30.62 in chips)
Seat 2: Hero ($25 in chips)
Seat 3: 7c0ffa93 ($28.99 in chips)
Seat 4: 44495cc2 ($44.68 in chips)
Seat 5: 1055451d ($12.5 in chips)
Seat 6: fe3f48f4 ($28.02 in chips)
Hero: posts small blind $0.1
7c0ffa93: posts big blind $0.25
*** HOLE CARDS ***
Dealt to deb69778 
Dealt to Hero [Jd 4s]
Dealt to 7c0ffa93 
Dealt to 44495cc2 
Dealt to 1055451d 
Dealt to fe3f48f4 
44495cc2: folds
1055451d: folds
fe3f48f4: folds
deb69778: folds
Hero: folds
Uncalled bet ($0.15) returned to 7c0ffa93
*** SHOWDOWN ***
7c0ffa93 collected $0.2 from pot
*** SUMMARY ***
Total pot $0.2
Seat 1: deb69778 (button) folded before Flop (didn't bet)
Seat 2: Hero (small blind) folded before Flop
Seat 3: 7c0ffa93 (big blind) collected ($0.2)
Seat 4: 44495cc2 folded before Flop (didn't bet)
Seat 5: 1055451d folded before Flop (didn't bet)
Seat 6: fe3f48f4 folded before Flop (didn't bet)


Poker Hand #RC95085419: Hold'em No Limit ($0.1/$0.25) - 2020/04/07 15:17:23
Table 'RushAndCash363993' 6-max Seat #1 is the button
Seat 1: Hero ($25 in chips)
Seat 2: cc092a76 ($9.2 in chips)
Seat 3: dbf6981f ($41.53 in chips)
Seat 4: d437c92d ($43.28 in chips)
Seat 5: deb69778 ($30.62 in chips)
Seat 6: d4f64153 ($25.47 in chips)
cc092a76: posts small blind $0.1
dbf6981f: posts big blind $0.25
*** HOLE CARDS ***
Dealt to Hero [Js 6s]
Dealt to cc092a76 
Dealt to dbf6981f 
Dealt to d437c92d 
Dealt to deb69778 
Dealt to d4f64153 
d437c92d: folds
deb69778: raises $0.38 to $0.63
d4f64153: calls $0.63
Hero: folds
cc092a76: folds
dbf6981f: folds
*** FLOP *** [9s 7s Qd]
deb69778: bets $0.9
d4f64153: raises $2.3 to $3.2
deb69778: folds
Uncalled bet ($2.3) returned to d4f64153
*** SHOWDOWN ***
d4f64153 collected $3.41 from pot
*** SUMMARY ***
Total pot $3.41
Board [9s 7s Qd]
Seat 1: Hero (button) folded before Flop (didn't bet)
Seat 2: cc092a76 (small blind) folded before Flop
Seat 3: dbf6981f (big blind) folded before Flop
Seat 4: d437c92d folded before Flop (didn't bet)
Seat 5: deb69778 folded on the Flop
Seat 6: d4f64153 won ($3.41)


Poker Hand #RC95085515: Hold'em No Limit ($0.1/$0.25) - 2020/04/07 15:17:35
Table 'RushAndCash364008' 6-max Seat #1 is the button
Seat 1: 7bf7c8c9 ($26.46 in chips)
Seat 2: 8a9a9c5f ($25.92 in chips)
Seat 3: f7ed681a ($12.75 in chips)
Seat 4: e4c4c11e ($12.52 in chips)
Seat 5: Hero ($25 in chips)
Seat 6: 518d077e ($25.7 in chips)
8a9a9c5f: posts small blind $0.1
f7ed681a: posts big blind $0.25
*** HOLE CARDS ***
Dealt to 7bf7c8c9 
Dealt to 8a9a9c5f 
Dealt to f7ed681a 
Dealt to e4c4c11e 
Dealt to Hero [Ad 3s]
Dealt to 518d077e 
e4c4c11e: folds
Hero: folds
518d077e: folds
7bf7c8c9: folds
8a9a9c5f: calls $0.15
f7ed681a: checks
*** FLOP *** [Ah 9c 5s]
8a9a9c5f: checks
f7ed681a: checks
*** TURN *** [Ah 9c 5s] [Ts]
8a9a9c5f: checks
f7ed681a: checks
*** RIVER *** [Ah 9c 5s Ts] [Js]
8a9a9c5f: checks
f7ed681a: checks
8a9a9c5f: shows [6s Kh] (Ace-High)
f7ed681a: shows [Qd Tc] (Pair of Tens)
*** SHOWDOWN ***
f7ed681a collected $0.5 from pot
*** SUMMARY ***
Total pot $0.5
Board [Ah 9c 5s Ts Js]
Seat 1: 7bf7c8c9 (button) folded before Flop (didn't bet)
Seat 2: 8a9a9c5f (small blind) showed [Kh 6s] and lost with Ace-High
Seat 3: f7ed681a (big blind) showed [Qd Tc] and won ($0.5) with Pair of Tens
Seat 4: e4c4c11e folded before Flop (didn't bet)
Seat 5: Hero folded before Flop (didn't bet)
Seat 6: 518d077e folded before Flop (didn't bet)


Poker Hand #RC95085560: Hold'em No Limit ($0.1/$0.25) - 2020/04/07 15:17:41
Table 'RushAndCash364016' 6-max Seat #1 is the button
Seat 1: a2f2938c ($25 in chips)
Seat 2: 89387862 ($25 in chips)
Seat 3: Hero ($25 in chips)
Seat 4: cc092a76 ($9.1 in chips)
Seat 5: 704c37d9 ($52.95 in chips)
Seat 6: 62eebc49 ($106.25 in chips)
89387862: posts small blind $0.1
Hero: posts big blind $0.25
*** HOLE CARDS ***
Dealt to a2f2938c 
Dealt to 89387862 
Dealt to Hero [6s 3d]
Dealt to cc092a76 
Dealt to 704c37d9 
Dealt to 62eebc49 
cc092a76: calls $0.25
704c37d9: folds
62eebc49: folds
a2f2938c: folds
89387862: folds
Hero: checks
*** FLOP *** [2s Js Kc]
Hero: checks
cc092a76: checks
*** TURN *** [2s Js Kc] [5s]
Hero: checks
cc092a76: bets $0.4
Hero: folds
Uncalled bet ($0.4) returned to cc092a76
*** SHOWDOWN ***
cc092a76 collected $0.6 from pot
*** SUMMARY ***
Total pot $0.6
Board [2s Js Kc 5s]
Seat 1: a2f2938c (button) folded before Flop (didn't bet)
Seat 2: 89387862 (small blind) folded before Flop
Seat 3: Hero (big blind) folded on the Turn
Seat 4: cc092a76 won ($0.6)
Seat 5: 704c37d9 folded before Flop (didn't bet)
Seat 6: 62eebc49 folded before Flop (didn't bet)


Poker Hand #RC95085603: Hold'em No Limit ($0.1/$0.25) - 2020/04/07 15:17:46
Table 'RushAndCash364024' 6-max Seat #1 is the button
Seat 1: 605bdd57 ($12.5 in chips)
Seat 2: 20b62793 ($64.35 in chips)
Seat 3: e1071a91 ($32.38 in chips)
Seat 4: 17388104 ($25.28 in chips)
Seat 5: Hero ($25 in chips)
Seat 6: 6a4f7541 ($28.66 in chips)
20b62793: posts small blind $0.1
e1071a91: posts big blind $0.25
*** HOLE CARDS ***
Dealt to 605bdd57 
Dealt to 20b62793 
Dealt to e1071a91 
Dealt to 17388104 
Dealt to Hero [Td Tc]
Dealt to 6a4f7541 
17388104: folds
Hero: raises $0.38 to $0.63
6a4f7541: folds
605bdd57: folds
20b62793: raises $1.17 to $1.8
e1071a91: folds
Hero: calls $1.17
*** FLOP *** [2c Jc Ts]
20b62793: checks
Hero: bets $1.3
20b62793: raises $1.7 to $3
Hero: calls $1.7
*** TURN *** [2c Jc Ts] [6c]
20b62793: checks
Hero: bets $7.4
20b62793: folds
Uncalled bet ($7.4) returned to Hero
*** SHOWDOWN ***
Hero collected $9.85 from pot
*** SUMMARY ***
Total pot $9.85
Board [2c Jc Ts 6c]
Seat 1: 605bdd57 (button) folded before Flop (didn't bet)
Seat 2: 20b62793 (small blind) folded on the Turn
Seat 3: e1071a91 (big blind) folded before Flop
Seat 4: 17388104 folded before Flop (didn't bet)
Seat 5: Hero won ($9.85)
Seat 6: 6a4f7541 folded before Flop (didn't bet)


Poker Hand #RC95086038: Hold'em No Limit ($0.1/$0.25) - 2020/04/07 15:18:42
Table 'RushAndCash364096' 6-max Seat #1 is the button
Seat 1: bfa55601 ($12.75 in chips)
Seat 2: 7ac43878 ($14.15 in chips)
Seat 3: e814b201 ($26.55 in chips)
Seat 4: Hero ($29.31 in chips)
Seat 5: 20b62793 ($59.55 in chips)
Seat 6: 49b3e425 ($21.27 in chips)
7ac43878: posts small blind $0.1
e814b201: posts big blind $0.25
*** HOLE CARDS ***
Dealt to bfa55601 
Dealt to 7ac43878 
Dealt to e814b201 
Dealt to Hero [Kh 3c]
Dealt to 20b62793 
Dealt to 49b3e425 
Hero: folds
20b62793: folds
49b3e425: folds
bfa55601: folds
7ac43878: calls $0.15
e814b201: raises $0.75 to $1
7ac43878: calls $0.75
*** FLOP *** [9d Qh Js]
7ac43878: checks
e814b201: checks
*** TURN *** [9d Qh Js] [3h]
7ac43878: bets $0.25
e814b201: folds
Uncalled bet ($0.25) returned to 7ac43878
*** SHOWDOWN ***
7ac43878 collected $2 from pot
*** SUMMARY ***
Total pot $2
Board [9d Qh Js 3h]
Seat 1: bfa55601 (button) folded before Flop (didn't bet)
Seat 2: 7ac43878 (small blind) won ($2)
Seat 3: e814b201 (big blind) folded on the Turn
Seat 4: Hero folded before Flop (didn't bet)
Seat 5: 20b62793 folded before Flop (didn't bet)
Seat 6: 49b3e425 folded before Flop (didn't bet)


Poker Hand #RC95086066: Hold'em No Limit ($0.1/$0.25) - 2020/04/07 15:18:46
Table 'RushAndCash364101' 6-max Seat #1 is the button
Seat 1: 4ab4e4a3 ($26.97 in chips)
Seat 2: Hero ($29.31 in chips)
Seat 3: 32953d2a ($12.5 in chips)
Seat 4: 6752758b ($14.11 in chips)
Seat 5: 20b62793 ($59.55 in chips)
Seat 6: 9f138297 ($31.25 in chips)
Hero: posts small blind $0.1
32953d2a: posts big blind $0.25
*** HOLE CARDS ***
Dealt to 4ab4e4a3 
Dealt to Hero [Ah 3d]
Dealt to 32953d2a 
Dealt to 6752758b 
Dealt to 20b62793 
Dealt to 9f138297 
6752758b: raises $0.38 to $0.63
20b62793: folds
9f138297: folds
4ab4e4a3: calls $0.63
Hero: folds
32953d2a: folds
*** FLOP *** [2h 9s 2c]
6752758b: checks
4ab4e4a3: bets $1
6752758b: calls $1
*** TURN *** [2h 9s 2c] [5c]
6752758b: checks
4ab4e4a3: bets $2
6752758b: raises $3.1 to $5.1
4ab4e4a3: folds
Uncalled bet ($3.1) returned to 6752758b
*** SHOWDOWN ***
6752758b collected $7.61 from pot
*** SUMMARY ***
Total pot $7.61
Board [2h 9s 2c 5c]
Seat 1: 4ab4e4a3 (button) folded on the Turn
Seat 2: Hero (small blind) folded before Flop
Seat 3: 32953d2a (big blind) folded before Flop
Seat 4: 6752758b won ($7.61)
Seat 5: 20b62793 folded before Flop (didn't bet)
Seat 6: 9f138297 folded before Flop (didn't bet)


Poker Hand #RC95086092: Hold'em No Limit ($0.1/$0.25) - 2020/04/07 15:18:50
Table 'RushAndCash364104' 6-max Seat #1 is the button
Seat 1: cb835642 ($28.22 in chips)
Seat 2: d6f2a39c ($9.29 in chips)
Seat 3: 95083363 ($32.02 in chips)
Seat 4: Hero ($29.21 in chips)
Seat 5: 20b62793 ($59.55 in chips)
Seat 6: 8b8d197c ($31.31 in chips)
d6f2a39c: posts small blind $0.1
95083363: posts big blind $0.25
*** HOLE CARDS ***
Dealt to cb835642 
Dealt to d6f2a39c 
Dealt to 95083363 
Dealt to Hero [9c 7d]
Dealt to 20b62793 
Dealt to 8b8d197c 
Hero: folds
20b62793: folds
8b8d197c: raises $0.38 to $0.63
cb835642: folds
d6f2a39c: folds
95083363: folds
Uncalled bet ($0.38) returned to 8b8d197c
*** SHOWDOWN ***
8b8d197c collected $0.6 from pot
*** SUMMARY ***
Total pot $0.6
Seat 1: cb835642 (button) folded before Flop (didn't bet)
Seat 2: d6f2a39c (small blind) folded before Flop
Seat 3: 95083363 (big blind) folded before Flop
Seat 4: Hero folded before Flop (didn't bet)
Seat 5: 20b62793 folded before Flop (didn't bet)
Seat 6: 8b8d197c collected ($0.6)


Poker Hand #RC95086119: Hold'em No Limit ($0.1/$0.25) - 2020/04/07 15:18:54
Table 'RushAndCash364110' 6-max Seat #1 is the button
Seat 1: 20b62793 ($59.55 in chips)
Seat 2: 704a7fcf ($28.05 in chips)
Seat 3: Hero ($29.21 in chips)
Seat 4: 91c71347 ($25.7 in chips)
Seat 5: 24a8e574 ($30.51 in chips)
Seat 6: 6a4f7541 ($26.66 in chips)
704a7fcf: posts small blind $0.1
Hero: posts big blind $0.25
*** HOLE CARDS ***
Dealt to 20b62793 
Dealt to 704a7fcf 
Dealt to Hero [7h 7c]
Dealt to 91c71347 
Dealt to 24a8e574 
Dealt to 6a4f7541 
91c71347: folds
24a8e574: folds
6a4f7541: folds
20b62793: folds
704a7fcf: folds
Uncalled bet ($0.15) returned to Hero
*** SHOWDOWN ***
Hero collected $0.2 from pot
*** SUMMARY ***
Total pot $0.2
Seat 1: 20b62793 (button) folded before Flop (didn't bet)
Seat 2: 704a7fcf (small blind) folded before Flop
Seat 3: Hero (big blind) collected ($0.2)
Seat 4: 91c71347 folded before Flop (didn't bet)
Seat 5: 24a8e574 folded before Flop (didn't bet)
Seat 6: 6a4f7541 folded before Flop (didn't bet)


Poker Hand #RC95086212: Hold'em No Limit ($0.1/$0.25) - 2020/04/07 15:19:07
Table 'RushAndCash364125' 6-max Seat #1 is the button
Seat 1: Hero ($29.31 in chips)
Seat 2: d59ed63d ($9.81 in chips)
Seat 3: e1071a91 ($32.28 in chips)
Seat 4: f7ed681a ($13.33 in chips)
Seat 5: bbb85b3f ($40.17 in chips)
Seat 6: bf64de7f ($8.92 in chips)
d59ed63d: posts small blind $0.1
e1071a91: posts big blind $0.25
*** HOLE CARDS ***
Dealt to Hero [Ac Qh]
Dealt to d59ed63d 
Dealt to e1071a91 
Dealt to f7ed681a 
Dealt to bbb85b3f 
Dealt to bf64de7f 
f7ed681a: folds
bbb85b3f: raises $0.38 to $0.63
bf64de7f: folds
Hero: raises $1.49 to $2.12
d59ed63d: folds
e1071a91: folds
bbb85b3f: calls $1.49
*** FLOP *** [5c Qd As]
bbb85b3f: checks
Hero: bets $1.6
bbb85b3f: folds
Uncalled bet ($1.6) returned to Hero
*** SHOWDOWN ***
Hero collected $4.59 from pot
*** SUMMARY ***
Total pot $4.59
Board [5c Qd As]
Seat 1: Hero (button) won ($4.59)
Seat 2: d59ed63d (small blind) folded before Flop
Seat 3: e1071a91 (big blind) folded before Flop
Seat 4: f7ed681a folded before Flop (didn't bet)
Seat 5: bbb85b3f folded on the Flop
Seat 6: bf64de7f folded before Flop (didn't bet)


Poker Hand #RC95086565: Hold'em No Limit ($0.1/$0.25) - 2020/04/07 15:19:52
Table 'RushAndCash364186' 6-max Seat #1 is the button
Seat 1: b5d592d2 ($14.33 in chips)
Seat 2: 29100105 ($37.65 in chips)
Seat 3: 275e7f74 ($31.18 in chips)
Seat 4: 454abe8b ($25.35 in chips)
Seat 5: Hero ($31.55 in chips)
Seat 6: bbb85b3f ($38.05 in chips)
29100105: posts small blind $0.1
275e7f74: posts big blind $0.25
*** HOLE CARDS ***
Dealt to b5d592d2 
Dealt to 29100105 
Dealt to 275e7f74 
Dealt to 454abe8b 
Dealt to Hero [Kh 2s]
Dealt to bbb85b3f 
454abe8b: raises $0.38 to $0.63
Hero: folds
bbb85b3f: folds
b5d592d2: folds
29100105: calls $0.53
275e7f74: calls $0.38
*** FLOP *** [2c Td 2d]
29100105: checks
275e7f74: checks
454abe8b: checks
*** TURN *** [2c Td 2d] [9d]
29100105: checks
275e7f74: bets $1.3
454abe8b: folds
29100105: folds
Uncalled bet ($1.3) returned to 275e7f74
*** SHOWDOWN ***
275e7f74 collected $1.89 from pot
*** SUMMARY ***
Total pot $1.89
Board [2c Td 2d 9d]
Seat 1: b5d592d2 (button) folded before Flop (didn't bet)
Seat 2: 29100105 (small blind) folded on the Turn
Seat 3: 275e7f74 (big blind) won ($1.89)
Seat 4: 454abe8b folded on the Turn
Seat 5: Hero folded before Flop (didn't bet)
Seat 6: bbb85b3f folded before Flop (didn't bet)


Poker Hand #RC95086597: Hold'em No Limit ($0.1/$0.25) - 2020/04/07 15:19:56
Table 'RushAndCash364192' 6-max Seat #1 is the button
Seat 1: f9ba2d22 ($21.19 in chips)
Seat 2: fd9dacc9 ($34.05 in chips)
Seat 3: 45920dbc ($34.39 in chips)
Seat 4: 82ace6d5 ($25.15 in chips)
Seat 5: f7ed681a ($13.68 in chips)
Seat 6: Hero ($31.55 in chips)
fd9dacc9: posts small blind $0.1
45920dbc: posts big blind $0.25
*** HOLE CARDS ***
Dealt to f9ba2d22 
Dealt to fd9dacc9 
Dealt to 45920dbc 
Dealt to 82ace6d5 
Dealt to f7ed681a 
Dealt to Hero [Jd 8c]
82ace6d5: folds
f7ed681a: folds
Hero: folds
f9ba2d22: raises $0.5 to $0.75
fd9dacc9: folds
45920dbc: folds
Uncalled bet ($0.5) returned to f9ba2d22
*** SHOWDOWN ***
f9ba2d22 collected $0.6 from pot
*** SUMMARY ***
Total pot $0.6
Seat 1: f9ba2d22 (button) collected ($0.6)
Seat 2: fd9dacc9 (small blind) folded before Flop
Seat 3: 45920dbc (big blind) folded before Flop
Seat 4: 82ace6d5 folded before Flop (didn't bet)
Seat 5: f7ed681a folded before Flop (didn't bet)
Seat 6: Hero folded before Flop (didn't bet)


Poker Hand #RC95086633: Hold'em No Limit ($0.1/$0.25) - 2020/04/07 15:20:00
Table 'RushAndCash364198' 6-max Seat #1 is the button
Seat 1: 7ed3ab6b ($68.62 in chips)
Seat 2: e1071a91 ($32.03 in chips)
Seat 3: 24a8e574 ($29.78 in chips)
Seat 4: 5794e88f ($39.55 in chips)
Seat 5: Hero ($31.55 in chips)
Seat 6: 3423a84d ($32.92 in chips)
e1071a91: posts small blind $0.1
24a8e574: posts big blind $0.25
*** HOLE CARDS ***
Dealt to 7ed3ab6b 
Dealt to e1071a91 
Dealt to 24a8e574 
Dealt to 5794e88f 
Dealt to Hero [Jh 6d]
Dealt to 3423a84d 
5794e88f: folds
Hero: folds
3423a84d: raises $0.25 to $0.5
7ed3ab6b: folds
e1071a91: folds
24a8e574: calls $0.25
*** FLOP *** [2s As Ks]
24a8e574: checks
3423a84d: checks
*** TURN *** [2s As Ks] [2d]
24a8e574: checks
3423a84d: bets $0.4
24a8e574: folds
Uncalled bet ($0.4) returned to 3423a84d
*** SHOWDOWN ***
3423a84d collected $1.1 from pot
*** SUMMARY ***
Total pot $1.1
Board [2s As Ks 2d]
Seat 1: 7ed3ab6b (button) folded before Flop (didn't bet)
Seat 2: e1071a91 (small blind) folded before Flop
Seat 3: 24a8e574 (big blind) folded on the Turn
Seat 4: 5794e88f folded before Flop (didn't bet)
Seat 5: Hero folded before Flop (didn't bet)
Seat 6: 3423a84d won ($1.1)


Poker Hand #RC95086678: Hold'em No Limit ($0.1/$0.25) - 2020/04/07 15:20:06
Table 'RushAndCash364207' 6-max Seat #1 is the button
Seat 1: 1a2581ce ($25 in chips)
Seat 2: a0d04110 ($43.58 in chips)
Seat 3: f7ed681a ($13.68 in chips)
Seat 4: Hero ($31.55 in chips)
Seat 5: 3ff56a6c ($23.25 in chips)
Seat 6: 6736194e ($24.9 in chips)
a0d04110: posts small blind $0.1
f7ed681a: posts big blind $0.25
*** HOLE CARDS ***
Dealt to 1a2581ce 
Dealt to a0d04110 
Dealt to f7ed681a 
Dealt to Hero [Ts 5c]
Dealt to 3ff56a6c 
Dealt to 6736194e 
Hero: folds
3ff56a6c: raises $0.38 to $0.63
6736194e: folds
1a2581ce: calls $0.63
a0d04110: folds
f7ed681a: folds
*** FLOP *** [Js Ad 7c]
3ff56a6c: bets $1
1a2581ce: calls $1
*** TURN *** [Js Ad 7c] [Qc]
3ff56a6c: bets $2.75
1a2581ce: calls $2.75
*** RIVER *** [Js Ad 7c Qc] [5d]
3ff56a6c: bets $6.75
1a2581ce: folds
Uncalled bet ($6.75) returned to 3ff56a6c
*** SHOWDOWN ***
3ff56a6c collected $9.11 from pot
*** SUMMARY ***
Total pot $9.11
Board [Js Ad 7c Qc 5d]
Seat 1: 1a2581ce (button) folded on the River
Seat 2: a0d04110 (small blind) folded before Flop
Seat 3: f7ed681a (big blind) folded before Flop
Seat 4: Hero folded before Flop (didn't bet)
Seat 5: 3ff56a6c won ($9.11)
Seat 6: 6736194e folded before Flop (didn't bet)


Poker Hand #RC95086720: Hold'em No Limit ($0.1/$0.25) - 2020/04/07 15:20:11
Table 'RushAndCash364214' 6-max Seat #1 is the button
Seat 1: 6752758b ($17.11 in chips)
Seat 2: b92cc87c ($9.09 in chips)
Seat 3: 6736194e ($24.9 in chips)
Seat 4: fd9dacc9 ($33.95 in chips)
Seat 5: Hero ($31.55 in chips)
Seat 6: bd460ce3 ($31.43 in chips)
b92cc87c: posts small blind $0.1
6736194e: posts big blind $0.25
*** HOLE CARDS ***
Dealt to 6752758b 
Dealt to b92cc87c 
Dealt to 6736194e 
Dealt to fd9dacc9 
Dealt to Hero [Th 5h]
Dealt to bd460ce3 
fd9dacc9: folds
Hero: folds
bd460ce3: folds
6752758b: folds
b92cc87c: raises $0.38 to $0.63
6736194e: folds
Uncalled bet ($0.38) returned to b92cc87c
*** SHOWDOWN ***
b92cc87c collected $0.5 from pot
*** SUMMARY ***
Total pot $0.5
Seat 1: 6752758b (button) folded before Flop (didn't bet)
Seat 2: b92cc87c (small blind) collected ($0.5)
Seat 3: 6736194e (big blind) folded before Flop
Seat 4: fd9dacc9 folded before Flop (didn't bet)
Seat 5: Hero folded before Flop (didn't bet)
Seat 6: bd460ce3 folded before Flop (didn't bet)


Poker Hand #RC95086776: Hold'em No Limit ($0.1/$0.25) - 2020/04/07 15:20:18
Table 'RushAndCash364223' 6-max Seat #1 is the button
Seat 1: accea393 ($47.65 in chips)
Seat 2: Hero ($31.55 in chips)
Seat 3: 47cd88ac ($12 in chips)
Seat 4: 258d376e ($25.35 in chips)
Seat 5: 45920dbc ($34.04 in chips)
Seat 6: 895c14a7 ($12.95 in chips)
Hero: posts small blind $0.1
47cd88ac: posts big blind $0.25
*** HOLE CARDS ***
Dealt to accea393 
Dealt to Hero [5c 4s]
Dealt to 47cd88ac 
Dealt to 258d376e 
Dealt to 45920dbc 
Dealt to 895c14a7 
258d376e: folds
45920dbc: folds
895c14a7: raises $0.38 to $0.63
accea393: folds
Hero: folds
47cd88ac: folds
Uncalled bet ($0.38) returned to 895c14a7
*** SHOWDOWN ***
895c14a7 collected $0.6 from pot
*** SUMMARY ***
Total pot $0.6
Seat 1: accea393 (button) folded before Flop (didn't bet)
Seat 2: Hero (small blind) folded before Flop
Seat 3: 47cd88ac (big blind) folded before Flop
Seat 4: 258d376e folded before Flop (didn't bet)
Seat 5: 45920dbc folded before Flop (didn't bet)
Seat 6: 895c14a7 collected ($0.6)


Poker Hand #RC95086815: Hold'em No Limit ($0.1/$0.25) - 2020/04/07 15:20:23
Table 'RushAndCash364230' 6-max Seat #1 is the button
Seat 1: Hero ($31.45 in chips)
Seat 2: f9ba2d22 ($21.54 in chips)
Seat 3: 30cab83a ($25 in chips)
Seat 4: 62eebc49 ($124.86 in chips)
Seat 5: d59ed63d ($9.46 in chips)
Seat 6: be711e9d ($29.3 in chips)
f9ba2d22: posts small blind $0.1
30cab83a: posts big blind $0.25
*** HOLE CARDS ***
Dealt to Hero [Ad 2s]
Dealt to f9ba2d22 
Dealt to 30cab83a 
Dealt to 62eebc49 
Dealt to d59ed63d 
Dealt to be711e9d 
62eebc49: raises $0.38 to $0.63
d59ed63d: raises $1.37 to $2
be711e9d: folds
Hero: folds
f9ba2d22: folds
30cab83a: folds
62eebc49: folds
Uncalled bet ($1.37) returned to d59ed63d
*** SHOWDOWN ***
d59ed63d collected $1.61 from pot
*** SUMMARY ***
Total pot $1.61
Seat 1: Hero (button) folded before Flop (didn't bet)
Seat 2: f9ba2d22 (small blind) folded before Flop
Seat 3: 30cab83a (big blind) folded before Flop
Seat 4: 62eebc49 folded before Flop
Seat 5: d59ed63d collected ($1.61)
Seat 6: be711e9d folded before Flop (didn't bet)


Poker Hand #RC95086920: Hold'em No Limit ($0.1/$0.25) - 2020/04/07 15:20:36
Table 'RushAndCash364246' 6-max Seat #1 is the button
Seat 1: acf1a889 ($12.5 in chips)
Seat 2: dec4d916 ($11.75 in chips)
Seat 3: Hero ($31.45 in chips)
Seat 4: b92cc87c ($9.34 in chips)
Seat 5: 4ab4e4a3 ($25.45 in chips)
Seat 6: 91c71347 ($28.29 in chips)
dec4d916: posts small blind $0.1
Hero: posts big blind $0.25
*** HOLE CARDS ***
Dealt to acf1a889 
Dealt to dec4d916 
Dealt to Hero [4h 4c]
Dealt to b92cc87c 
Dealt to 4ab4e4a3 
Dealt to 91c71347 
b92cc87c: folds
4ab4e4a3: folds
91c71347: folds
acf1a889: raises $0.38 to $0.63
dec4d916: folds
Hero: calls $0.38
*** FLOP *** [Jd 2h Ts]
Hero: checks
acf1a889: bets $0.5
Hero: calls $0.5
*** TURN *** [Jd 2h Ts] [5c]
Hero: checks
acf1a889: checks
*** RIVER *** [Jd 2h Ts 5c] [6c]
Hero: checks
acf1a889: checks
Hero: shows [4h 4c] (Pair of Fours)
acf1a889: shows [Ac Kh] (Ace-High)
*** SHOWDOWN ***
Hero collected $2.36 from pot
*** SUMMARY ***
Total pot $2.36
Board [Jd 2h Ts 5c 6c]
Seat 1: acf1a889 (button) showed [Ac Kh] and lost with Ace-High
Seat 2: dec4d916 (small blind) folded before Flop
Seat 3: Hero (big blind) showed [4h 4c] and won ($2.36) with Pair of Fours
Seat 4: b92cc87c folded before Flop (didn't bet)
Seat 5: 4ab4e4a3 folded before Flop (didn't bet)
Seat 6: 91c71347 folded before Flop (didn't bet)


Poker Hand #RC95087207: Hold'em No Limit ($0.1/$0.25) - 2020/04/07 15:21:14
Table 'RushAndCash364296' 6-max Seat #1 is the button
Seat 1: fe3f48f4 ($25 in chips)
Seat 2: Hero ($32.57 in chips)
Seat 3: 3f5f9735 ($21.14 in chips)
Seat 4: 603fb192 ($17.18 in chips)
Seat 5: e1071a91 ($31.65 in chips)
Seat 6: 8a9a9c5f ($26.61 in chips)
Hero: posts small blind $0.1
3f5f9735: posts big blind $0.25
*** HOLE CARDS ***
Dealt to fe3f48f4 
Dealt to Hero [Ad Th]
Dealt to 3f5f9735 
Dealt to 603fb192 
Dealt to e1071a91 
Dealt to 8a9a9c5f 
603fb192: raises $0.38 to $0.63
e1071a91: folds
8a9a9c5f: calls $0.63
fe3f48f4: folds
Hero: calls $0.53
3f5f9735: folds
*** FLOP *** [Jd Qd 7h]
Hero: checks
603fb192: checks
8a9a9c5f: checks
*** TURN *** [Jd Qd 7h] [Ts]
Hero: checks
603fb192: checks
8a9a9c5f: bets $2.2
Hero: folds
603fb192: folds
Uncalled bet ($2.2) returned to 8a9a9c5f
*** SHOWDOWN ***
8a9a9c5f collected $2.14 from pot
*** SUMMARY ***
Total pot $2.14
Board [Jd Qd 7h Ts]
Seat 1: fe3f48f4 (button) folded before Flop (didn't bet)
Seat 2: Hero (small blind) folded on the Turn
Seat 3: 3f5f9735 (big blind) folded before Flop
Seat 4: 603fb192 folded on the Turn
Seat 5: e1071a91 folded before Flop (didn't bet)
Seat 6: 8a9a9c5f won ($2.14)


Poker Hand #RC95087639: Hold'em No Limit ($0.1/$0.25) - 2020/04/07 15:22:12
Table 'RushAndCash364359' 6-max Seat #1 is the button
Seat 1: cb835642 ($27.17 in chips)
Seat 2: 289f2e46 ($29.41 in chips)
Seat 3: ce2bf8ea ($25.67 in chips)
Seat 4: 895c14a7 ($12.95 in chips)
Seat 5: b431c8b6 ($28.86 in chips)
Seat 6: Hero ($31.94 in chips)
289f2e46: posts small blind $0.1
ce2bf8ea: posts big blind $0.25
*** HOLE CARDS ***
Dealt to cb835642 
Dealt to 289f2e46 
Dealt to ce2bf8ea 
Dealt to 895c14a7 
Dealt to b431c8b6 
Dealt to Hero [9c 5h]
895c14a7: folds
b431c8b6: raises $0.38 to $0.63
Hero: folds
cb835642: folds
289f2e46: folds
ce2bf8ea: folds
Uncalled bet ($0.38) returned to b431c8b6
*** SHOWDOWN ***
b431c8b6 collected $0.6 from pot
*** SUMMARY ***
Total pot $0.6
Seat 1: cb835642 (button) folded before Flop (didn't bet)
Seat 2: 289f2e46 (small blind) folded before Flop
Seat 3: ce2bf8ea (big blind) folded before Flop
Seat 4: 895c14a7 folded before Flop (didn't bet)
Seat 5: b431c8b6 collected ($0.6)
Seat 6: Hero folded before Flop (didn't bet)


Poker Hand #RC95087671: Hold'em No Limit ($0.1/$0.25) - 2020/04/07 15:22:16
Table 'RushAndCash364364' 6-max Seat #1 is the button
Seat 1: 605bdd57 ($12.5 in chips)
Seat 2: 103129d8 ($25.1 in chips)
Seat 3: Hero ($31.94 in chips)
Seat 4: 704a7fcf ($28.62 in chips)
Seat 5: 887f8eab ($13.03 in chips)
Seat 6: 24a8e574 ($30.65 in chips)
103129d8: posts small blind $0.1
Hero: posts big blind $0.25
*** HOLE CARDS ***
Dealt to 605bdd57 
Dealt to 103129d8 
Dealt to Hero [4s 4d]
Dealt to 704a7fcf 
Dealt to 887f8eab 
Dealt to 24a8e574 
704a7fcf: folds
887f8eab: folds
24a8e574: folds
605bdd57: raises $0.38 to $0.63
103129d8: folds
Hero: calls $0.38
*** FLOP *** [6h Th As]
Hero: checks
605bdd57: checks
*** TURN *** [6h Th As] [3s]
Hero: checks
605bdd57: bets $0.9
Hero: folds
Uncalled bet ($0.9) returned to 605bdd57
*** SHOWDOWN ***
605bdd57 collected $1.36 from pot
*** SUMMARY ***
Total pot $1.36
Board [6h Th As 3s]
Seat 1: 605bdd57 (button) won ($1.36)
Seat 2: 103129d8 (small blind) folded before Flop
Seat 3: Hero (big blind) folded on the Turn
Seat 4: 704a7fcf folded before Flop (didn't bet)
Seat 5: 887f8eab folded before Flop (didn't bet)
Seat 6: 24a8e574 folded before Flop (didn't bet)


Poker Hand #RC95087958: Hold'em No Limit ($0.1/$0.25) - 2020/04/07 15:22:53
Table 'RushAndCash364409' 6-max Seat #1 is the button
Seat 1: Hero ($31.31 in chips)
Seat 2: dbf6981f ($57.27 in chips)
Seat 3: 8c86f461 ($38.73 in chips)
Seat 4: 79cc211c ($26.42 in chips)
Seat 5: e4c4c11e ($12 in chips)
Seat 6: 258d376e ($25 in chips)
dbf6981f: posts small blind $0.1
8c86f461: posts big blind $0.25
*** HOLE CARDS ***
Dealt to Hero [Qd 8d]
Dealt to dbf6981f 
Dealt to 8c86f461 
Dealt to 79cc211c 
Dealt to e4c4c11e 
Dealt to 258d376e 
79cc211c: folds
e4c4c11e: folds
258d376e: raises $0.38 to $0.63
Hero: folds
dbf6981f: folds
8c86f461: folds
Uncalled bet ($0.38) returned to 258d376e
*** SHOWDOWN ***
258d376e collected $0.6 from pot
*** SUMMARY ***
Total pot $0.6
Seat 1: Hero (button) folded before Flop (didn't bet)
Seat 2: dbf6981f (small blind) folded before Flop
Seat 3: 8c86f461 (big blind) folded before Flop
Seat 4: 79cc211c folded before Flop (didn't bet)
Seat 5: e4c4c11e folded before Flop (didn't bet)
Seat 6: 258d376e collected ($0.6)


Poker Hand #RC95088064: Hold'em No Limit ($0.1/$0.25) - 2020/04/07 15:23:06
Table 'RushAndCash364424' 6-max Seat #1 is the button
Seat 1: 8b8d197c ($35.32 in chips)
Seat 2: 704a7fcf ($28.72 in chips)
Seat 3: dbf6981f ($57.17 in chips)
Seat 4: 4c989e65 ($5.29 in chips)
Seat 5: Hero ($31.31 in chips)
Seat 6: 24a8e574 ($30.65 in chips)
Cash Drop to Pot : total $2.5 
704a7fcf: posts small blind $0.1
dbf6981f: posts big blind $0.25
*** HOLE CARDS ***
Dealt to 8b8d197c 
Dealt to 704a7fcf 
Dealt to dbf6981f 
Dealt to 4c989e65 
Dealt to Hero [Ac 9c]
Dealt to 24a8e574 
4c989e65: raises $5.04 to $5.29 and is all-in
Hero: raises $10.11 to $15.4
24a8e574: folds
8b8d197c: folds
704a7fcf: folds
dbf6981f: folds
Uncalled bet ($10.11) returned to Hero
Hero: shows [Ac 9c]
4c989e65: shows [8h 7h]
*** FLOP *** [4s Qc 6s]
*** TURN *** [4s Qc 6s] [Ah]
*** RIVER *** [4s Qc 6s Ah] [As]
*** SHOWDOWN ***
Hero collected $13.43 from pot
*** SUMMARY ***
Total pot $13.43
Board [4s Qc 6s Ah As]
Seat 1: 8b8d197c (button) folded before Flop (didn't bet)
Seat 2: 704a7fcf (small blind) folded before Flop
Seat 3: dbf6981f (big blind) folded before Flop
Seat 4: 4c989e65 showed [8h 7h] and lost with Pair of Aces
Seat 5: Hero showed [Ac 9c] and won ($13.43) with Three Aces
Seat 6: 24a8e574 folded before Flop (didn't bet)


Poker Hand #RC95088467: Hold'em No Limit ($0.1/$0.25) - 2020/04/07 15:23:59
Table 'RushAndCash364474' 6-max Seat #1 is the button
Seat 1: d6f2a39c ($8.2 in chips)
Seat 2: 65837850 ($131.77 in chips)
Seat 3: 603fb192 ($17.39 in chips)
Seat 4: dbf6981f ($56.92 in chips)
Seat 5: Hero ($38.53 in chips)
Seat 6: 3aba7ce9 ($12.1 in chips)
65837850: posts small blind $0.1
603fb192: posts big blind $0.25
*** HOLE CARDS ***
Dealt to d6f2a39c 
Dealt to 65837850 
Dealt to 603fb192 
Dealt to dbf6981f 
Dealt to Hero [Ks Qh]
Dealt to 3aba7ce9 
dbf6981f: folds
Hero: raises $0.38 to $0.63
3aba7ce9: calls $0.63
d6f2a39c: folds
65837850: folds
603fb192: folds
*** FLOP *** [Td 2s 4s]
Hero: bets $0.6
3aba7ce9: calls $0.6
*** TURN *** [Td 2s 4s] [Js]
Hero: bets $2.2
3aba7ce9: folds
Uncalled bet ($2.2) returned to Hero
*** SHOWDOWN ***
Hero collected $2.81 from pot
*** SUMMARY ***
Total pot $2.81
Board [Td 2s 4s Js]
Seat 1: d6f2a39c (button) folded before Flop (didn't bet)
Seat 2: 65837850 (small blind) folded before Flop
Seat 3: 603fb192 (big blind) folded before Flop
Seat 4: dbf6981f folded before Flop (didn't bet)
Seat 5: Hero won ($2.81)
Seat 6: 3aba7ce9 folded on the Turn


Poker Hand #RC95088725: Hold'em No Limit ($0.1/$0.25) - 2020/04/07 15:24:30
Table 'RushAndCash364508' 6-max Seat #1 is the button
Seat 1: c88456c4 ($5.92 in chips)
Seat 2: fe5b2431 ($12.85 in chips)
Seat 3: a0d04110 ($41.55 in chips)
Seat 4: 3aba7ce9 ($10.87 in chips)
Seat 5: 454abe8b ($25.6 in chips)
Seat 6: Hero ($39.97 in chips)
fe5b2431: posts small blind $0.1
a0d04110: posts big blind $0.25
*** HOLE CARDS ***
Dealt to c88456c4 
Dealt to fe5b2431 
Dealt to a0d04110 
Dealt to 3aba7ce9 
Dealt to 454abe8b 
Dealt to Hero [Kc Ts]
3aba7ce9: folds
454abe8b: folds
Hero: raises $0.38 to $0.63
c88456c4: folds
fe5b2431: folds
a0d04110: folds
Uncalled bet ($0.38) returned to Hero
*** SHOWDOWN ***
Hero collected $0.6 from pot
*** SUMMARY ***
Total pot $0.6
Seat 1: c88456c4 (button) folded before Flop (didn't bet)
Seat 2: fe5b2431 (small blind) folded before Flop
Seat 3: a0d04110 (big blind) folded before Flop
Seat 4: 3aba7ce9 folded before Flop (didn't bet)
Seat 5: 454abe8b folded before Flop (didn't bet)
Seat 6: Hero collected ($0.6)


Poker Hand #RC95088932: Hold'em No Limit ($0.1/$0.25) - 2020/04/07 15:24:56
Table 'RushAndCash364539' 6-max Seat #1 is the button
Seat 1: 79cc211c ($26.42 in chips)
Seat 2: 4dbd4c7f ($9.49 in chips)
Seat 3: Hero ($40.32 in chips)
Seat 4: acf1a889 ($14.78 in chips)
Seat 5: 704c37d9 ($56.93 in chips)
Seat 6: 7ed3ab6b ($62.16 in chips)
4dbd4c7f: posts small blind $0.1
Hero: posts big blind $0.25
*** HOLE CARDS ***
Dealt to 79cc211c 
Dealt to 4dbd4c7f 
Dealt to Hero [4s 3d]
Dealt to acf1a889 
Dealt to 704c37d9 
Dealt to 7ed3ab6b 
acf1a889: raises $0.38 to $0.63
704c37d9: folds
7ed3ab6b: folds
79cc211c: folds
4dbd4c7f: folds
Hero: folds
Uncalled bet ($0.38) returned to acf1a889
*** SHOWDOWN ***
acf1a889 collected $0.6 from pot
*** SUMMARY ***
Total pot $0.6
Seat 1: 79cc211c (button) folded before Flop (didn't bet)
Seat 2: 4dbd4c7f (small blind) folded before Flop
Seat 3: Hero (big blind) folded before Flop
Seat 4: acf1a889 collected ($0.6)
Seat 5: 704c37d9 folded before Flop (didn't bet)
Seat 6: 7ed3ab6b folded before Flop (didn't bet)


Poker Hand #RC95088966: Hold'em No Limit ($0.1/$0.25) - 2020/04/07 15:25:00
Table 'RushAndCash364544' 6-max Seat #1 is the button
Seat 1: 4c989e65 ($2.35 in chips)
Seat 2: 7ac43878 ($39.26 in chips)
Seat 3: 1a2581ce ($25.1 in chips)
Seat 4: 8b8d197c ($34.46 in chips)
Seat 5: Hero ($40.07 in chips)
Seat 6: dbf6981f ($56.32 in chips)
7ac43878: posts small blind $0.1
1a2581ce: posts big blind $0.25
*** HOLE CARDS ***
Dealt to 4c989e65 
Dealt to 7ac43878 
Dealt to 1a2581ce 
Dealt to 8b8d197c 
Dealt to Hero [Js 8s]
Dealt to dbf6981f 
8b8d197c: folds
Hero: folds
dbf6981f: folds
4c989e65: folds
7ac43878: calls $0.15
1a2581ce: checks
*** FLOP *** [3c Qh Ts]
7ac43878: checks
1a2581ce: checks
*** TURN *** [3c Qh Ts] [5h]
7ac43878: checks
1a2581ce: checks
*** RIVER *** [3c Qh Ts 5h] [6s]
7ac43878: checks
1a2581ce: checks
7ac43878: shows [As Kd] (Ace-High)
1a2581ce: shows [2s 7d] (Queen-High)
*** SHOWDOWN ***
7ac43878 collected $0.5 from pot
*** SUMMARY ***
Total pot $0.5
Board [3c Qh Ts 5h 6s]
Seat 1: 4c989e65 (button) folded before Flop (didn't bet)
Seat 2: 7ac43878 (small blind) showed [As Kd] and won ($0.5) with Ace-High
Seat 3: 1a2581ce (big blind) showed [7d 2s] and lost with Queen-High
Seat 4: 8b8d197c folded before Flop (didn't bet)
Seat 5: Hero folded before Flop (didn't bet)
Seat 6: dbf6981f folded before Flop (didn't bet)


Poker Hand #RC95089039: Hold'em No Limit ($0.1/$0.25) - 2020/04/07 15:25:09
Table 'RushAndCash364556' 6-max Seat #1 is the button
Seat 1: a4ba858f ($29.01 in chips)
Seat 2: Hero ($40.07 in chips)
Seat 3: 91c71347 ($32.45 in chips)
Seat 4: 324d8e1d ($33.75 in chips)
Seat 5: 32953d2a ($12.6 in chips)
Seat 6: 518d077e ($33.74 in chips)
Hero: posts small blind $0.1
91c71347: posts big blind $0.25
*** HOLE CARDS ***
Dealt to a4ba858f 
Dealt to Hero [Qc 5s]
Dealt to 91c71347 
Dealt to 324d8e1d 
Dealt to 32953d2a 
Dealt to 518d077e 
324d8e1d: folds
32953d2a: folds
518d077e: folds
a4ba858f: raises $0.5 to $0.75
Hero: folds
91c71347: folds
Uncalled bet ($0.5) returned to a4ba858f
*** SHOWDOWN ***
a4ba858f collected $0.6 from pot
*** SUMMARY ***
Total pot $0.6
Seat 1: a4ba858f (button) collected ($0.6)
Seat 2: Hero (small blind) folded before Flop
Seat 3: 91c71347 (big blind) folded before Flop
Seat 4: 324d8e1d folded before Flop (didn't bet)
Seat 5: 32953d2a folded before Flop (didn't bet)
Seat 6: 518d077e folded before Flop (didn't bet)


Poker Hand #RC95089136: Hold'em No Limit ($0.1/$0.25) - 2020/04/07 15:25:21
Table 'RushAndCash364569' 6-max Seat #1 is the button
Seat 1: Hero ($39.97 in chips)
Seat 2: 8004b155 ($12.35 in chips)
Seat 3: d5989e2b ($12 in chips)
Seat 4: 91c71347 ($32.2 in chips)
Seat 5: b5d592d2 ($15.79 in chips)
Seat 6: 6a4f7541 ($26.2 in chips)
8004b155: posts small blind $0.1
d5989e2b: posts big blind $0.25
*** HOLE CARDS ***
Dealt to Hero [Ac Qd]
Dealt to 8004b155 
Dealt to d5989e2b 
Dealt to 91c71347 
Dealt to b5d592d2 
Dealt to 6a4f7541 
91c71347: folds
b5d592d2: folds
6a4f7541: folds
Hero: raises $0.38 to $0.63
8004b155: folds
d5989e2b: raises $1.07 to $1.7
Hero: calls $1.07
*** FLOP *** [4h Qh Th]
d5989e2b: bets $10.3 and is all-in
Hero: calls $10.3
d5989e2b: shows [Kd Qs] (Pair of Queens)
Hero: shows [Qd Ac] (Pair of Queens)
*** TURN *** [4h Qh Th] [9d]
*** RIVER *** [4h Qh Th 9d] [Jh]
*** SHOWDOWN ***
d5989e2b collected $24.1 from pot
*** SUMMARY ***
Total pot $24.1
Board [4h Qh Th 9d Jh]
Seat 1: Hero (button) showed [Ac Qd] and lost with Pair of Queens
Seat 2: 8004b155 (small blind) folded before Flop
Seat 3: d5989e2b (big blind) showed [Kd Qs] and won ($24.1) with Kings-High Straight
Seat 4: 91c71347 folded before Flop (didn't bet)
Seat 5: b5d592d2 folded before Flop (didn't bet)
Seat 6: 6a4f7541 folded before Flop (didn't bet)


Poker Hand #RC95089455: Hold'em No Limit ($0.1/$0.25) - 2020/04/07 15:26:01
Table 'RushAndCash364612' 6-max Seat #1 is the button
Seat 1: a4ba858f ($29.36 in chips)
Seat 2: d5989e2b ($23.1 in chips)
Seat 3: 89387862 ($28.84 in chips)
Seat 4: Hero ($27.97 in chips)
Seat 5: 605bdd57 ($12.57 in chips)
Seat 6: a2f2938c ($25 in chips)
d5989e2b: posts small blind $0.1
89387862: posts big blind $0.25
*** HOLE CARDS ***
Dealt to a4ba858f 
Dealt to d5989e2b 
Dealt to 89387862 
Dealt to Hero [Ks Td]
Dealt to 605bdd57 
Dealt to a2f2938c 
Hero: folds
605bdd57: folds
a2f2938c: folds
a4ba858f: folds
d5989e2b: folds
Uncalled bet ($0.15) returned to 89387862
*** SHOWDOWN ***
89387862 collected $0.2 from pot
*** SUMMARY ***
Total pot $0.2
Seat 1: a4ba858f (button) folded before Flop (didn't bet)
Seat 2: d5989e2b (small blind) folded before Flop
Seat 3: 89387862 (big blind) collected ($0.2)
Seat 4: Hero folded before Flop (didn't bet)
Seat 5: 605bdd57 folded before Flop (didn't bet)
Seat 6: a2f2938c folded before Flop (didn't bet)


Poker Hand #RC95089489: Hold'em No Limit ($0.1/$0.25) - 2020/04/07 15:26:05
Table 'RushAndCash364617' 6-max Seat #1 is the button
Seat 1: d5989e2b ($23 in chips)
Seat 2: a296ff49 ($12.46 in chips)
Seat 3: 49b3e425 ($25.61 in chips)
Seat 4: Hero ($27.97 in chips)
Seat 5: a4ba858f ($29.36 in chips)
Seat 6: 832cd074 ($34.41 in chips)
a296ff49: posts small blind $0.1
49b3e425: posts big blind $0.25
*** HOLE CARDS ***
Dealt to d5989e2b 
Dealt to a296ff49 
Dealt to 49b3e425 
Dealt to Hero [Qh 5s]
Dealt to a4ba858f 
Dealt to 832cd074 
Hero: folds
a4ba858f: folds
832cd074: folds
d5989e2b: folds
a296ff49: raises $0.5 to $0.75
49b3e425: raises $0.75 to $1.5
a296ff49: calls $0.75
*** FLOP *** [3d 4s 8h]
a296ff49: checks
49b3e425: bets $1.5
a296ff49: calls $1.5
*** TURN *** [3d 4s 8h] [Jh]
a296ff49: checks
49b3e425: bets $3
a296ff49: folds
Uncalled bet ($3) returned to 49b3e425
*** SHOWDOWN ***
49b3e425 collected $6 from pot
*** SUMMARY ***
Total pot $6
Board [3d 4s 8h Jh]
Seat 1: d5989e2b (button) folded before Flop (didn't bet)
Seat 2: a296ff49 (small blind) folded on the Turn
Seat 3: 49b3e425 (big blind) won ($6)
Seat 4: Hero folded before Flop (didn't bet)
Seat 5: a4ba858f folded before Flop (didn't bet)
Seat 6: 832cd074 folded before Flop (didn't bet)


Poker Hand #RC95089525: Hold'em No Limit ($0.1/$0.25) - 2020/04/07 15:26:09
Table 'RushAndCash364622' 6-max Seat #1 is the button
Seat 1: 1055451d ($12.5 in chips)
Seat 2: 45920dbc ($46.07 in chips)
Seat 3: Hero ($27.97 in chips)
Seat 4: d5989e2b ($23 in chips)
Seat 5: a4ba858f ($29.36 in chips)
Seat 6: af84e661 ($6.15 in chips)
45920dbc: posts small blind $0.1
Hero: posts big blind $0.25
*** HOLE CARDS ***
Dealt to 1055451d 
Dealt to 45920dbc 
Dealt to Hero [Tc 5s]
Dealt to d5989e2b 
Dealt to a4ba858f 
Dealt to af84e661 
d5989e2b: raises $0.5 to $0.75
a4ba858f: folds
af84e661: folds
1055451d: folds
45920dbc: folds
Hero: folds
Uncalled bet ($0.5) returned to d5989e2b
*** SHOWDOWN ***
d5989e2b collected $0.6 from pot
*** SUMMARY ***
Total pot $0.6
Seat 1: 1055451d (button) folded before Flop (didn't bet)
Seat 2: 45920dbc (small blind) folded before Flop
Seat 3: Hero (big blind) folded before Flop
Seat 4: d5989e2b collected ($0.6)
Seat 5: a4ba858f folded before Flop (didn't bet)
Seat 6: af84e661 folded before Flop (didn't bet)


Poker Hand #RC95089567: Hold'em No Limit ($0.1/$0.25) - 2020/04/07 15:26:14
Table 'RushAndCash364627' 6-max Seat #1 is the button
Seat 1: 3423a84d ($34.07 in chips)
Seat 2: Hero ($27.72 in chips)
Seat 3: 832cd074 ($34.31 in chips)
Seat 4: 79cc211c ($27.54 in chips)
Seat 5: ce59b684 ($29.66 in chips)
Seat 6: 89387862 ($28.94 in chips)
Hero: posts small blind $0.1
832cd074: posts big blind $0.25
*** HOLE CARDS ***
Dealt to 3423a84d 
Dealt to Hero [Ad 9h]
Dealt to 832cd074 
Dealt to 79cc211c 
Dealt to ce59b684 
Dealt to 89387862 
79cc211c: folds
ce59b684: folds
89387862: folds
3423a84d: folds
Hero: folds
Uncalled bet ($0.15) returned to 832cd074
*** SHOWDOWN ***
832cd074 collected $0.2 from pot
*** SUMMARY ***
Total pot $0.2
Seat 1: 3423a84d (button) folded before Flop (didn't bet)
Seat 2: Hero (small blind) folded before Flop
Seat 3: 832cd074 (big blind) collected ($0.2)
Seat 4: 79cc211c folded before Flop (didn't bet)
Seat 5: ce59b684 folded before Flop (didn't bet)
Seat 6: 89387862 folded before Flop (didn't bet)


Poker Hand #RC95089609: Hold'em No Limit ($0.1/$0.25) - 2020/04/07 15:26:19
Table 'RushAndCash364633' 6-max Seat #1 is the button
Seat 1: 17388104 ($19.35 in chips)
Seat 2: 432498db ($27.18 in chips)
Seat 3: 36017ad1 ($25 in chips)
Seat 4: 8c86f461 ($41.7 in chips)
Seat 5: 4ab4e4a3 ($25 in chips)
Seat 6: Hero ($27.62 in chips)
432498db: posts small blind $0.1
36017ad1: posts big blind $0.25
*** HOLE CARDS ***
Dealt to 17388104 
Dealt to 432498db 
Dealt to 36017ad1 
Dealt to 8c86f461 
Dealt to 4ab4e4a3 
Dealt to Hero [Qc 7c]
8c86f461: folds
4ab4e4a3: folds
Hero: folds
17388104: calls $0.25
432498db: folds
36017ad1: checks
*** FLOP *** [4h 7s Ts]
36017ad1: checks
17388104: checks
*** TURN *** [4h 7s Ts] [As]
36017ad1: checks
17388104: checks
*** RIVER *** [4h 7s Ts As] [2d]
36017ad1: checks
17388104: bets $0.3
36017ad1: folds
Uncalled bet ($0.3) returned to 17388104
*** SHOWDOWN ***
17388104 collected $0.6 from pot
*** SUMMARY ***
Total pot $0.6
Board [4h 7s Ts As 2d]
Seat 1: 17388104 (button) won ($0.6)
Seat 2: 432498db (small blind) folded before Flop
Seat 3: 36017ad1 (big blind) folded on the River
Seat 4: 8c86f461 folded before Flop (didn't bet)
Seat 5: 4ab4e4a3 folded before Flop (didn't bet)
Seat 6: Hero folded before Flop (didn't bet)


Poker Hand #RC95089670: Hold'em No Limit ($0.1/$0.25) - 2020/04/07 15:26:27
Table 'RushAndCash364641' 6-max Seat #1 is the button
Seat 1: Hero ($27.62 in chips)
Seat 2: d437c92d ($62.59 in chips)
Seat 3: fc8a29ea ($69.73 in chips)
Seat 4: 3c96062f ($14.84 in chips)
Seat 5: 61ad32d ($18.29 in chips)
Seat 6: 832cd074 ($34.06 in chips)
d437c92d: posts small blind $0.1
fc8a29ea: posts big blind $0.25
*** HOLE CARDS ***
Dealt to Hero [Ah 7s]
Dealt to d437c92d 
Dealt to fc8a29ea 
Dealt to 3c96062f 
Dealt to 61ad32d 
Dealt to 832cd074 
3c96062f: folds
61ad32d: folds
832cd074: raises $0.5 to $0.75
Hero: folds
d437c92d: calls $0.65
fc8a29ea: folds
*** FLOP *** [Jc 9d 8s]
d437c92d: checks
832cd074: checks
*** TURN *** [Jc 9d 8s] [Qs]
d437c92d: checks
832cd074: checks
*** RIVER *** [Jc 9d 8s Qs] [5h]
d437c92d: checks
832cd074: checks
d437c92d: shows [3h 3s] (Pair of Treys)
832cd074: shows [Ad 2d] (Ace-High)
*** SHOWDOWN ***
d437c92d collected $1.75 from pot
*** SUMMARY ***
Total pot $1.75
Board [Jc 9d 8s Qs 5h]
Seat 1: Hero (button) folded before Flop (didn't bet)
Seat 2: d437c92d (small blind) showed [3s 3h] and won ($1.75) with Pair of Treys
Seat 3: fc8a29ea (big blind) folded before Flop
Seat 4: 3c96062f folded before Flop (didn't bet)
Seat 5: 61ad32d folded before Flop (didn't bet)
Seat 6: 832cd074 showed [Ad 2d] and lost with Ace-High


Poker Hand #RC95089759: Hold'em No Limit ($0.1/$0.25) - 2020/04/07 15:26:38
Table 'RushAndCash364654' 6-max Seat #1 is the button
Seat 1: 2dd038c3 ($11.02 in chips)
Seat 2: 45920dbc ($45.72 in chips)
Seat 3: deb69778 ($26.63 in chips)
Seat 4: cc092a76 ($11.84 in chips)
Seat 5: Hero ($27.62 in chips)
Seat 6: 36017ad1 ($25 in chips)
45920dbc: posts small blind $0.1
deb69778: posts big blind $0.25
*** HOLE CARDS ***
Dealt to 2dd038c3 
Dealt to 45920dbc 
Dealt to deb69778 
Dealt to cc092a76 
Dealt to Hero [Ad 5d]
Dealt to 36017ad1 
cc092a76: folds
Hero: raises $0.38 to $0.63
36017ad1: folds
2dd038c3: folds
45920dbc: folds
deb69778: folds
Uncalled bet ($0.38) returned to Hero
*** SHOWDOWN ***
Hero collected $0.6 from pot
*** SUMMARY ***
Total pot $0.6
Seat 1: 2dd038c3 (button) folded before Flop (didn't bet)
Seat 2: 45920dbc (small blind) folded before Flop
Seat 3: deb69778 (big blind) folded before Flop
Seat 4: cc092a76 folded before Flop (didn't bet)
Seat 5: Hero collected ($0.6)
Seat 6: 36017ad1 folded before Flop (didn't bet)


Poker Hand #RC95089878: Hold'em No Limit ($0.1/$0.25) - 2020/04/07 15:26:53
Table 'RushAndCash364669' 6-max Seat #1 is the button
Seat 1: d2f55a32 ($13.02 in chips)
Seat 2: b431c8b6 ($34 in chips)
Seat 3: 61ad32d ($18.19 in chips)
Seat 4: 324d8e1d ($33.65 in chips)
Seat 5: Hero ($27.97 in chips)
Seat 6: 704a7fcf ($29.83 in chips)
b431c8b6: posts small blind $0.1
61ad32d: posts big blind $0.25
*** HOLE CARDS ***
Dealt to d2f55a32 
Dealt to b431c8b6 
Dealt to 61ad32d 
Dealt to 324d8e1d 
Dealt to Hero [Jd 6d]
Dealt to 704a7fcf 
324d8e1d: folds
Hero: folds
704a7fcf: folds
d2f55a32: raises $0.25 to $0.5
b431c8b6: folds
61ad32d: folds
Uncalled bet ($0.25) returned to d2f55a32
*** SHOWDOWN ***
d2f55a32 collected $0.6 from pot
*** SUMMARY ***
Total pot $0.6
Seat 1: d2f55a32 (button) collected ($0.6)
Seat 2: b431c8b6 (small blind) folded before Flop
Seat 3: 61ad32d (big blind) folded before Flop
Seat 4: 324d8e1d folded before Flop (didn't bet)
Seat 5: Hero folded before Flop (didn't bet)
Seat 6: 704a7fcf folded before Flop (didn't bet)


Poker Hand #RC95089933: Hold'em No Limit ($0.1/$0.25) - 2020/04/07 15:27:00
Table 'RushAndCash364677' 6-max Seat #1 is the button
Seat 1: Hero ($27.97 in chips)
Seat 2: 8004b155 ($10.4 in chips)
Seat 3: a8ef6a6e ($25 in chips)
Seat 4: e1071a91 ($27.72 in chips)
Seat 5: 704a7fcf ($29.83 in chips)
Seat 6: bf64de7f ($7.92 in chips)
8004b155: posts small blind $0.1
a8ef6a6e: posts big blind $0.25
*** HOLE CARDS ***
Dealt to Hero [Td 2h]
Dealt to 8004b155 
Dealt to a8ef6a6e 
Dealt to e1071a91 
Dealt to 704a7fcf 
Dealt to bf64de7f 
e1071a91: folds
704a7fcf: folds
bf64de7f: folds
Hero: folds
8004b155: folds
Uncalled bet ($0.15) returned to a8ef6a6e
*** SHOWDOWN ***
a8ef6a6e collected $0.2 from pot
*** SUMMARY ***
Total pot $0.2
Seat 1: Hero (button) folded before Flop (didn't bet)
Seat 2: 8004b155 (small blind) folded before Flop
Seat 3: a8ef6a6e (big blind) collected ($0.2)
Seat 4: e1071a91 folded before Flop (didn't bet)
Seat 5: 704a7fcf folded before Flop (didn't bet)
Seat 6: bf64de7f folded before Flop (didn't bet)


Poker Hand #RC95090020: Hold'em No Limit ($0.1/$0.25) - 2020/04/07 15:27:10
Table 'RushAndCash364688' 6-max Seat #1 is the button
Seat 1: 258d376e ($25.35 in chips)
Seat 2: 6a4f7541 ($26.01 in chips)
Seat 3: Hero ($27.97 in chips)
Seat 4: ecd599c ($11.85 in chips)
Seat 5: 6736194e ($28.82 in chips)
Seat 6: 704a7fcf ($29.83 in chips)
6a4f7541: posts small blind $0.1
Hero: posts big blind $0.25
*** HOLE CARDS ***
Dealt to 258d376e 
Dealt to 6a4f7541 
Dealt to Hero [Jh 8d]
Dealt to ecd599c 
Dealt to 6736194e 
Dealt to 704a7fcf 
ecd599c: folds
6736194e: folds
704a7fcf: raises $0.38 to $0.63
258d376e: folds
6a4f7541: folds
Hero: folds
Uncalled bet ($0.38) returned to 704a7fcf
*** SHOWDOWN ***
704a7fcf collected $0.6 from pot
*** SUMMARY ***
Total pot $0.6
Seat 1: 258d376e (button) folded before Flop (didn't bet)
Seat 2: 6a4f7541 (small blind) folded before Flop
Seat 3: Hero (big blind) folded before Flop
Seat 4: ecd599c folded before Flop (didn't bet)
Seat 5: 6736194e folded before Flop (didn't bet)
Seat 6: 704a7fcf collected ($0.6)


Poker Hand #RC95090139: Hold'em No Limit ($0.1/$0.25) - 2020/04/07 15:27:24
Table 'RushAndCash364701' 6-max Seat #1 is the button
Seat 1: 418ccf5b ($24.65 in chips)
Seat 2: Hero ($27.72 in chips)
Seat 3: b5d592d2 ($15.44 in chips)
Seat 4: edde387a ($23.3 in chips)
Seat 5: d437c92d ($63.51 in chips)
Seat 6: fe3f48f4 ($27.69 in chips)
Hero: posts small blind $0.1
b5d592d2: posts big blind $0.25
*** HOLE CARDS ***
Dealt to 418ccf5b 
Dealt to Hero [Qs 3h]
Dealt to b5d592d2 
Dealt to edde387a 
Dealt to d437c92d 
Dealt to fe3f48f4 
edde387a: raises $0.38 to $0.63
d437c92d: folds
fe3f48f4: raises $1.37 to $2
418ccf5b: folds
Hero: folds
b5d592d2: folds
edde387a: folds
Uncalled bet ($1.37) returned to fe3f48f4
*** SHOWDOWN ***
fe3f48f4 collected $1.61 from pot
*** SUMMARY ***
Total pot $1.61
Seat 1: 418ccf5b (button) folded before Flop (didn't bet)
Seat 2: Hero (small blind) folded before Flop
Seat 3: b5d592d2 (big blind) folded before Flop
Seat 4: edde387a folded before Flop
Seat 5: d437c92d folded before Flop (didn't bet)
Seat 6: fe3f48f4 collected ($1.61)


Poker Hand #RC95090202: Hold'em No Limit ($0.1/$0.25) - 2020/04/07 15:27:33
Table 'RushAndCash364710' 6-max Seat #1 is the button
Seat 1: d2f55a32 ($13.37 in chips)
Seat 2: 62eebc49 ($121.58 in chips)
Seat 3: d437c92d ($63.51 in chips)
Seat 4: Hero ($27.62 in chips)
Seat 5: a2f2938c ($25 in chips)
Seat 6: 36017ad1 ($25 in chips)
Cash Drop to Pot : total $2.5 
62eebc49: posts small blind $0.1
d437c92d: posts big blind $0.25
*** HOLE CARDS ***
Dealt to d2f55a32 
Dealt to 62eebc49 
Dealt to d437c92d 
Dealt to Hero [9s 4h]
Dealt to a2f2938c 
Dealt to 36017ad1 
Hero: folds
a2f2938c: calls $0.25
36017ad1: folds
d2f55a32: calls $0.25
62eebc49: calls $0.15
d437c92d: checks
*** FLOP *** [5s 7h 3h]
62eebc49: checks
d437c92d: checks
a2f2938c: bets $1
d2f55a32: raises $12.12 to $13.12 and is all-in
62eebc49: folds
d437c92d: folds
a2f2938c: folds
Uncalled bet ($12.12) returned to d2f55a32
*** SHOWDOWN ***
d2f55a32 collected $5.5 from pot
*** SUMMARY ***
Total pot $5.5
Board [5s 7h 3h]
Seat 1: d2f55a32 (button) won ($5.5)
Seat 2: 62eebc49 (small blind) folded on the Flop
Seat 3: d437c92d (big blind) folded on the Flop
Seat 4: Hero folded before Flop (didn't bet)
Seat 5: a2f2938c folded on the Flop
Seat 6: 36017ad1 folded before Flop (didn't bet)


Poker Hand #RC95090281: Hold'em No Limit ($0.1/$0.25) - 2020/04/07 15:27:43
Table 'RushAndCash364720' 6-max Seat #1 is the button
Seat 1: 2d45ce80 ($9.46 in chips)
Seat 2: 36017ad1 ($25 in chips)
Seat 3: 7bf7c8c9 ($25 in chips)
Seat 4: 52ee6b3d ($26.02 in chips)
Seat 5: Hero ($27.62 in chips)
Seat 6: edde387a ($22.67 in chips)
36017ad1: posts small blind $0.1
7bf7c8c9: posts big blind $0.25
*** HOLE CARDS ***
Dealt to 2d45ce80 
Dealt to 36017ad1 
Dealt to 7bf7c8c9 
Dealt to 52ee6b3d 
Dealt to Hero [Js 3s]
Dealt to edde387a 
52ee6b3d: folds
Hero: folds
edde387a: folds
2d45ce80: folds
36017ad1: folds
Uncalled bet ($0.15) returned to 7bf7c8c9
*** SHOWDOWN ***
7bf7c8c9 collected $0.2 from pot
*** SUMMARY ***
Total pot $0.2
Seat 1: 2d45ce80 (button) folded before Flop (didn't bet)
Seat 2: 36017ad1 (small blind) folded before Flop
Seat 3: 7bf7c8c9 (big blind) collected ($0.2)
Seat 4: 52ee6b3d folded before Flop (didn't bet)
Seat 5: Hero folded before Flop (didn't bet)
Seat 6: edde387a folded before Flop (didn't bet)


Poker Hand #RC95090301: Hold'em No Limit ($0.1/$0.25) - 2020/04/07 15:27:46
Table 'RushAndCash364723' 6-max Seat #1 is the button
Seat 1: Hero ($27.62 in chips)
Seat 2: 6a4f7541 ($25.66 in chips)
Seat 3: 418ccf5b ($24.65 in chips)
Seat 4: 46e10b42 ($11.65 in chips)
Seat 5: 528a07f8 ($33.52 in chips)
Seat 6: 91c71347 ($32.32 in chips)
6a4f7541: posts small blind $0.1
418ccf5b: posts big blind $0.25
*** HOLE CARDS ***
Dealt to Hero [As 5c]
Dealt to 6a4f7541 
Dealt to 418ccf5b 
Dealt to 46e10b42 
Dealt to 528a07f8 
Dealt to 91c71347 
46e10b42: raises $0.38 to $0.63
528a07f8: folds
91c71347: folds
Hero: folds
6a4f7541: folds
418ccf5b: calls $0.38
*** FLOP *** [2c 2h 4h]
418ccf5b: checks
46e10b42: checks
*** TURN *** [2c 2h 4h] [4d]
418ccf5b: bets $0.7
46e10b42: folds
Uncalled bet ($0.7) returned to 418ccf5b
*** SHOWDOWN ***
418ccf5b collected $1.36 from pot
*** SUMMARY ***
Total pot $1.36
Board [2c 2h 4h 4d]
Seat 1: Hero (button) folded before Flop (didn't bet)
Seat 2: 6a4f7541 (small blind) folded before Flop
Seat 3: 418ccf5b (big blind) won ($1.36)
Seat 4: 46e10b42 folded on the Turn
Seat 5: 528a07f8 folded before Flop (didn't bet)
Seat 6: 91c71347 folded before Flop (didn't bet)


Poker Hand #RC95090344: Hold'em No Limit ($0.1/$0.25) - 2020/04/07 15:27:51
Table 'RushAndCash364729' 6-max Seat #1 is the button
Seat 1: e1071a91 ($26.92 in chips)
Seat 2: 8c86f461 ($41.2 in chips)
Seat 3: Hero ($27.62 in chips)
Seat 4: caa68458 ($25.35 in chips)
Seat 5: edde387a ($22.67 in chips)
Seat 6: a4ba858f ($29.71 in chips)
8c86f461: posts small blind $0.1
Hero: posts big blind $0.25
*** HOLE CARDS ***
Dealt to e1071a91 
Dealt to 8c86f461 
Dealt to Hero [8h 5h]
Dealt to caa68458 
Dealt to edde387a 
Dealt to a4ba858f 
caa68458: folds
edde387a: folds
a4ba858f: raises $0.5 to $0.75
e1071a91: folds
8c86f461: folds
Hero: folds
Uncalled bet ($0.5) returned to a4ba858f
*** SHOWDOWN ***
a4ba858f collected $0.6 from pot
*** SUMMARY ***
Total pot $0.6
Seat 1: e1071a91 (button) folded before Flop (didn't bet)
Seat 2: 8c86f461 (small blind) folded before Flop
Seat 3: Hero (big blind) folded before Flop
Seat 4: caa68458 folded before Flop (didn't bet)
Seat 5: edde387a folded before Flop (didn't bet)
Seat 6: a4ba858f collected ($0.6)


Poker Hand #RC95090386: Hold'em No Limit ($0.1/$0.25) - 2020/04/07 15:27:57
Table 'RushAndCash364734' 6-max Seat #1 is the button
Seat 1: 5ffa3a03 ($12 in chips)
Seat 2: Hero ($27.37 in chips)
Seat 3: edde387a ($22.67 in chips)
Seat 4: cc092a76 ($10.74 in chips)
Seat 5: 74937d40 ($28.26 in chips)
Seat 6: b431c8b6 ($33.02 in chips)
Hero: posts small blind $0.1
edde387a: posts big blind $0.25
*** HOLE CARDS ***
Dealt to 5ffa3a03 
Dealt to Hero [As 6d]
Dealt to edde387a 
Dealt to cc092a76 
Dealt to 74937d40 
Dealt to b431c8b6 
cc092a76: folds
74937d40: folds
b431c8b6: raises $0.38 to $0.63
5ffa3a03: calls $0.63
Hero: folds
edde387a: folds
*** FLOP *** [7d 7c 6s]
b431c8b6: checks
5ffa3a03: bets $0.9
b431c8b6: folds
Uncalled bet ($0.9) returned to 5ffa3a03
*** SHOWDOWN ***
5ffa3a03 collected $1.61 from pot
*** SUMMARY ***
Total pot $1.61
Board [7d 7c 6s]
Seat 1: 5ffa3a03 (button) won ($1.61)
Seat 2: Hero (small blind) folded before Flop
Seat 3: edde387a (big blind) folded before Flop
Seat 4: cc092a76 folded before Flop (didn't bet)
Seat 5: 74937d40 folded before Flop (didn't bet)
Seat 6: b431c8b6 folded on the Flop


Poker Hand #RC95090449: Hold'em No Limit ($0.1/$0.25) - 2020/04/07 15:28:05
Table 'RushAndCash364745' 6-max Seat #1 is the button
Seat 1: 8c86f461 ($41.1 in chips)
Seat 2: e6c023d1 ($34.78 in chips)
Seat 3: af84e661 ($5.17 in chips)
Seat 4: 65837850 ($133.88 in chips)
Seat 5: Hero ($27.27 in chips)
Seat 6: 324d8e1d ($33.12 in chips)
e6c023d1: posts small blind $0.1
af84e661: posts big blind $0.25
*** HOLE CARDS ***
Dealt to 8c86f461 
Dealt to e6c023d1 
Dealt to af84e661 
Dealt to 65837850 
Dealt to Hero [Qh Qc]
Dealt to 324d8e1d 
65837850: folds
Hero: raises $0.38 to $0.63
324d8e1d: folds
8c86f461: folds
e6c023d1: folds
af84e661: folds
Uncalled bet ($0.38) returned to Hero
*** SHOWDOWN ***
Hero collected $0.6 from pot
*** SUMMARY ***
Total pot $0.6
Seat 1: 8c86f461 (button) folded before Flop (didn't bet)
Seat 2: e6c023d1 (small blind) folded before Flop
Seat 3: af84e661 (big blind) folded before Flop
Seat 4: 65837850 folded before Flop (didn't bet)
Seat 5: Hero collected ($0.6)
Seat 6: 324d8e1d folded before Flop (didn't bet)


Poker Hand #RC95090573: Hold'em No Limit ($0.1/$0.25) - 2020/04/07 15:28:21
Table 'RushAndCash364764' 6-max Seat #1 is the button
Seat 1: 62eebc49 ($121.33 in chips)
Seat 2: d2f55a32 ($17.1 in chips)
Seat 3: 36017ad1 ($25.35 in chips)
Seat 4: Hero ($27.62 in chips)
Seat 5: 32953d2a ($13.55 in chips)
Seat 6: 7bf7c8c9 ($25.45 in chips)
d2f55a32: posts small blind $0.1
36017ad1: posts big blind $0.25
*** HOLE CARDS ***
Dealt to 62eebc49 
Dealt to d2f55a32 
Dealt to 36017ad1 
Dealt to Hero [Qh 9s]
Dealt to 32953d2a 
Dealt to 7bf7c8c9 
Hero: folds
32953d2a: folds
7bf7c8c9: folds
62eebc49: raises $0.38 to $0.63
d2f55a32: folds
36017ad1: calls $0.38
*** FLOP *** [4h Tc 8d]
36017ad1: checks
62eebc49: checks
*** TURN *** [4h Tc 8d] [5s]
36017ad1: bets $0.7
62eebc49: calls $0.7
*** RIVER *** [4h Tc 8d 5s] [Jc]
36017ad1: bets $1.4
62eebc49: calls $1.4
36017ad1: shows [6d Jd] (Pair of Jacks)
62eebc49: shows [8h 7s] (Pair of Eights)
*** SHOWDOWN ***
36017ad1 collected $5.56 from pot
*** SUMMARY ***
Total pot $5.56
Board [4h Tc 8d 5s Jc]
Seat 1: 62eebc49 (button) showed [8h 7s] and lost with Pair of Eights
Seat 2: d2f55a32 (small blind) folded before Flop
Seat 3: 36017ad1 (big blind) showed [Jd 6d] and won ($5.56) with Pair of Jacks
Seat 4: Hero folded before Flop (didn't bet)
Seat 5: 32953d2a folded before Flop (didn't bet)
Seat 6: 7bf7c8c9 folded before Flop (didn't bet)


Poker Hand #RC95090614: Hold'em No Limit ($0.1/$0.25) - 2020/04/07 15:28:26
Table 'RushAndCash364770' 6-max Seat #1 is the button
Seat 1: af84e661 ($4.92 in chips)
Seat 2: Hero ($27.62 in chips)
Seat 3: edde387a ($22.32 in chips)
Seat 4: 889e7e90 ($26.78 in chips)
Seat 5: fe3f48f4 ($28.59 in chips)
Seat 6: 366c47e0 ($12 in chips)
Hero: posts small blind $0.1
edde387a: posts big blind $0.25
*** HOLE CARDS ***
Dealt to af84e661 
Dealt to Hero [Qh 5c]
Dealt to edde387a 
Dealt to 889e7e90 
Dealt to fe3f48f4 
Dealt to 366c47e0 
889e7e90: folds
fe3f48f4: folds
366c47e0: raises $0.5 to $0.75
af84e661: folds
Hero: folds
edde387a: folds
Uncalled bet ($0.5) returned to 366c47e0
*** SHOWDOWN ***
366c47e0 collected $0.6 from pot
*** SUMMARY ***
Total pot $0.6
Seat 1: af84e661 (button) folded before Flop (didn't bet)
Seat 2: Hero (small blind) folded before Flop
Seat 3: edde387a (big blind) folded before Flop
Seat 4: 889e7e90 folded before Flop (didn't bet)
Seat 5: fe3f48f4 folded before Flop (didn't bet)
Seat 6: 366c47e0 collected ($0.6)


Poker Hand #RC95090641: Hold'em No Limit ($0.1/$0.25) - 2020/04/07 15:28:30
Table 'RushAndCash364774' 6-max Seat #1 is the button
Seat 1: Hero ($27.52 in chips)
Seat 2: 88709749 ($11.75 in chips)
Seat 3: d6f2a39c ($5.45 in chips)
Seat 4: fc8a29ea ($68.88 in chips)
Seat 5: fe3f48f4 ($28.59 in chips)
Seat 6: 889e7e90 ($26.78 in chips)
88709749: posts small blind $0.1
d6f2a39c: posts big blind $0.25
*** HOLE CARDS ***
Dealt to Hero [As 8s]
Dealt to 88709749 
Dealt to d6f2a39c 
Dealt to fc8a29ea 
Dealt to fe3f48f4 
Dealt to 889e7e90 
fc8a29ea: folds
fe3f48f4: folds
889e7e90: raises $0.38 to $0.63
Hero: calls $0.63
88709749: folds
d6f2a39c: folds
*** FLOP *** [5d 3c 5c]
889e7e90: bets $0.6
Hero: calls $0.6
*** TURN *** [5d 3c 5c] [Qh]
889e7e90: bets $1.75
Hero: folds
Uncalled bet ($1.75) returned to 889e7e90
*** SHOWDOWN ***
889e7e90 collected $2.81 from pot
*** SUMMARY ***
Total pot $2.81
Board [5d 3c 5c Qh]
Seat 1: Hero (button) folded on the Turn
Seat 2: 88709749 (small blind) folded before Flop
Seat 3: d6f2a39c (big blind) folded before Flop
Seat 4: fc8a29ea folded before Flop (didn't bet)
Seat 5: fe3f48f4 folded before Flop (didn't bet)
Seat 6: 889e7e90 won ($2.81)


Poker Hand #RC95090911: Hold'em No Limit ($0.1/$0.25) - 2020/04/07 15:29:04
Table 'RushAndCash364813' 6-max Seat #1 is the button
Seat 1: 704c37d9 ($47.1 in chips)
Seat 2: 889e7e90 ($28.22 in chips)
Seat 3: ecd599c ($8.52 in chips)
Seat 4: Hero ($26.29 in chips)
Seat 5: e6c023d1 ($33.7 in chips)
Seat 6: 518d077e ($37.18 in chips)
889e7e90: posts small blind $0.1
ecd599c: posts big blind $0.25
*** HOLE CARDS ***
Dealt to 704c37d9 
Dealt to 889e7e90 
Dealt to ecd599c 
Dealt to Hero [Qs 3h]
Dealt to e6c023d1 
Dealt to 518d077e 
Hero: folds
e6c023d1: raises $0.38 to $0.63
518d077e: folds
704c37d9: folds
889e7e90: calls $0.53
ecd599c: raises $7.89 to $8.52 and is all-in
e6c023d1: raises $25.18 to $33.7 and is all-in
889e7e90: folds
Uncalled bet ($25.18) returned to e6c023d1
e6c023d1: shows [Jd Jh]
ecd599c: shows [4d 4c]
*** FIRST FLOP *** [9h 8h Tc]
*** FIRST TURN *** [9h 8h Tc] [9s]
*** FIRST RIVER *** [9h 8h Tc 9s] [3s]
*** SECOND FLOP *** [4s 7s 5c]
*** SECOND TURN *** [4s 7s 5c] [8c]
*** SECOND RIVER *** [4s 7s 5c 8c] [8d]
*** THIRD FLOP *** [2d 2c 6h]
*** THIRD TURN *** [2d 2c 6h] [Ac]
*** THIRD RIVER *** [2d 2c 6h Ac] [9c]
*** FIRST SHOWDOWN ***
e6c023d1 collected $5.89 from pot
*** SECOND SHOWDOWN ***
ecd599c collected $5.89 from pot
*** THIRD SHOWDOWN ***
e6c023d1 collected $5.89 from pot
*** SUMMARY ***
Total pot $17.67
Hand was run three times
FIRST Board [9h 8h Tc 9s 3s]
SECOND Board [4s 7s 5c 8c 8d]
THIRD Board [2d 2c 6h Ac 9c]
Seat 1: 704c37d9 (button) folded before Flop (didn't bet)
Seat 2: 889e7e90 (small blind) folded before Flop
Seat 3: ecd599c (big blind) showed [4d 4c] and lost with Pair of Nines and Pair of Fours, and won ($5.89) with Fours Full over Eights, and lost with Pair of Fours and Pair of Twos
Seat 4: Hero folded before Flop (didn't bet)
Seat 5: e6c023d1 showed [Jh Jd] and won ($5.89) with Pair of Jacks and Pair of Nines, and lost with Pair of Jacks and Pair of Eights, and won ($5.89) with Pair of Jacks and Pair of Twos
Seat 6: 518d077e folded before Flop (didn't bet)


Poker Hand #RC95090933: Hold'em No Limit ($0.1/$0.25) - 2020/04/07 15:29:08
Table 'RushAndCash364815' 6-max Seat #1 is the button
Seat 1: d6f2a39c ($5.1 in chips)
Seat 2: be711e9d ($30.11 in chips)
Seat 3: 528a07f8 ($33.42 in chips)
Seat 4: 8004b155 ($7.94 in chips)
Seat 5: Hero ($26.29 in chips)
Seat 6: bf64de7f ($6.94 in chips)
be711e9d: posts small blind $0.1
528a07f8: posts big blind $0.25
*** HOLE CARDS ***
Dealt to d6f2a39c 
Dealt to be711e9d 
Dealt to 528a07f8 
Dealt to 8004b155 
Dealt to Hero [Th 9s]
Dealt to bf64de7f 
8004b155: folds
Hero: folds
bf64de7f: folds
d6f2a39c: folds
be711e9d: folds
Uncalled bet ($0.15) returned to 528a07f8
*** SHOWDOWN ***
528a07f8 collected $0.2 from pot
*** SUMMARY ***
Total pot $0.2
Seat 1: d6f2a39c (button) folded before Flop (didn't bet)
Seat 2: be711e9d (small blind) folded before Flop
Seat 3: 528a07f8 (big blind) collected ($0.2)
Seat 4: 8004b155 folded before Flop (didn't bet)
Seat 5: Hero folded before Flop (didn't bet)
Seat 6: bf64de7f folded before Flop (didn't bet)


Poker Hand #RC95090961: Hold'em No Limit ($0.1/$0.25) - 2020/04/07 15:29:12
Table 'RushAndCash364820' 6-max Seat #1 is the button
Seat 1: 45920dbc ($50.62 in chips)
Seat 2: fc8a29ea ($69.23 in chips)
Seat 3: Hero ($26.29 in chips)
Seat 4: af65165a ($13.84 in chips)
Seat 5: bb849ffc ($5.52 in chips)
Seat 6: 704c37d9 ($47.1 in chips)
fc8a29ea: posts small blind $0.1
Hero: posts big blind $0.25
*** HOLE CARDS ***
Dealt to 45920dbc 
Dealt to fc8a29ea 
Dealt to Hero [Ks Kd]
Dealt to af65165a 
Dealt to bb849ffc 
Dealt to 704c37d9 
af65165a: folds
bb849ffc: folds
704c37d9: folds
45920dbc: raises $0.38 to $0.63
fc8a29ea: folds
Hero: raises $1.87 to $2.5
45920dbc: folds
Uncalled bet ($1.87) returned to Hero
*** SHOWDOWN ***
Hero collected $1.36 from pot
*** SUMMARY ***
Total pot $1.36
Seat 1: 45920dbc (button) folded before Flop
Seat 2: fc8a29ea (small blind) folded before Flop
Seat 3: Hero (big blind) collected ($1.36)
Seat 4: af65165a folded before Flop (didn't bet)
Seat 5: bb849ffc folded before Flop (didn't bet)
Seat 6: 704c37d9 folded before Flop (didn't bet)


Poker Hand #RC95091178: Hold'em No Limit ($0.1/$0.25) - 2020/04/07 15:29:38
Table 'RushAndCash364845' 6-max Seat #1 is the button
Seat 1: 61ad32d ($18.99 in chips)
Seat 2: 91c71347 ($31.06 in chips)
Seat 3: 89387862 ($31.63 in chips)
Seat 4: 45920dbc ($49.99 in chips)
Seat 5: Hero ($26.96 in chips)
Seat 6: 528a07f8 ($33.52 in chips)
91c71347: posts small blind $0.1
89387862: posts big blind $0.25
*** HOLE CARDS ***
Dealt to 61ad32d 
Dealt to 91c71347 
Dealt to 89387862 
Dealt to 45920dbc 
Dealt to Hero [Kc Qc]
Dealt to 528a07f8 
45920dbc: folds
Hero: raises $0.38 to $0.63
528a07f8: folds
61ad32d: folds
91c71347: folds
89387862: calls $0.38
*** FLOP *** [9h 8c 7h]
89387862: checks
Hero: bets $1.1
89387862: folds
Uncalled bet ($1.1) returned to Hero
*** SHOWDOWN ***
Hero collected $1.36 from pot
*** SUMMARY ***
Total pot $1.36
Board [9h 8c 7h]
Seat 1: 61ad32d (button) folded before Flop (didn't bet)
Seat 2: 91c71347 (small blind) folded before Flop
Seat 3: 89387862 (big blind) folded on the Flop
Seat 4: 45920dbc folded before Flop (didn't bet)
Seat 5: Hero won ($1.36)
Seat 6: 528a07f8 folded before Flop (didn't bet)


Poker Hand #RC95091529: Hold'em No Limit ($0.1/$0.25) - 2020/04/07 15:30:22
Table 'RushAndCash364889' 6-max Seat #1 is the button
Seat 1: edde387a ($24.36 in chips)
Seat 2: be711e9d ($30.01 in chips)
Seat 3: 3d395129 ($12 in chips)
Seat 4: f9ba2d22 ($17.93 in chips)
Seat 5: Hero ($27.63 in chips)
Seat 6: 89387862 ($31 in chips)
be711e9d: posts small blind $0.1
3d395129: posts big blind $0.25
*** HOLE CARDS ***
Dealt to edde387a 
Dealt to be711e9d 
Dealt to 3d395129 
Dealt to f9ba2d22 
Dealt to Hero [Qc 6h]
Dealt to 89387862 
f9ba2d22: raises $0.5 to $0.75
Hero: folds
89387862: raises $1.5 to $2.25
edde387a: folds
be711e9d: folds
3d395129: folds
f9ba2d22: raises $4.85 to $7.1
89387862: folds
Uncalled bet ($4.85) returned to f9ba2d22
*** SHOWDOWN ***
f9ba2d22 collected $4.85 from pot
*** SUMMARY ***
Total pot $4.85
Seat 1: edde387a (button) folded before Flop (didn't bet)
Seat 2: be711e9d (small blind) folded before Flop
Seat 3: 3d395129 (big blind) folded before Flop
Seat 4: f9ba2d22 collected ($4.85)
Seat 5: Hero folded before Flop (didn't bet)
Seat 6: 89387862 folded before Flop


Poker Hand #RC95091586: Hold'em No Limit ($0.1/$0.25) - 2020/04/07 15:30:29
Table 'RushAndCash364894' 6-max Seat #1 is the button
Seat 1: 6736194e ($25.36 in chips)
Seat 2: 1179c6f3 ($26.36 in chips)
Seat 3: d6f2a39c ($5 in chips)
Seat 4: 17388104 ($17.97 in chips)
Seat 5: be711e9d ($29.91 in chips)
Seat 6: Hero ($27.63 in chips)
1179c6f3: posts small blind $0.1
d6f2a39c: posts big blind $0.25
*** HOLE CARDS ***
Dealt to 6736194e 
Dealt to 1179c6f3 
Dealt to d6f2a39c 
Dealt to 17388104 
Dealt to be711e9d 
Dealt to Hero [Kh Js]
17388104: folds
be711e9d: folds
Hero: raises $0.38 to $0.63
6736194e: folds
1179c6f3: raises $1.62 to $2.25
d6f2a39c: folds
Hero: folds
Uncalled bet ($1.62) returned to 1179c6f3
*** SHOWDOWN ***
1179c6f3 collected $1.51 from pot
*** SUMMARY ***
Total pot $1.51
Seat 1: 6736194e (button) folded before Flop (didn't bet)
Seat 2: 1179c6f3 (small blind) collected ($1.51)
Seat 3: d6f2a39c (big blind) folded before Flop
Seat 4: 17388104 folded before Flop (didn't bet)
Seat 5: be711e9d folded before Flop (didn't bet)
Seat 6: Hero folded before Flop


Poker Hand #RC95091759: Hold'em No Limit ($0.1/$0.25) - 2020/04/07 15:30:51
Table 'RushAndCash364914' 6-max Seat #1 is the button
Seat 1: 5ffa3a03 ($16.7 in chips)
Seat 2: Hero ($27 in chips)
Seat 3: 704a7fcf ($29.93 in chips)
Seat 4: 1179c6f3 ($27.17 in chips)
Seat 5: be711e9d ($30.26 in chips)
Seat 6: 45920dbc ($48.34 in chips)
Hero: posts small blind $0.1
704a7fcf: posts big blind $0.25
*** HOLE CARDS ***
Dealt to 5ffa3a03 
Dealt to Hero [Ts 8d]
Dealt to 704a7fcf 
Dealt to 1179c6f3 
Dealt to be711e9d 
Dealt to 45920dbc 
1179c6f3: raises $0.5 to $0.75
be711e9d: folds
45920dbc: folds
5ffa3a03: folds
Hero: folds
704a7fcf: folds
Uncalled bet ($0.5) returned to 1179c6f3
*** SHOWDOWN ***
1179c6f3 collected $0.6 from pot
*** SUMMARY ***
Total pot $0.6
Seat 1: 5ffa3a03 (button) folded before Flop (didn't bet)
Seat 2: Hero (small blind) folded before Flop
Seat 3: 704a7fcf (big blind) folded before Flop
Seat 4: 1179c6f3 collected ($0.6)
Seat 5: be711e9d folded before Flop (didn't bet)
Seat 6: 45920dbc folded before Flop (didn't bet)


Poker Hand #RC95091790: Hold'em No Limit ($0.1/$0.25) - 2020/04/07 15:30:55
Table 'RushAndCash364917' 6-max Seat #1 is the button
Seat 1: Hero ($26.9 in chips)
Seat 2: 1780ed6 ($56.22 in chips)
Seat 3: 74937d40 ($28.16 in chips)
Seat 4: 9f138297 ($31.25 in chips)
Seat 5: fc8a29ea ($69.95 in chips)
Seat 6: dbf6981f ($57.85 in chips)
1780ed6: posts small blind $0.1
74937d40: posts big blind $0.25
*** HOLE CARDS ***
Dealt to Hero [Kd 2d]
Dealt to 1780ed6 
Dealt to 74937d40 
Dealt to 9f138297 
Dealt to fc8a29ea 
Dealt to dbf6981f 
9f138297: folds
fc8a29ea: folds
dbf6981f: folds
Hero: folds
1780ed6: folds
Uncalled bet ($0.15) returned to 74937d40
*** SHOWDOWN ***
74937d40 collected $0.2 from pot
*** SUMMARY ***
Total pot $0.2
Seat 1: Hero (button) folded before Flop (didn't bet)
Seat 2: 1780ed6 (small blind) folded before Flop
Seat 3: 74937d40 (big blind) collected ($0.2)
Seat 4: 9f138297 folded before Flop (didn't bet)
Seat 5: fc8a29ea folded before Flop (didn't bet)
Seat 6: dbf6981f folded before Flop (didn't bet)


Poker Hand #RC95091824: Hold'em No Limit ($0.1/$0.25) - 2020/04/07 15:30:59
Table 'RushAndCash364922' 6-max Seat #1 is the button
Seat 1: 704a7fcf ($29.68 in chips)
Seat 2: 52ee6b3d ($25.85 in chips)
Seat 3: Hero ($26.9 in chips)
Seat 4: 45920dbc ($48.34 in chips)
Seat 5: 36017ad1 ($28.84 in chips)
Seat 6: d07b3de1 ($30.57 in chips)
52ee6b3d: posts small blind $0.1
Hero: posts big blind $0.25
*** HOLE CARDS ***
Dealt to 704a7fcf 
Dealt to 52ee6b3d 
Dealt to Hero [Jh 9d]
Dealt to 45920dbc 
Dealt to 36017ad1 
Dealt to d07b3de1 
45920dbc: folds
36017ad1: folds
d07b3de1: folds
704a7fcf: raises $0.38 to $0.63
52ee6b3d: folds
Hero: folds
Uncalled bet ($0.38) returned to 704a7fcf
*** SHOWDOWN ***
704a7fcf collected $0.6 from pot
*** SUMMARY ***
Total pot $0.6
Seat 1: 704a7fcf (button) collected ($0.6)
Seat 2: 52ee6b3d (small blind) folded before Flop
Seat 3: Hero (big blind) folded before Flop
Seat 4: 45920dbc folded before Flop (didn't bet)
Seat 5: 36017ad1 folded before Flop (didn't bet)
Seat 6: d07b3de1 folded before Flop (didn't bet)


Poker Hand #RC95091850: Hold'em No Limit ($0.1/$0.25) - 2020/04/07 15:31:02
Table 'RushAndCash364927' 6-max Seat #1 is the button
Seat 1: 889e7e90 ($28.59 in chips)
Seat 2: 81c6db62 ($29.57 in chips)
Seat 3: 6736194e ($25.36 in chips)
Seat 4: Hero ($26.65 in chips)
Seat 5: c4f78976 ($11.12 in chips)
Seat 6: d2f55a32 ($17.9 in chips)
81c6db62: posts small blind $0.1
6736194e: posts big blind $0.25
*** HOLE CARDS ***
Dealt to 889e7e90 
Dealt to 81c6db62 
Dealt to 6736194e 
Dealt to Hero [7d 4d]
Dealt to c4f78976 
Dealt to d2f55a32 
Hero: folds
c4f78976: folds
d2f55a32: folds
889e7e90: raises $0.5 to $0.75
81c6db62: folds
6736194e: folds
Uncalled bet ($0.5) returned to 889e7e90
*** SHOWDOWN ***
889e7e90 collected $0.6 from pot
*** SUMMARY ***
Total pot $0.6
Seat 1: 889e7e90 (button) collected ($0.6)
Seat 2: 81c6db62 (small blind) folded before Flop
Seat 3: 6736194e (big blind) folded before Flop
Seat 4: Hero folded before Flop (didn't bet)
Seat 5: c4f78976 folded before Flop (didn't bet)
Seat 6: d2f55a32 folded before Flop (didn't bet)


Poker Hand #RC95091881: Hold'em No Limit ($0.1/$0.25) - 2020/04/07 15:31:07
Table 'RushAndCash364932' 6-max Seat #1 is the button
Seat 1: 45920dbc ($48.34 in chips)
Seat 2: d6f2a39c ($5.1 in chips)
Seat 3: d2f55a32 ($17.9 in chips)
Seat 4: c4f78976 ($11.12 in chips)
Seat 5: Hero ($26.65 in chips)
Seat 6: 62eebc49 ($118.25 in chips)
d6f2a39c: posts small blind $0.1
d2f55a32: posts big blind $0.25
*** HOLE CARDS ***
Dealt to 45920dbc 
Dealt to d6f2a39c 
Dealt to d2f55a32 
Dealt to c4f78976 
Dealt to Hero [Qh 4c]
Dealt to 62eebc49 
c4f78976: folds
Hero: folds
62eebc49: folds
45920dbc: folds
d6f2a39c: raises $0.38 to $0.63
d2f55a32: raises $17.27 to $17.9 and is all-in
d6f2a39c: calls $4.47 and is all-in
Uncalled bet ($12.8) returned to d2f55a32
d2f55a32: shows [Jd Ks]
d6f2a39c: shows [2d 2s]
*** FIRST FLOP *** [8s Ts As]
*** FIRST TURN *** [8s Ts As] [Td]
*** FIRST RIVER *** [8s Ts As Td] [Ah]
*** SECOND FLOP *** [9s 8d Jh]
*** SECOND TURN *** [9s 8d Jh] [3h]
*** SECOND RIVER *** [9s 8d Jh 3h] [2c]
*** FIRST SHOWDOWN ***
d2f55a32 collected $5.1 from pot
*** SECOND SHOWDOWN ***
d6f2a39c collected $5.1 from pot
*** SUMMARY ***
Total pot $10.2
Hand was run two times
FIRST Board [8s Ts As Td Ah]
SECOND Board [9s 8d Jh 3h 2c]
Seat 1: 45920dbc (button) folded before Flop (didn't bet)
Seat 2: d6f2a39c (small blind) showed [2s 2d] and lost with Pair of Aces and Pair of Tens, and won ($5.1) with Three Twos
Seat 3: d2f55a32 (big blind) showed [Ks Jd] and won ($5.1) with Pair of Aces and Pair of Tens, and lost with Pair of Jacks
Seat 4: c4f78976 folded before Flop (didn't bet)
Seat 5: Hero folded before Flop (didn't bet)
Seat 6: 62eebc49 folded before Flop (didn't bet)


Poker Hand #RC95091915: Hold'em No Limit ($0.1/$0.25) - 2020/04/07 15:31:12
Table 'RushAndCash364937' 6-max Seat #1 is the button
Seat 1: 81c6db62 ($29.47 in chips)
Seat 2: Hero ($26.65 in chips)
Seat 3: 51c60a1c ($8.39 in chips)
Seat 4: b5d592d2 ($12.41 in chips)
Seat 5: b431c8b6 ($31.46 in chips)
Seat 6: 62eebc49 ($118.25 in chips)
Hero: posts small blind $0.1
51c60a1c: posts big blind $0.25
*** HOLE CARDS ***
Dealt to 81c6db62 
Dealt to Hero [8d 4h]
Dealt to 51c60a1c 
Dealt to b5d592d2 
Dealt to b431c8b6 
Dealt to 62eebc49 
b5d592d2: folds
b431c8b6: folds
62eebc49: folds
81c6db62: raises $0.5 to $0.75
Hero: folds
51c60a1c: folds
Uncalled bet ($0.5) returned to 81c6db62
*** SHOWDOWN ***
81c6db62 collected $0.6 from pot
*** SUMMARY ***
Total pot $0.6
Seat 1: 81c6db62 (button) collected ($0.6)
Seat 2: Hero (small blind) folded before Flop
Seat 3: 51c60a1c (big blind) folded before Flop
Seat 4: b5d592d2 folded before Flop (didn't bet)
Seat 5: b431c8b6 folded before Flop (didn't bet)
Seat 6: 62eebc49 folded before Flop (didn't bet)


Poker Hand #RC95091942: Hold'em No Limit ($0.1/$0.25) - 2020/04/07 15:31:16
Table 'RushAndCash364942' 6-max Seat #1 is the button
Seat 1: Hero ($26.55 in chips)
Seat 2: bda1b4ce ($25.35 in chips)
Seat 3: dbf6981f ($57.85 in chips)
Seat 4: cae4d8ce ($13.78 in chips)
Seat 5: bf64de7f ($7.29 in chips)
Seat 6: 103129d8 ($24.57 in chips)
bda1b4ce: posts small blind $0.1
dbf6981f: posts big blind $0.25
*** HOLE CARDS ***
Dealt to Hero [9d 7c]
Dealt to bda1b4ce 
Dealt to dbf6981f 
Dealt to cae4d8ce 
Dealt to bf64de7f 
Dealt to 103129d8 
cae4d8ce: folds
bf64de7f: folds
103129d8: raises $0.75 to $1
Hero: folds
bda1b4ce: folds
dbf6981f: folds
Uncalled bet ($0.75) returned to 103129d8
*** SHOWDOWN ***
103129d8 collected $0.6 from pot
*** SUMMARY ***
Total pot $0.6
Seat 1: Hero (button) folded before Flop (didn't bet)
Seat 2: bda1b4ce (small blind) folded before Flop
Seat 3: dbf6981f (big blind) folded before Flop
Seat 4: cae4d8ce folded before Flop (didn't bet)
Seat 5: bf64de7f folded before Flop (didn't bet)
Seat 6: 103129d8 collected ($0.6)


Poker Hand #RC95091981: Hold'em No Limit ($0.1/$0.25) - 2020/04/07 15:31:21
Table 'RushAndCash364947' 6-max Seat #1 is the button
Seat 1: 90ddca47 ($30.98 in chips)
Seat 2: 966446c2 ($34.06 in chips)
Seat 3: b3f0b9e0 ($12.35 in chips)
Seat 4: 8c86f461 ($41.29 in chips)
Seat 5: bf64de7f ($7.29 in chips)
Seat 6: Hero ($26.55 in chips)
966446c2: posts small blind $0.1
b3f0b9e0: posts big blind $0.25
*** HOLE CARDS ***
Dealt to 90ddca47 
Dealt to 966446c2 
Dealt to b3f0b9e0 
Dealt to 8c86f461 
Dealt to bf64de7f 
Dealt to Hero [Qc 7c]
8c86f461: folds
bf64de7f: raises $0.38 to $0.63
Hero: folds
90ddca47: folds
966446c2: calls $0.53
b3f0b9e0: calls $0.38
*** FLOP *** [4c Ac 7s]
966446c2: checks
b3f0b9e0: checks
bf64de7f: checks
*** TURN *** [4c Ac 7s] [Jd]
966446c2: checks
b3f0b9e0: checks
bf64de7f: checks
*** RIVER *** [4c Ac 7s Jd] [2d]
966446c2: checks
b3f0b9e0: checks
bf64de7f: checks
966446c2: shows [8c 9c] (Ace-High)
b3f0b9e0: shows [9s 8h] (Ace-High)
bf64de7f: shows [5c 5s] (Pair of Fives)
*** SHOWDOWN ***
bf64de7f collected $1.89 from pot
*** SUMMARY ***
Total pot $1.89
Board [4c Ac 7s Jd 2d]
Seat 1: 90ddca47 (button) folded before Flop (didn't bet)
Seat 2: 966446c2 (small blind) showed [9c 8c] and lost with Ace-High
Seat 3: b3f0b9e0 (big blind) showed [9s 8h] and lost with Ace-High
Seat 4: 8c86f461 folded before Flop (didn't bet)
Seat 5: bf64de7f showed [5s 5c] and won ($1.89) with Pair of Fives
Seat 6: Hero folded before Flop (didn't bet)


Poker Hand #RC95092017: Hold'em No Limit ($0.1/$0.25) - 2020/04/07 15:31:25
Table 'RushAndCash364952' 6-max Seat #1 is the button
Seat 1: b431c8b6 ($31.36 in chips)
Seat 2: 62eebc49 ($118.25 in chips)
Seat 3: Hero ($26.55 in chips)
Seat 4: 8004b155 ($11.65 in chips)
Seat 5: 61ad32d ($18.82 in chips)
Seat 6: e131407f ($30.66 in chips)
62eebc49: posts small blind $0.1
Hero: posts big blind $0.25
*** HOLE CARDS ***
Dealt to b431c8b6 
Dealt to 62eebc49 
Dealt to Hero [7c 2s]
Dealt to 8004b155 
Dealt to 61ad32d 
Dealt to e131407f 
8004b155: folds
61ad32d: folds
e131407f: folds
b431c8b6: raises $0.38 to $0.63
62eebc49: folds
Hero: folds
Uncalled bet ($0.38) returned to b431c8b6
*** SHOWDOWN ***
b431c8b6 collected $0.6 from pot
*** SUMMARY ***
Total pot $0.6
Seat 1: b431c8b6 (button) collected ($0.6)
Seat 2: 62eebc49 (small blind) folded before Flop
Seat 3: Hero (big blind) folded before Flop
Seat 4: 8004b155 folded before Flop (didn't bet)
Seat 5: 61ad32d folded before Flop (didn't bet)
Seat 6: e131407f folded before Flop (didn't bet)


Poker Hand #RC95092054: Hold'em No Limit ($0.1/$0.25) - 2020/04/07 15:31:30
Table 'RushAndCash364957' 6-max Seat #1 is the button
Seat 1: 65837850 ($132.69 in chips)
Seat 2: 88709749 ($7.32 in chips)
Seat 3: 45920dbc ($48.24 in chips)
Seat 4: efdadab5 ($11.65 in chips)
Seat 5: Hero ($26.3 in chips)
Seat 6: 90ddca47 ($30.98 in chips)
88709749: posts small blind $0.1
45920dbc: posts big blind $0.25
*** HOLE CARDS ***
Dealt to 65837850 
Dealt to 88709749 
Dealt to 45920dbc 
Dealt to efdadab5 
Dealt to Hero [9c 4h]
Dealt to 90ddca47 
efdadab5: raises $0.38 to $0.63
Hero: folds
90ddca47: folds
65837850: folds
88709749: folds
45920dbc: folds
Uncalled bet ($0.38) returned to efdadab5
*** SHOWDOWN ***
efdadab5 collected $0.6 from pot
*** SUMMARY ***
Total pot $0.6
Seat 1: 65837850 (button) folded before Flop (didn't bet)
Seat 2: 88709749 (small blind) folded before Flop
Seat 3: 45920dbc (big blind) folded before Flop
Seat 4: efdadab5 collected ($0.6)
Seat 5: Hero folded before Flop (didn't bet)
Seat 6: 90ddca47 folded before Flop (didn't bet)


Poker Hand #RC95092095: Hold'em No Limit ($0.1/$0.25) - 2020/04/07 15:31:34
Table 'RushAndCash364962' 6-max Seat #1 is the button
Seat 1: 62eebc49 ($118.15 in chips)
Seat 2: e814b201 ($25.2 in chips)
Seat 3: 7bf7c8c9 ($25 in chips)
Seat 4: Hero ($26.3 in chips)
Seat 5: d2986703 ($42.67 in chips)
Seat 6: d437c92d ($65.44 in chips)
e814b201: posts small blind $0.1
7bf7c8c9: posts big blind $0.25
*** HOLE CARDS ***
Dealt to 62eebc49 
Dealt to e814b201 
Dealt to 7bf7c8c9 
Dealt to Hero [Js 2s]
Dealt to d2986703 
Dealt to d437c92d 
Hero: folds
d2986703: raises $0.5 to $0.75
d437c92d: folds
62eebc49: folds
e814b201: folds
7bf7c8c9: folds
Uncalled bet ($0.5) returned to d2986703
*** SHOWDOWN ***
d2986703 collected $0.6 from pot
*** SUMMARY ***
Total pot $0.6
Seat 1: 62eebc49 (button) folded before Flop (didn't bet)
Seat 2: e814b201 (small blind) folded before Flop
Seat 3: 7bf7c8c9 (big blind) folded before Flop
Seat 4: Hero folded before Flop (didn't bet)
Seat 5: d2986703 collected ($0.6)
Seat 6: d437c92d folded before Flop (didn't bet)


Poker Hand #RC95092127: Hold'em No Limit ($0.1/$0.25) - 2020/04/07 15:31:39
Table 'RushAndCash364967' 6-max Seat #1 is the button
Seat 1: c4f78976 ($11.79 in chips)
Seat 2: Hero ($26.3 in chips)
Seat 3: 90ddca47 ($30.98 in chips)
Seat 4: 81c6db62 ($29.82 in chips)
Seat 5: 7c0ffa93 ($33.94 in chips)
Seat 6: 704a7fcf ($29.68 in chips)
Hero: posts small blind $0.1
90ddca47: posts big blind $0.25
*** HOLE CARDS ***
Dealt to c4f78976 
Dealt to Hero [3s 3d]
Dealt to 90ddca47 
Dealt to 81c6db62 
Dealt to 7c0ffa93 
Dealt to 704a7fcf 
81c6db62: folds
7c0ffa93: folds
704a7fcf: folds
c4f78976: folds
Hero: raises $0.5 to $0.75
90ddca47: folds
Uncalled bet ($0.5) returned to Hero
*** SHOWDOWN ***
Hero collected $0.5 from pot
*** SUMMARY ***
Total pot $0.5
Seat 1: c4f78976 (button) folded before Flop (didn't bet)
Seat 2: Hero (small blind) collected ($0.5)
Seat 3: 90ddca47 (big blind) folded before Flop
Seat 4: 81c6db62 folded before Flop (didn't bet)
Seat 5: 7c0ffa93 folded before Flop (didn't bet)
Seat 6: 704a7fcf folded before Flop (didn't bet)


Poker Hand #RC95092293: Hold'em No Limit ($0.1/$0.25) - 2020/04/07 15:32:00
Table 'RushAndCash364984' 6-max Seat #1 is the button
Seat 1: d6f2a39c ($4.72 in chips)
Seat 2: d2f55a32 ($17.52 in chips)
Seat 3: d2986703 ($43.02 in chips)
Seat 4: af65165a ($11.48 in chips)
Seat 5: a0d04110 ($43.69 in chips)
Seat 6: Hero ($26.55 in chips)
d2f55a32: posts small blind $0.1
d2986703: posts big blind $0.25
*** HOLE CARDS ***
Dealt to d6f2a39c 
Dealt to d2f55a32 
Dealt to d2986703 
Dealt to af65165a 
Dealt to a0d04110 
Dealt to Hero [6s 3d]
af65165a: folds
a0d04110: folds
Hero: folds
d6f2a39c: raises $0.25 to $0.5
d2f55a32: folds
d2986703: folds
Uncalled bet ($0.25) returned to d6f2a39c
*** SHOWDOWN ***
d6f2a39c collected $0.6 from pot
*** SUMMARY ***
Total pot $0.6
Seat 1: d6f2a39c (button) collected ($0.6)
Seat 2: d2f55a32 (small blind) folded before Flop
Seat 3: d2986703 (big blind) folded before Flop
Seat 4: af65165a folded before Flop (didn't bet)
Seat 5: a0d04110 folded before Flop (didn't bet)
Seat 6: Hero folded before Flop (didn't bet)


Poker Hand #RC95092315: Hold'em No Limit ($0.1/$0.25) - 2020/04/07 15:32:03
Table 'RushAndCash364987' 6-max Seat #1 is the button
Seat 1: 4c91cf91 ($13.72 in chips)
Seat 2: ab29e296 ($19.11 in chips)
Seat 3: caa68458 ($25 in chips)
Seat 4: Hero ($26.55 in chips)
Seat 5: 103129d8 ($24.92 in chips)
Seat 6: 90ddca47 ($30.73 in chips)
ab29e296: posts small blind $0.1
caa68458: posts big blind $0.25
*** HOLE CARDS ***
Dealt to 4c91cf91 
Dealt to ab29e296 
Dealt to caa68458 
Dealt to Hero [3h 3c]
Dealt to 103129d8 
Dealt to 90ddca47 
Hero: folds
103129d8: folds
90ddca47: folds
4c91cf91: calls $0.25
ab29e296: folds
caa68458: checks
*** FLOP *** [9h 8c Jh]
caa68458: checks
4c91cf91: checks
*** TURN *** [9h 8c Jh] [6d]
caa68458: bets $0.25
4c91cf91: calls $0.25
*** RIVER *** [9h 8c Jh 6d] [Th]
caa68458: checks
4c91cf91: checks
caa68458: shows [8s 2d] (Pair of Eights)
4c91cf91: shows [5c 5s] (Pair of Fives)
*** SHOWDOWN ***
caa68458 collected $1.1 from pot
*** SUMMARY ***
Total pot $1.1
Board [9h 8c Jh 6d Th]
Seat 1: 4c91cf91 (button) showed [5s 5c] and lost with Pair of Fives
Seat 2: ab29e296 (small blind) folded before Flop
Seat 3: caa68458 (big blind) showed [8s 2d] and won ($1.1) with Pair of Eights
Seat 4: Hero folded before Flop (didn't bet)
Seat 5: 103129d8 folded before Flop (didn't bet)
Seat 6: 90ddca47 folded before Flop (didn't bet)


Poker Hand #RC95092341: Hold'em No Limit ($0.1/$0.25) - 2020/04/07 15:32:07
Table 'RushAndCash364990' 6-max Seat #1 is the button
Seat 1: Hero ($26.55 in chips)
Seat 2: fe3f48f4 ($25 in chips)
Seat 3: 49b3e425 ($27.52 in chips)
Seat 4: ecd599c ($9 in chips)
Seat 5: af84e661 ($3.12 in chips)
Seat 6: 366c47e0 ($9.13 in chips)
fe3f48f4: posts small blind $0.1
49b3e425: posts big blind $0.25
*** HOLE CARDS ***
Dealt to Hero [Qh 7s]
Dealt to fe3f48f4 
Dealt to 49b3e425 
Dealt to ecd599c 
Dealt to af84e661 
Dealt to 366c47e0 
ecd599c: folds
af84e661: folds
366c47e0: folds
Hero: folds
fe3f48f4: folds
Uncalled bet ($0.15) returned to 49b3e425
*** SHOWDOWN ***
49b3e425 collected $0.2 from pot
*** SUMMARY ***
Total pot $0.2
Seat 1: Hero (button) folded before Flop (didn't bet)
Seat 2: fe3f48f4 (small blind) folded before Flop
Seat 3: 49b3e425 (big blind) collected ($0.2)
Seat 4: ecd599c folded before Flop (didn't bet)
Seat 5: af84e661 folded before Flop (didn't bet)
Seat 6: 366c47e0 folded before Flop (didn't bet)


Poker Hand #RC95092361: Hold'em No Limit ($0.1/$0.25) - 2020/04/07 15:32:09
Table 'RushAndCash364993' 6-max Seat #1 is the button
Seat 1: 103129d8 ($24.92 in chips)
Seat 2: b3f0b9e0 ($11.72 in chips)
Seat 3: Hero ($26.55 in chips)
Seat 4: bf64de7f ($8.46 in chips)
Seat 5: 966446c2 ($33.43 in chips)
Seat 6: 5794e88f ($40.26 in chips)
b3f0b9e0: posts small blind $0.1
Hero: posts big blind $0.25
*** HOLE CARDS ***
Dealt to 103129d8 
Dealt to b3f0b9e0 
Dealt to Hero [Js 9s]
Dealt to bf64de7f 
Dealt to 966446c2 
Dealt to 5794e88f 
bf64de7f: folds
966446c2: raises $0.5 to $0.75
5794e88f: folds
103129d8: folds
b3f0b9e0: calls $0.65
Hero: calls $0.5
*** FLOP *** [Jh 8c 5s]
b3f0b9e0: checks
Hero: checks
966446c2: bets $1.2
b3f0b9e0: folds
Hero: calls $1.2
*** TURN *** [Jh 8c 5s] [Qs]
Hero: checks
966446c2: checks
*** RIVER *** [Jh 8c 5s Qs] [Td]
Hero: bets $4.7
966446c2: folds
Uncalled bet ($4.7) returned to Hero
*** SHOWDOWN ***
Hero collected $4.65 from pot
*** SUMMARY ***
Total pot $4.65
Board [Jh 8c 5s Qs Td]
Seat 1: 103129d8 (button) folded before Flop (didn't bet)
Seat 2: b3f0b9e0 (small blind) folded on the Flop
Seat 3: Hero (big blind) won ($4.65)
Seat 4: bf64de7f folded before Flop (didn't bet)
Seat 5: 966446c2 folded on the River
Seat 6: 5794e88f folded before Flop (didn't bet)


Poker Hand #RC95092916: Hold'em No Limit ($0.1/$0.25) - 2020/04/07 15:33:26
Table 'RushAndCash365056' 6-max Seat #1 is the button
Seat 1: 275e7f74 ($25 in chips)
Seat 2: 51c60a1c ($6.44 in chips)
Seat 3: 52ee6b3d ($30.13 in chips)
Seat 4: Hero ($29.02 in chips)
Seat 5: 966446c2 ($31.48 in chips)
Seat 6: 8b8d197c ($33.9 in chips)
51c60a1c: posts small blind $0.1
52ee6b3d: posts big blind $0.25
*** HOLE CARDS ***
Dealt to 275e7f74 
Dealt to 51c60a1c 
Dealt to 52ee6b3d 
Dealt to Hero [Jc 7h]
Dealt to 966446c2 
Dealt to 8b8d197c 
Hero: folds
966446c2: raises $0.5 to $0.75
8b8d197c: folds
275e7f74: folds
51c60a1c: raises $0.95 to $1.7
52ee6b3d: folds
966446c2: folds
Uncalled bet ($0.95) returned to 51c60a1c
*** SHOWDOWN ***
51c60a1c collected $1.75 from pot
*** SUMMARY ***
Total pot $1.75
Seat 1: 275e7f74 (button) folded before Flop (didn't bet)
Seat 2: 51c60a1c (small blind) collected ($1.75)
Seat 3: 52ee6b3d (big blind) folded before Flop
Seat 4: Hero folded before Flop (didn't bet)
Seat 5: 966446c2 folded before Flop
Seat 6: 8b8d197c folded before Flop (didn't bet)


Poker Hand #RC95092949: Hold'em No Limit ($0.1/$0.25) - 2020/04/07 15:33:30
Table 'RushAndCash365061' 6-max Seat #1 is the button
Seat 1: 32953d2a ($12.85 in chips)
Seat 2: 4dd920ba ($41.55 in chips)
Seat 3: d2f55a32 ($16.32 in chips)
Seat 4: Hero ($29.02 in chips)
Seat 5: b5d592d2 ($11.96 in chips)
Seat 6: 275e7f74 ($25 in chips)
4dd920ba: posts small blind $0.1
d2f55a32: posts big blind $0.25
*** HOLE CARDS ***
Dealt to 32953d2a 
Dealt to 4dd920ba 
Dealt to d2f55a32 
Dealt to Hero [Jd 9c]
Dealt to b5d592d2 
Dealt to 275e7f74 
Hero: folds
b5d592d2: folds
275e7f74: folds
32953d2a: folds
4dd920ba: folds
Uncalled bet ($0.15) returned to d2f55a32
*** SHOWDOWN ***
d2f55a32 collected $0.2 from pot
*** SUMMARY ***
Total pot $0.2
Seat 1: 32953d2a (button) folded before Flop (didn't bet)
Seat 2: 4dd920ba (small blind) folded before Flop
Seat 3: d2f55a32 (big blind) collected ($0.2)
Seat 4: Hero folded before Flop (didn't bet)
Seat 5: b5d592d2 folded before Flop (didn't bet)
Seat 6: 275e7f74 folded before Flop (didn't bet)


Poker Hand #RC95092983: Hold'em No Limit ($0.1/$0.25) - 2020/04/07 15:33:35
Table 'RushAndCash365065' 6-max Seat #1 is the button
Seat 1: 9c76a6c2 ($25.92 in chips)
Seat 2: 7c0ffa93 ($33.19 in chips)
Seat 3: 275e7f74 ($25 in chips)
Seat 4: 4dd920ba ($41.45 in chips)
Seat 5: 704a7fcf ($29.89 in chips)
Seat 6: Hero ($29.02 in chips)
7c0ffa93: posts small blind $0.1
275e7f74: posts big blind $0.25
*** HOLE CARDS ***
Dealt to 9c76a6c2 
Dealt to 7c0ffa93 
Dealt to 275e7f74 
Dealt to 4dd920ba 
Dealt to 704a7fcf 
Dealt to Hero [Kc 5s]
4dd920ba: folds
704a7fcf: folds
Hero: folds
9c76a6c2: folds
7c0ffa93: raises $0.5 to $0.75
275e7f74: calls $0.5
*** FLOP *** [8s 2c 5c]
7c0ffa93: bets $0.75
275e7f74: folds
Uncalled bet ($0.75) returned to 7c0ffa93
*** SHOWDOWN ***
7c0ffa93 collected $1.5 from pot
*** SUMMARY ***
Total pot $1.5
Board [8s 2c 5c]
Seat 1: 9c76a6c2 (button) folded before Flop (didn't bet)
Seat 2: 7c0ffa93 (small blind) won ($1.5)
Seat 3: 275e7f74 (big blind) folded on the Flop
Seat 4: 4dd920ba folded before Flop (didn't bet)
Seat 5: 704a7fcf folded before Flop (didn't bet)
Seat 6: Hero folded before Flop (didn't bet)


Poker Hand #RC95093026: Hold'em No Limit ($0.1/$0.25) - 2020/04/07 15:33:40
Table 'RushAndCash365069' 6-max Seat #1 is the button
Seat 1: 8b8d197c ($33.9 in chips)
Seat 2: Hero ($29.02 in chips)
Seat 3: bda1b4ce ($25 in chips)
Seat 4: d3373005 ($13.51 in chips)
Seat 5: 49b3e425 ($27.97 in chips)
Seat 6: edde387a ($24.38 in chips)
Hero: posts small blind $0.1
bda1b4ce: posts big blind $0.25
*** HOLE CARDS ***
Dealt to 8b8d197c 
Dealt to Hero [7c 2h]
Dealt to bda1b4ce 
Dealt to d3373005 
Dealt to 49b3e425 
Dealt to edde387a 
d3373005: folds
49b3e425: folds
edde387a: folds
8b8d197c: folds
Hero: folds
Uncalled bet ($0.15) returned to bda1b4ce
*** SHOWDOWN ***
bda1b4ce collected $0.2 from pot
*** SUMMARY ***
Total pot $0.2
Seat 1: 8b8d197c (button) folded before Flop (didn't bet)
Seat 2: Hero (small blind) folded before Flop
Seat 3: bda1b4ce (big blind) collected ($0.2)
Seat 4: d3373005 folded before Flop (didn't bet)
Seat 5: 49b3e425 folded before Flop (didn't bet)
Seat 6: edde387a folded before Flop (didn't bet)


Poker Hand #RC95093058: Hold'em No Limit ($0.1/$0.25) - 2020/04/07 15:33:44
Table 'RushAndCash365073' 6-max Seat #1 is the button
Seat 1: e814b201 ($25 in chips)
Seat 2: 4ab4e4a3 ($27.19 in chips)
Seat 3: Hero ($28.92 in chips)
Seat 4: 49b3e425 ($27.97 in chips)
Seat 5: 5794e88f ($39.53 in chips)
Seat 6: edde387a ($24.38 in chips)
4ab4e4a3: posts small blind $0.1
Hero: posts big blind $0.25
*** HOLE CARDS ***
Dealt to e814b201 
Dealt to 4ab4e4a3 
Dealt to Hero [Ks 6h]
Dealt to 49b3e425 
Dealt to 5794e88f 
Dealt to edde387a 
49b3e425: folds
5794e88f: raises $0.38 to $0.63
edde387a: raises $1.07 to $1.7
e814b201: folds
4ab4e4a3: folds
Hero: folds
5794e88f: calls $1.07
*** FLOP *** [Ts As 8h]
5794e88f: checks
edde387a: checks
*** TURN *** [Ts As 8h] [8c]
5794e88f: checks
edde387a: checks
*** RIVER *** [Ts As 8h 8c] [Jh]
5794e88f: bets $2.9
edde387a: calls $2.9
5794e88f: shows [Qd 9d] (Queens-High Straight)
edde387a: shows [Kh Kc] (Pair of Kings and Pair of Eights)
*** SHOWDOWN ***
5794e88f collected $9.55 from pot
*** SUMMARY ***
Total pot $9.55
Board [Ts As 8h 8c Jh]
Seat 1: e814b201 (button) folded before Flop (didn't bet)
Seat 2: 4ab4e4a3 (small blind) folded before Flop
Seat 3: Hero (big blind) folded before Flop
Seat 4: 49b3e425 folded before Flop (didn't bet)
Seat 5: 5794e88f showed [Qd 9d] and won ($9.55) with Queens-High Straight
Seat 6: edde387a showed [Kh Kc] and lost with Pair of Kings and Pair of Eights


Poker Hand #RC95093086: Hold'em No Limit ($0.1/$0.25) - 2020/04/07 15:33:48
Table 'RushAndCash365077' 6-max Seat #1 is the button
Seat 1: Hero ($28.67 in chips)
Seat 2: 8b8d197c ($33.9 in chips)
Seat 3: b5d592d2 ($11.96 in chips)
Seat 4: 4ab4e4a3 ($27.09 in chips)
Seat 5: 36017ad1 ($29.47 in chips)
Seat 6: 366c47e0 ($8.78 in chips)
8b8d197c: posts small blind $0.1
b5d592d2: posts big blind $0.25
*** HOLE CARDS ***
Dealt to Hero [Qs Ts]
Dealt to 8b8d197c 
Dealt to b5d592d2 
Dealt to 4ab4e4a3 
Dealt to 36017ad1 
Dealt to 366c47e0 
4ab4e4a3: folds
36017ad1: folds
366c47e0: folds
Hero: raises $0.38 to $0.63
8b8d197c: folds
b5d592d2: folds
Uncalled bet ($0.38) returned to Hero
*** SHOWDOWN ***
Hero collected $0.6 from pot
*** SUMMARY ***
Total pot $0.6
Seat 1: Hero (button) collected ($0.6)
Seat 2: 8b8d197c (small blind) folded before Flop
Seat 3: b5d592d2 (big blind) folded before Flop
Seat 4: 4ab4e4a3 folded before Flop (didn't bet)
Seat 5: 36017ad1 folded before Flop (didn't bet)
Seat 6: 366c47e0 folded before Flop (didn't bet)


Poker Hand #RC95093237: Hold'em No Limit ($0.1/$0.25) - 2020/04/07 15:34:07
Table 'RushAndCash365099' 6-max Seat #1 is the button
Seat 1: 8c86f461 ($41.53 in chips)
Seat 2: f9ba2d22 ($21.24 in chips)
Seat 3: e131407f ($30.61 in chips)
Seat 4: Hero ($29.02 in chips)
Seat 5: c535e341 ($45.55 in chips)
Seat 6: c4f78976 ($7.74 in chips)
f9ba2d22: posts small blind $0.1
e131407f: posts big blind $0.25
*** HOLE CARDS ***
Dealt to 8c86f461 
Dealt to f9ba2d22 
Dealt to e131407f 
Dealt to Hero [Ad Jc]
Dealt to c535e341 
Dealt to c4f78976 
Hero: raises $0.38 to $0.63
c535e341: folds
c4f78976: folds
8c86f461: raises $1.37 to $2
f9ba2d22: folds
e131407f: folds
Hero: calls $1.37
*** FLOP *** [Jd 6h Js]
Hero: checks
8c86f461: bets $1.5
Hero: calls $1.5
*** TURN *** [Jd 6h Js] [2s]
Hero: checks
8c86f461: bets $4.6
Hero: raises $12.5 to $17.1
8c86f461: calls $12.5
*** RIVER *** [Jd 6h Js 2s] [9s]
Hero: bets $8.42 and is all-in
8c86f461: calls $8.42
Hero: shows [Jc Ad] (Three Jacks)
8c86f461: shows [Jh Qh] (Three Jacks)
*** SHOWDOWN ***
Hero collected $58.39 from pot
*** SUMMARY ***
Total pot $58.39
Board [Jd 6h Js 2s 9s]
Seat 1: 8c86f461 (button) showed [Qh Jh] and lost with Three Jacks
Seat 2: f9ba2d22 (small blind) folded before Flop
Seat 3: e131407f (big blind) folded before Flop
Seat 4: Hero showed [Ad Jc] and won ($58.39) with Three Jacks
Seat 5: c535e341 folded before Flop (didn't bet)
Seat 6: c4f78976 folded before Flop (didn't bet)


Poker Hand #RC95093836: Hold'em No Limit ($0.1/$0.25) - 2020/04/07 15:35:30
Table 'RushAndCash365174' 6-max Seat #1 is the button
Seat 1: Hero ($57.39 in chips)
Seat 2: ab29e296 ($24.2 in chips)
Seat 3: 17388104 ($16.24 in chips)
Seat 4: c4f78976 ($6.79 in chips)
Seat 5: bb849ffc ($10.34 in chips)
Seat 6: decd88e2 ($26.24 in chips)
ab29e296: posts small blind $0.1
17388104: posts big blind $0.25
*** HOLE CARDS ***
Dealt to Hero [6s 4s]
Dealt to ab29e296 
Dealt to 17388104 
Dealt to c4f78976 
Dealt to bb849ffc 
Dealt to decd88e2 
c4f78976: folds
bb849ffc: raises $0.25 to $0.5
decd88e2: folds
Hero: calls $0.5
ab29e296: folds
17388104: raises $0.8 to $1.3
bb849ffc: raises $9.04 to $10.34 and is all-in
Hero: folds
17388104: calls $9.04
bb849ffc: shows [Jh Js]
17388104: shows [Qh Kd]
*** FIRST FLOP *** [Qd 3d Th]
*** FIRST TURN *** [Qd 3d Th] [6c]
*** FIRST RIVER *** [Qd 3d Th 6c] [5d]
*** SECOND FLOP *** [8d Ac 3c]
*** SECOND TURN *** [8d Ac 3c] [9s]
*** SECOND RIVER *** [8d Ac 3c 9s] [4c]
*** FIRST SHOWDOWN ***
17388104 collected $10.64 from pot
*** SECOND SHOWDOWN ***
bb849ffc collected $10.64 from pot
*** SUMMARY ***
Total pot $21.28
Hand was run two times
FIRST Board [Qd 3d Th 6c 5d]
SECOND Board [8d Ac 3c 9s 4c]
Seat 1: Hero (button) folded before Flop
Seat 2: ab29e296 (small blind) folded before Flop
Seat 3: 17388104 (big blind) showed [Kd Qh] and won ($10.64) with Pair of Queens, and lost with Ace-High
Seat 4: c4f78976 folded before Flop (didn't bet)
Seat 5: bb849ffc showed [Js Jh] and lost with Pair of Jacks, and won ($10.64) with Pair of Jacks
Seat 6: decd88e2 folded before Flop (didn't bet)


Poker Hand #RC95094323: Hold'em No Limit ($0.1/$0.25) - 2020/04/07 15:36:35
Table 'RushAndCash365237' 6-max Seat #1 is the button
Seat 1: 7ed3ab6b ($68.47 in chips)
Seat 2: Hero ($56.89 in chips)
Seat 3: edde387a ($21.14 in chips)
Seat 4: fe3f48f4 ($25.7 in chips)
Seat 5: 103129d8 ($27.24 in chips)
Seat 6: ecd599c ($7.8 in chips)
Hero: posts small blind $0.1
edde387a: posts big blind $0.25
*** HOLE CARDS ***
Dealt to 7ed3ab6b 
Dealt to Hero [8s 2h]
Dealt to edde387a 
Dealt to fe3f48f4 
Dealt to 103129d8 
Dealt to ecd599c 
fe3f48f4: folds
103129d8: folds
ecd599c: raises $0.25 to $0.5
7ed3ab6b: folds
Hero: folds
edde387a: folds
Uncalled bet ($0.25) returned to ecd599c
*** SHOWDOWN ***
ecd599c collected $0.6 from pot
*** SUMMARY ***
Total pot $0.6
Seat 1: 7ed3ab6b (button) folded before Flop (didn't bet)
Seat 2: Hero (small blind) folded before Flop
Seat 3: edde387a (big blind) folded before Flop
Seat 4: fe3f48f4 folded before Flop (didn't bet)
Seat 5: 103129d8 folded before Flop (didn't bet)
Seat 6: ecd599c collected ($0.6)


Poker Hand #RC95094343: Hold'em No Limit ($0.1/$0.25) - 2020/04/07 15:36:39
Table 'RushAndCash365241' 6-max Seat #1 is the button
Seat 1: 62eebc49 ($117.87 in chips)
Seat 2: d2f55a32 ($12.76 in chips)
Seat 3: 37ae2dd7 ($27.01 in chips)
Seat 4: Hero ($56.79 in chips)
Seat 5: 4c91cf91 ($8.37 in chips)
Seat 6: d3373005 ($12.43 in chips)
d2f55a32: posts small blind $0.1
37ae2dd7: posts big blind $0.25
*** HOLE CARDS ***
Dealt to 62eebc49 
Dealt to d2f55a32 
Dealt to 37ae2dd7 
Dealt to Hero [Kd 7d]
Dealt to 4c91cf91 
Dealt to d3373005 
Hero: folds
4c91cf91: folds
d3373005: folds
62eebc49: folds
d2f55a32: folds
Uncalled bet ($0.15) returned to 37ae2dd7
*** SHOWDOWN ***
37ae2dd7 collected $0.2 from pot
*** SUMMARY ***
Total pot $0.2
Seat 1: 62eebc49 (button) folded before Flop (didn't bet)
Seat 2: d2f55a32 (small blind) folded before Flop
Seat 3: 37ae2dd7 (big blind) collected ($0.2)
Seat 4: Hero folded before Flop (didn't bet)
Seat 5: 4c91cf91 folded before Flop (didn't bet)
Seat 6: d3373005 folded before Flop (didn't bet)


Poker Hand #RC95094365: Hold'em No Limit ($0.1/$0.25) - 2020/04/07 15:36:42
Table 'RushAndCash365244' 6-max Seat #1 is the button
Seat 1: dbf6981f ($64.88 in chips)
Seat 2: 3d05956 ($18.64 in chips)
Seat 3: Hero ($56.79 in chips)
Seat 4: 3cfd7308 ($49.38 in chips)
Seat 5: e1071a91 ($25.09 in chips)
Seat 6: b5d592d2 ($12.13 in chips)
3d05956: posts small blind $0.1
Hero: posts big blind $0.25
*** HOLE CARDS ***
Dealt to dbf6981f 
Dealt to 3d05956 
Dealt to Hero [3c 2s]
Dealt to 3cfd7308 
Dealt to e1071a91 
Dealt to b5d592d2 
3cfd7308: raises $0.38 to $0.63
e1071a91: raises $1.17 to $1.8
b5d592d2: folds
dbf6981f: folds
3d05956: folds
Hero: folds
3cfd7308: calls $1.17
*** FLOP *** [4s 9s 8c]
3cfd7308: checks
e1071a91: bets $2.3
3cfd7308: folds
Uncalled bet ($2.3) returned to e1071a91
*** SHOWDOWN ***
e1071a91 collected $3.95 from pot
*** SUMMARY ***
Total pot $3.95
Board [4s 9s 8c]
Seat 1: dbf6981f (button) folded before Flop (didn't bet)
Seat 2: 3d05956 (small blind) folded before Flop
Seat 3: Hero (big blind) folded before Flop
Seat 4: 3cfd7308 folded on the Flop
Seat 5: e1071a91 won ($3.95)
Seat 6: b5d592d2 folded before Flop (didn't bet)


Poker Hand #RC95094492: Hold'em No Limit ($0.1/$0.25) - 2020/04/07 15:36:59
Table 'RushAndCash365264' 6-max Seat #1 is the button
Seat 1: 704c37d9 ($46.6 in chips)
Seat 2: 32953d2a ($12.5 in chips)
Seat 3: 492c0086 ($11.65 in chips)
Seat 4: 5004602b ($10.43 in chips)
Seat 5: ecd599c ($8.15 in chips)
Seat 6: Hero ($56.54 in chips)
32953d2a: posts small blind $0.1
492c0086: posts big blind $0.25
*** HOLE CARDS ***
Dealt to 704c37d9 
Dealt to 32953d2a 
Dealt to 492c0086 
Dealt to 5004602b 
Dealt to ecd599c 
Dealt to Hero [Jc 7s]
5004602b: folds
ecd599c: raises $0.25 to $0.5
Hero: folds
704c37d9: folds
32953d2a: raises $1.75 to $2.25
492c0086: folds
ecd599c: folds
Uncalled bet ($1.75) returned to 32953d2a
*** SHOWDOWN ***
32953d2a collected $1.25 from pot
*** SUMMARY ***
Total pot $1.25
Seat 1: 704c37d9 (button) folded before Flop (didn't bet)
Seat 2: 32953d2a (small blind) collected ($1.25)
Seat 3: 492c0086 (big blind) folded before Flop
Seat 4: 5004602b folded before Flop (didn't bet)
Seat 5: ecd599c folded before Flop
Seat 6: Hero folded before Flop (didn't bet)


Poker Hand #RC95094540: Hold'em No Limit ($0.1/$0.25) - 2020/04/07 15:37:06
Table 'RushAndCash365269' 6-max Seat #1 is the button
Seat 1: be711e9d ($30.13 in chips)
Seat 2: bda1b4ce ($25 in chips)
Seat 3: ad52a579 ($12 in chips)
Seat 4: Hero ($56.54 in chips)
Seat 5: 7bf7c8c9 ($25.73 in chips)
Seat 6: 36017ad1 ($30.67 in chips)
bda1b4ce: posts small blind $0.1
ad52a579: posts big blind $0.25
*** HOLE CARDS ***
Dealt to be711e9d 
Dealt to bda1b4ce 
Dealt to ad52a579 
Dealt to Hero [3c 2s]
Dealt to 7bf7c8c9 
Dealt to 36017ad1 
Hero: folds
7bf7c8c9: folds
36017ad1: raises $0.38 to $0.63
be711e9d: folds
bda1b4ce: folds
ad52a579: folds
Uncalled bet ($0.38) returned to 36017ad1
*** SHOWDOWN ***
36017ad1 collected $0.6 from pot
*** SUMMARY ***
Total pot $0.6
Seat 1: be711e9d (button) folded before Flop (didn't bet)
Seat 2: bda1b4ce (small blind) folded before Flop
Seat 3: ad52a579 (big blind) folded before Flop
Seat 4: Hero folded before Flop (didn't bet)
Seat 5: 7bf7c8c9 folded before Flop (didn't bet)
Seat 6: 36017ad1 collected ($0.6)


Poker Hand #RC95094588: Hold'em No Limit ($0.1/$0.25) - 2020/04/07 15:37:12
Table 'RushAndCash365277' 6-max Seat #1 is the button
Seat 1: f178c62c ($12.5 in chips)
Seat 2: 89387862 ($27.44 in chips)
Seat 3: d2f55a32 ($13.01 in chips)
Seat 4: Hero ($56.54 in chips)
Seat 5: 8b8d197c ($34.09 in chips)
Seat 6: acf1a889 ($18.62 in chips)
89387862: posts small blind $0.1
d2f55a32: posts big blind $0.25
*** HOLE CARDS ***
Dealt to f178c62c 
Dealt to 89387862 
Dealt to d2f55a32 
Dealt to Hero [Kc 2d]
Dealt to 8b8d197c 
Dealt to acf1a889 
Hero: folds
8b8d197c: folds
acf1a889: folds
f178c62c: folds
89387862: folds
Uncalled bet ($0.15) returned to d2f55a32
*** SHOWDOWN ***
d2f55a32 collected $0.2 from pot
*** SUMMARY ***
Total pot $0.2
Seat 1: f178c62c (button) folded before Flop (didn't bet)
Seat 2: 89387862 (small blind) folded before Flop
Seat 3: d2f55a32 (big blind) collected ($0.2)
Seat 4: Hero folded before Flop (didn't bet)
Seat 5: 8b8d197c folded before Flop (didn't bet)
Seat 6: acf1a889 folded before Flop (didn't bet)


Poker Hand #RC95094610: Hold'em No Limit ($0.1/$0.25) - 2020/04/07 15:37:16
Table 'RushAndCash365279' 6-max Seat #1 is the button
Seat 1: bf64de7f ($9.03 in chips)
Seat 2: Hero ($56.54 in chips)
Seat 3: 5ffa3a03 ($9.27 in chips)
Seat 4: 7ed3ab6b ($68.12 in chips)
Seat 5: 704c37d9 ($46.5 in chips)
Seat 6: e814b201 ($27.57 in chips)
Hero: posts small blind $0.1
5ffa3a03: posts big blind $0.25
*** HOLE CARDS ***
Dealt to bf64de7f 
Dealt to Hero [Ts 8s]
Dealt to 5ffa3a03 
Dealt to 7ed3ab6b 
Dealt to 704c37d9 
Dealt to e814b201 
7ed3ab6b: folds
704c37d9: folds
e814b201: folds
bf64de7f: folds
Hero: raises $0.5 to $0.75
5ffa3a03: calls $0.5
*** FLOP *** [2d 7h 6c]
Hero: bets $0.5
5ffa3a03: raises $1 to $1.5
Hero: calls $1
*** TURN *** [2d 7h 6c] [Ac]
Hero: checks
5ffa3a03: bets $2.3
Hero: folds
Uncalled bet ($2.3) returned to 5ffa3a03
*** SHOWDOWN ***
5ffa3a03 collected $4.5 from pot
*** SUMMARY ***
Total pot $4.5
Board [2d 7h 6c Ac]
Seat 1: bf64de7f (button) folded before Flop (didn't bet)
Seat 2: Hero (small blind) folded on the Turn
Seat 3: 5ffa3a03 (big blind) won ($4.5)
Seat 4: 7ed3ab6b folded before Flop (didn't bet)
Seat 5: 704c37d9 folded before Flop (didn't bet)
Seat 6: e814b201 folded before Flop (didn't bet)


Poker Hand #RC95094924: Hold'em No Limit ($0.1/$0.25) - 2020/04/07 15:37:59
Table 'RushAndCash365321' 6-max Seat #1 is the button
Seat 1: Hero ($54.29 in chips)
Seat 2: d6f2a39c ($4.93 in chips)
Seat 3: caa68458 ($27.98 in chips)
Seat 4: deb69778 ($37.8 in chips)
Seat 5: ecd599c ($7.65 in chips)
Seat 6: edde387a ($22.03 in chips)
d6f2a39c: posts small blind $0.1
caa68458: posts big blind $0.25
*** HOLE CARDS ***
Dealt to Hero [Ad 7s]
Dealt to d6f2a39c 
Dealt to caa68458 
Dealt to deb69778 
Dealt to ecd599c 
Dealt to edde387a 
deb69778: folds
ecd599c: folds
edde387a: folds
Hero: folds
d6f2a39c: folds
Uncalled bet ($0.15) returned to caa68458
*** SHOWDOWN ***
caa68458 collected $0.2 from pot
*** SUMMARY ***
Total pot $0.2
Seat 1: Hero (button) folded before Flop (didn't bet)
Seat 2: d6f2a39c (small blind) folded before Flop
Seat 3: caa68458 (big blind) collected ($0.2)
Seat 4: deb69778 folded before Flop (didn't bet)
Seat 5: ecd599c folded before Flop (didn't bet)
Seat 6: edde387a folded before Flop (didn't bet)


Poker Hand #RC95094952: Hold'em No Limit ($0.1/$0.25) - 2020/04/07 15:38:03
Table 'RushAndCash365326' 6-max Seat #1 is the button
Seat 1: 62eebc49 ($117.27 in chips)
Seat 2: 17388104 ($25.18 in chips)
Seat 3: Hero ($54.29 in chips)
Seat 4: f6150235 ($18.49 in chips)
Seat 5: d2f55a32 ($13.66 in chips)
Seat 6: bbb85b3f ($26.66 in chips)
17388104: posts small blind $0.1
Hero: posts big blind $0.25
*** HOLE CARDS ***
Dealt to 62eebc49 
Dealt to 17388104 
Dealt to Hero [Tc 2c]
Dealt to f6150235 
Dealt to d2f55a32 
Dealt to bbb85b3f 
f6150235: folds
d2f55a32: folds
bbb85b3f: folds
62eebc49: folds
17388104: calls $0.15
Hero: checks
*** FLOP *** [3h 8c 9c]
17388104: checks
Hero: checks
*** TURN *** [3h 8c 9c] [Ts]
17388104: checks
Hero: checks
*** RIVER *** [3h 8c 9c Ts] [As]
17388104: bets $0.5
Hero: folds
Uncalled bet ($0.5) returned to 17388104
*** SHOWDOWN ***
17388104 collected $0.5 from pot
*** SUMMARY ***
Total pot $0.5
Board [3h 8c 9c Ts As]
Seat 1: 62eebc49 (button) folded before Flop (didn't bet)
Seat 2: 17388104 (small blind) won ($0.5)
Seat 3: Hero (big blind) folded on the River
Seat 4: f6150235 folded before Flop (didn't bet)
Seat 5: d2f55a32 folded before Flop (didn't bet)
Seat 6: bbb85b3f folded before Flop (didn't bet)


Poker Hand #RC95094987: Hold'em No Limit ($0.1/$0.25) - 2020/04/07 15:38:07
Table 'RushAndCash365330' 6-max Seat #1 is the button
Seat 1: d2986703 ($41.96 in chips)
Seat 2: 7ed3ab6b ($68.12 in chips)
Seat 3: dbf6981f ($64.18 in chips)
Seat 4: 811232a3 ($24.65 in chips)
Seat 5: f6150235 ($18.49 in chips)
Seat 6: Hero ($54.04 in chips)
7ed3ab6b: posts small blind $0.1
dbf6981f: posts big blind $0.25
*** HOLE CARDS ***
Dealt to d2986703 
Dealt to 7ed3ab6b 
Dealt to dbf6981f 
Dealt to 811232a3 
Dealt to f6150235 
Dealt to Hero [Kh 8s]
811232a3: folds
f6150235: folds
Hero: folds
d2986703: folds
7ed3ab6b: folds
Uncalled bet ($0.15) returned to dbf6981f
*** SHOWDOWN ***
dbf6981f collected $0.2 from pot
*** SUMMARY ***
Total pot $0.2
Seat 1: d2986703 (button) folded before Flop (didn't bet)
Seat 2: 7ed3ab6b (small blind) folded before Flop
Seat 3: dbf6981f (big blind) collected ($0.2)
Seat 4: 811232a3 folded before Flop (didn't bet)
Seat 5: f6150235 folded before Flop (didn't bet)
Seat 6: Hero folded before Flop (didn't bet)


Poker Hand #RC95095012: Hold'em No Limit ($0.1/$0.25) - 2020/04/07 15:38:10
Table 'RushAndCash365333' 6-max Seat #1 is the button
Seat 1: d6f2a39c ($4.83 in chips)
Seat 2: c535e341 ($45.3 in chips)
Seat 3: e131407f ($30.24 in chips)
Seat 4: Hero ($54.04 in chips)
Seat 5: 61ad32d ($20.44 in chips)
Seat 6: bbb85b3f ($26.66 in chips)
c535e341: posts small blind $0.1
e131407f: posts big blind $0.25
*** HOLE CARDS ***
Dealt to d6f2a39c 
Dealt to c535e341 
Dealt to e131407f 
Dealt to Hero [Kc 8c]
Dealt to 61ad32d 
Dealt to bbb85b3f 
Hero: raises $0.38 to $0.63
61ad32d: folds
bbb85b3f: folds
d6f2a39c: folds
c535e341: folds
e131407f: folds
Uncalled bet ($0.38) returned to Hero
*** SHOWDOWN ***
Hero collected $0.6 from pot
*** SUMMARY ***
Total pot $0.6
Seat 1: d6f2a39c (button) folded before Flop (didn't bet)
Seat 2: c535e341 (small blind) folded before Flop
Seat 3: e131407f (big blind) folded before Flop
Seat 4: Hero collected ($0.6)
Seat 5: 61ad32d folded before Flop (didn't bet)
Seat 6: bbb85b3f folded before Flop (didn't bet)


Poker Hand #RC95095183: Hold'em No Limit ($0.1/$0.25) - 2020/04/07 15:38:31
Table 'RushAndCash365354' 6-max Seat #1 is the button
Seat 1: fe3f48f4 ($25.35 in chips)
Seat 2: Hero ($54.39 in chips)
Seat 3: 5d2a310d ($12.55 in chips)
Seat 4: ce59b684 ($32.94 in chips)
Seat 5: 4c91cf91 ($7.84 in chips)
Seat 6: 40a91d41 ($26.57 in chips)
Hero: posts small blind $0.1
5d2a310d: posts big blind $0.25
*** HOLE CARDS ***
Dealt to fe3f48f4 
Dealt to Hero [Kh 8h]
Dealt to 5d2a310d 
Dealt to ce59b684 
Dealt to 4c91cf91 
Dealt to 40a91d41 
ce59b684: folds
4c91cf91: folds
40a91d41: raises $0.38 to $0.63
fe3f48f4: folds
Hero: folds
5d2a310d: folds
Uncalled bet ($0.38) returned to 40a91d41
*** SHOWDOWN ***
40a91d41 collected $0.6 from pot
*** SUMMARY ***
Total pot $0.6
Seat 1: fe3f48f4 (button) folded before Flop (didn't bet)
Seat 2: Hero (small blind) folded before Flop
Seat 3: 5d2a310d (big blind) folded before Flop
Seat 4: ce59b684 folded before Flop (didn't bet)
Seat 5: 4c91cf91 folded before Flop (didn't bet)
Seat 6: 40a91d41 collected ($0.6)


Poker Hand #RC95095286: Hold'em No Limit ($0.1/$0.25) - 2020/04/07 15:38:45
Table 'RushAndCash365366' 6-max Seat #1 is the button
Seat 1: Hero ($54.29 in chips)
Seat 2: f178c62c ($24.75 in chips)
Seat 3: 37ae2dd7 ($28.5 in chips)
Seat 4: 93bbad06 ($20.15 in chips)
Seat 5: 51c60a1c ($7.77 in chips)
Seat 6: 62eebc49 ($117.02 in chips)
f178c62c: posts small blind $0.1
37ae2dd7: posts big blind $0.25
*** HOLE CARDS ***
Dealt to Hero [Ts Th]
Dealt to f178c62c 
Dealt to 37ae2dd7 
Dealt to 93bbad06 
Dealt to 51c60a1c 
Dealt to 62eebc49 
93bbad06: raises $0.35 to $0.6
51c60a1c: folds
62eebc49: folds
Hero: raises $1.52 to $2.12
f178c62c: folds
37ae2dd7: folds
93bbad06: calls $1.52
*** FLOP *** [Kh Qc Ac]
93bbad06: checks
Hero: checks
*** TURN *** [Kh Qc Ac] [9s]
93bbad06: checks
Hero: checks
*** RIVER *** [Kh Qc Ac 9s] [As]
93bbad06: checks
Hero: bets $3.5
93bbad06: folds
Uncalled bet ($3.5) returned to Hero
*** SHOWDOWN ***
Hero collected $4.59 from pot
*** SUMMARY ***
Total pot $4.59
Board [Kh Qc Ac 9s As]
Seat 1: Hero (button) won ($4.59)
Seat 2: f178c62c (small blind) folded before Flop
Seat 3: 37ae2dd7 (big blind) folded before Flop
Seat 4: 93bbad06 folded on the River
Seat 5: 51c60a1c folded before Flop (didn't bet)
Seat 6: 62eebc49 folded before Flop (didn't bet)


Poker Hand #RC95095873: Hold'em No Limit ($0.1/$0.25) - 2020/04/07 15:40:03
Table 'RushAndCash365435' 6-max Seat #1 is the button
Seat 1: d9a04cfb ($28.7 in chips)
Seat 2: 44d6b861 ($25.57 in chips)
Seat 3: d6f2a39c ($4.3 in chips)
Seat 4: Hero ($56.53 in chips)
Seat 5: ce59b684 ($32.59 in chips)
Seat 6: 5004602b ($26.11 in chips)
44d6b861: posts small blind $0.1
d6f2a39c: posts big blind $0.25
*** HOLE CARDS ***
Dealt to d9a04cfb 
Dealt to 44d6b861 
Dealt to d6f2a39c 
Dealt to Hero [Kd 7s]
Dealt to ce59b684 
Dealt to 5004602b 
Hero: folds
ce59b684: raises $0.38 to $0.63
5004602b: folds
d9a04cfb: folds
44d6b861: folds
d6f2a39c: folds
Uncalled bet ($0.38) returned to ce59b684
*** SHOWDOWN ***
ce59b684 collected $0.6 from pot
*** SUMMARY ***
Total pot $0.6
Seat 1: d9a04cfb (button) folded before Flop (didn't bet)
Seat 2: 44d6b861 (small blind) folded before Flop
Seat 3: d6f2a39c (big blind) folded before Flop
Seat 4: Hero folded before Flop (didn't bet)
Seat 5: ce59b684 collected ($0.6)
Seat 6: 5004602b folded before Flop (didn't bet)


Poker Hand #RC95095904: Hold'em No Limit ($0.1/$0.25) - 2020/04/07 15:40:08
Table 'RushAndCash365439' 6-max Seat #1 is the button
Seat 1: deb69778 ($38.79 in chips)
Seat 2: 8c86f461 ($28.07 in chips)
Seat 3: Hero ($56.53 in chips)
Seat 4: dbf6981f ($64.03 in chips)
Seat 5: af84e661 ($5.49 in chips)
Seat 6: bf64de7f ($8.74 in chips)
8c86f461: posts small blind $0.1
Hero: posts big blind $0.25
*** HOLE CARDS ***
Dealt to deb69778 
Dealt to 8c86f461 
Dealt to Hero [Ks 8c]
Dealt to dbf6981f 
Dealt to af84e661 
Dealt to bf64de7f 
dbf6981f: folds
af84e661: folds
bf64de7f: folds
deb69778: raises $0.38 to $0.63
8c86f461: folds
Hero: folds
Uncalled bet ($0.38) returned to deb69778
*** SHOWDOWN ***
deb69778 collected $0.6 from pot
*** SUMMARY ***
Total pot $0.6
Seat 1: deb69778 (button) collected ($0.6)
Seat 2: 8c86f461 (small blind) folded before Flop
Seat 3: Hero (big blind) folded before Flop
Seat 4: dbf6981f folded before Flop (didn't bet)
Seat 5: af84e661 folded before Flop (didn't bet)
Seat 6: bf64de7f folded before Flop (didn't bet)


Poker Hand #RC95095928: Hold'em No Limit ($0.1/$0.25) - 2020/04/07 15:40:11
Table 'RushAndCash365442' 6-max Seat #1 is the button
Seat 1: 44d6b861 ($25.47 in chips)
Seat 2: bbb85b3f ($25.53 in chips)
Seat 3: bb849ffc ($11.2 in chips)
Seat 4: bdffd813 ($25 in chips)
Seat 5: 366c47e0 ($8.72 in chips)
Seat 6: Hero ($56.28 in chips)
bbb85b3f: posts small blind $0.1
bb849ffc: posts big blind $0.25
*** HOLE CARDS ***
Dealt to 44d6b861 
Dealt to bbb85b3f 
Dealt to bb849ffc 
Dealt to bdffd813 
Dealt to 366c47e0 
Dealt to Hero [9c 5h]
bdffd813: folds
366c47e0: raises $0.5 to $0.75
Hero: folds
44d6b861: folds
bbb85b3f: folds
bb849ffc: folds
Uncalled bet ($0.5) returned to 366c47e0
*** SHOWDOWN ***
366c47e0 collected $0.6 from pot
*** SUMMARY ***
Total pot $0.6
Seat 1: 44d6b861 (button) folded before Flop (didn't bet)
Seat 2: bbb85b3f (small blind) folded before Flop
Seat 3: bb849ffc (big blind) folded before Flop
Seat 4: bdffd813 folded before Flop (didn't bet)
Seat 5: 366c47e0 collected ($0.6)
Seat 6: Hero folded before Flop (didn't bet)


Poker Hand #RC95095957: Hold'em No Limit ($0.1/$0.25) - 2020/04/07 15:40:15
Table 'RushAndCash365446' 6-max Seat #1 is the button
Seat 1: Hero ($56.28 in chips)
Seat 2: bda1b4ce ($25 in chips)
Seat 3: cf91ce53 ($25.25 in chips)
Seat 4: 9f138297 ($31.57 in chips)
Seat 5: 6f1c538f ($25 in chips)
Seat 6: d437c92d ($60.65 in chips)
bda1b4ce: posts small blind $0.1
cf91ce53: posts big blind $0.25
*** HOLE CARDS ***
Dealt to Hero [Kd 3s]
Dealt to bda1b4ce 
Dealt to cf91ce53 
Dealt to 9f138297 
Dealt to 6f1c538f 
Dealt to d437c92d 
9f138297: folds
6f1c538f: folds
d437c92d: folds
Hero: folds
bda1b4ce: folds
Uncalled bet ($0.15) returned to cf91ce53
*** SHOWDOWN ***
cf91ce53 collected $0.2 from pot
*** SUMMARY ***
Total pot $0.2
Seat 1: Hero (button) folded before Flop (didn't bet)
Seat 2: bda1b4ce (small blind) folded before Flop
Seat 3: cf91ce53 (big blind) collected ($0.2)
Seat 4: 9f138297 folded before Flop (didn't bet)
Seat 5: 6f1c538f folded before Flop (didn't bet)
Seat 6: d437c92d folded before Flop (didn't bet)


Poker Hand #RC95095983: Hold'em No Limit ($0.1/$0.25) - 2020/04/07 15:40:18
Table 'RushAndCash365450' 6-max Seat #1 is the button
Seat 1: d6f2a39c ($4.05 in chips)
Seat 2: 4ab4e4a3 ($25.35 in chips)
Seat 3: 7c0ffa93 ($35.28 in chips)
Seat 4: fe3f48f4 ($27.52 in chips)
Seat 5: Hero ($56.28 in chips)
Seat 6: 3cfd7308 ($48.04 in chips)
4ab4e4a3: posts small blind $0.1
7c0ffa93: posts big blind $0.25
*** HOLE CARDS ***
Dealt to d6f2a39c 
Dealt to 4ab4e4a3 
Dealt to 7c0ffa93 
Dealt to fe3f48f4 
Dealt to Hero [Ad 5h]
Dealt to 3cfd7308 
fe3f48f4: folds
Hero: folds
3cfd7308: raises $0.38 to $0.63
d6f2a39c: folds
4ab4e4a3: folds
7c0ffa93: calls $0.38
*** FLOP *** [6c 6h 4h]
7c0ffa93: checks
3cfd7308: bets $0.5
7c0ffa93: folds
Uncalled bet ($0.5) returned to 3cfd7308
*** SHOWDOWN ***
3cfd7308 collected $1.36 from pot
*** SUMMARY ***
Total pot $1.36
Board [6c 6h 4h]
Seat 1: d6f2a39c (button) folded before Flop (didn't bet)
Seat 2: 4ab4e4a3 (small blind) folded before Flop
Seat 3: 7c0ffa93 (big blind) folded on the Flop
Seat 4: fe3f48f4 folded before Flop (didn't bet)
Seat 5: Hero folded before Flop (didn't bet)
Seat 6: 3cfd7308 won ($1.36)


Poker Hand #RC95096021: Hold'em No Limit ($0.1/$0.25) - 2020/04/07 15:40:22
Table 'RushAndCash365453' 6-max Seat #1 is the button
Seat 1: fe3f48f4 ($27.52 in chips)
Seat 2: Hero ($56.28 in chips)
Seat 3: e814b201 ($27.28 in chips)
Seat 4: 3f5f9735 ($20.93 in chips)
Seat 5: 492c0086 ($12.42 in chips)
Seat 6: 61ad32d ($19.56 in chips)
Hero: posts small blind $0.1
e814b201: posts big blind $0.25
*** HOLE CARDS ***
Dealt to fe3f48f4 
Dealt to Hero [Ac 7d]
Dealt to e814b201 
Dealt to 3f5f9735 
Dealt to 492c0086 
Dealt to 61ad32d 
3f5f9735: folds
492c0086: folds
61ad32d: folds
fe3f48f4: raises $0.38 to $0.63
Hero: folds
e814b201: folds
Uncalled bet ($0.38) returned to fe3f48f4
*** SHOWDOWN ***
fe3f48f4 collected $0.6 from pot
*** SUMMARY ***
Total pot $0.6
Seat 1: fe3f48f4 (button) collected ($0.6)
Seat 2: Hero (small blind) folded before Flop
Seat 3: e814b201 (big blind) folded before Flop
Seat 4: 3f5f9735 folded before Flop (didn't bet)
Seat 5: 492c0086 folded before Flop (didn't bet)
Seat 6: 61ad32d folded before Flop (didn't bet)


Poker Hand #RC95096049: Hold'em No Limit ($0.1/$0.25) - 2020/04/07 15:40:26
Table 'RushAndCash365456' 6-max Seat #1 is the button
Seat 1: e131407f ($29.29 in chips)
Seat 2: 8b8d197c ($33.66 in chips)
Seat 3: d2f55a32 ($12.91 in chips)
Seat 4: 181b6319 ($25.44 in chips)
Seat 5: Hero ($56.18 in chips)
Seat 6: 40a91d41 ($27.59 in chips)
8b8d197c: posts small blind $0.1
d2f55a32: posts big blind $0.25
*** HOLE CARDS ***
Dealt to e131407f 
Dealt to 8b8d197c 
Dealt to d2f55a32 
Dealt to 181b6319 
Dealt to Hero [Kd 2s]
Dealt to 40a91d41 
181b6319: folds
Hero: folds
40a91d41: raises $0.38 to $0.63
e131407f: folds
8b8d197c: folds
d2f55a32: folds
Uncalled bet ($0.38) returned to 40a91d41
*** SHOWDOWN ***
40a91d41 collected $0.6 from pot
*** SUMMARY ***
Total pot $0.6
Seat 1: e131407f (button) folded before Flop (didn't bet)
Seat 2: 8b8d197c (small blind) folded before Flop
Seat 3: d2f55a32 (big blind) folded before Flop
Seat 4: 181b6319 folded before Flop (didn't bet)
Seat 5: Hero folded before Flop (didn't bet)
Seat 6: 40a91d41 collected ($0.6)


Poker Hand #RC95096088: Hold'em No Limit ($0.1/$0.25) - 2020/04/07 15:40:31
Table 'RushAndCash365460' 6-max Seat #1 is the button
Seat 1: af84e661 ($5.49 in chips)
Seat 2: deb69778 ($39.14 in chips)
Seat 3: db97ffd8 ($12 in chips)
Seat 4: e131407f ($29.29 in chips)
Seat 5: Hero ($56.18 in chips)
Seat 6: 93bbad06 ($18.03 in chips)
deb69778: posts small blind $0.1
db97ffd8: posts big blind $0.25
*** HOLE CARDS ***
Dealt to af84e661 
Dealt to deb69778 
Dealt to db97ffd8 
Dealt to e131407f 
Dealt to Hero [9d 8h]
Dealt to 93bbad06 
e131407f: folds
Hero: folds
93bbad06: folds
af84e661: folds
deb69778: raises $0.5 to $0.75
db97ffd8: folds
Uncalled bet ($0.5) returned to deb69778
*** SHOWDOWN ***
deb69778 collected $0.5 from pot
*** SUMMARY ***
Total pot $0.5
Seat 1: af84e661 (button) folded before Flop (didn't bet)
Seat 2: deb69778 (small blind) collected ($0.5)
Seat 3: db97ffd8 (big blind) folded before Flop
Seat 4: e131407f folded before Flop (didn't bet)
Seat 5: Hero folded before Flop (didn't bet)
Seat 6: 93bbad06 folded before Flop (didn't bet)


Poker Hand #RC95096116: Hold'em No Limit ($0.1/$0.25) - 2020/04/07 15:40:35
Table 'RushAndCash365463' 6-max Seat #1 is the button
Seat 1: d2f55a32 ($12.66 in chips)
Seat 2: 2dd038c3 ($10.12 in chips)
Seat 3: ac90cf4e ($12 in chips)
Seat 4: acf1a889 ($19.14 in chips)
Seat 5: 57ff778 ($28 in chips)
Seat 6: Hero ($56.18 in chips)
2dd038c3: posts small blind $0.1
ac90cf4e: posts big blind $0.25
*** HOLE CARDS ***
Dealt to d2f55a32 
Dealt to 2dd038c3 
Dealt to ac90cf4e 
Dealt to acf1a889 
Dealt to 57ff778 
Dealt to Hero [Td 7s]
acf1a889: raises $0.38 to $0.63
57ff778: folds
Hero: folds
d2f55a32: folds
2dd038c3: folds
ac90cf4e: folds
Uncalled bet ($0.38) returned to acf1a889
*** SHOWDOWN ***
acf1a889 collected $0.6 from pot
*** SUMMARY ***
Total pot $0.6
Seat 1: d2f55a32 (button) folded before Flop (didn't bet)
Seat 2: 2dd038c3 (small blind) folded before Flop
Seat 3: ac90cf4e (big blind) folded before Flop
Seat 4: acf1a889 collected ($0.6)
Seat 5: 57ff778 folded before Flop (didn't bet)
Seat 6: Hero folded before Flop (didn't bet)


Poker Hand #RC95096147: Hold'em No Limit ($0.1/$0.25) - 2020/04/07 15:40:39
Table 'RushAndCash365468' 6-max Seat #1 is the button
Seat 1: 3d05956 ($41.49 in chips)
Seat 2: 32953d2a ($13.61 in chips)
Seat 3: Hero ($56.18 in chips)
Seat 4: 103129d8 ($25.04 in chips)
Seat 5: 89387862 ($29.91 in chips)
Seat 6: 492c0086 ($12.42 in chips)
32953d2a: posts small blind $0.1
Hero: posts big blind $0.25
*** HOLE CARDS ***
Dealt to 3d05956 
Dealt to 32953d2a 
Dealt to Hero [9s 6c]
Dealt to 103129d8 
Dealt to 89387862 
Dealt to 492c0086 
103129d8: folds
89387862: folds
492c0086: folds
3d05956: folds
32953d2a: folds
Uncalled bet ($0.15) returned to Hero
*** SHOWDOWN ***
Hero collected $0.2 from pot
*** SUMMARY ***
Total pot $0.2
Seat 1: 3d05956 (button) folded before Flop (didn't bet)
Seat 2: 32953d2a (small blind) folded before Flop
Seat 3: Hero (big blind) collected ($0.2)
Seat 4: 103129d8 folded before Flop (didn't bet)
Seat 5: 89387862 folded before Flop (didn't bet)
Seat 6: 492c0086 folded before Flop (didn't bet)


Poker Hand #RC95096176: Hold'em No Limit ($0.1/$0.25) - 2020/04/07 15:40:42
Table 'RushAndCash365471' 6-max Seat #1 is the button
Seat 1: cf91ce53 ($25.25 in chips)
Seat 2: 51c60a1c ($5.44 in chips)
Seat 3: af84e661 ($5.49 in chips)
Seat 4: 3fe95a27 ($14.08 in chips)
Seat 5: Hero ($55.93 in chips)
Seat 6: a4ba858f ($39.12 in chips)
51c60a1c: posts small blind $0.1
af84e661: posts big blind $0.25
*** HOLE CARDS ***
Dealt to cf91ce53 
Dealt to 51c60a1c 
Dealt to af84e661 
Dealt to 3fe95a27 
Dealt to Hero [8h 5h]
Dealt to a4ba858f 
3fe95a27: folds
Hero: folds
a4ba858f: folds
cf91ce53: folds
51c60a1c: folds
Uncalled bet ($0.15) returned to af84e661
*** SHOWDOWN ***
af84e661 collected $0.2 from pot
*** SUMMARY ***
Total pot $0.2
Seat 1: cf91ce53 (button) folded before Flop (didn't bet)
Seat 2: 51c60a1c (small blind) folded before Flop
Seat 3: af84e661 (big blind) collected ($0.2)
Seat 4: 3fe95a27 folded before Flop (didn't bet)
Seat 5: Hero folded before Flop (didn't bet)
Seat 6: a4ba858f folded before Flop (didn't bet)


Poker Hand #RC95096206: Hold'em No Limit ($0.1/$0.25) - 2020/04/07 15:40:46
Table 'RushAndCash365475' 6-max Seat #1 is the button
Seat 1: a0d04110 ($78.65 in chips)
Seat 2: af84e661 ($5.24 in chips)
Seat 3: 89387862 ($29.91 in chips)
Seat 4: 181b6319 ($25.44 in chips)
Seat 5: 61ad32d ($19.46 in chips)
Seat 6: Hero ($55.93 in chips)
af84e661: posts small blind $0.1
89387862: posts big blind $0.25
*** HOLE CARDS ***
Dealt to a0d04110 
Dealt to af84e661 
Dealt to 89387862 
Dealt to 181b6319 
Dealt to 61ad32d 
Dealt to Hero [Qs 4d]
181b6319: folds
61ad32d: folds
Hero: folds
a0d04110: folds
af84e661: raises $0.38 to $0.63
89387862: calls $0.38
*** FLOP *** [Ad Kd Th]
af84e661: checks
89387862: checks
*** TURN *** [Ad Kd Th] [Ac]
af84e661: bets $1
89387862: folds
Uncalled bet ($1) returned to af84e661
*** SHOWDOWN ***
af84e661 collected $1.26 from pot
*** SUMMARY ***
Total pot $1.26
Board [Ad Kd Th Ac]
Seat 1: a0d04110 (button) folded before Flop (didn't bet)
Seat 2: af84e661 (small blind) won ($1.26)
Seat 3: 89387862 (big blind) folded on the Turn
Seat 4: 181b6319 folded before Flop (didn't bet)
Seat 5: 61ad32d folded before Flop (didn't bet)
Seat 6: Hero folded before Flop (didn't bet)


Poker Hand #RC95096234: Hold'em No Limit ($0.1/$0.25) - 2020/04/07 15:40:49
Table 'RushAndCash365480' 6-max Seat #1 is the button
Seat 1: a4ba858f ($39.12 in chips)
Seat 2: Hero ($55.93 in chips)
Seat 3: b56c4622 ($12 in chips)
Seat 4: 7bf7c8c9 ($25 in chips)
Seat 5: cb3a82b2 ($11.65 in chips)
Seat 6: ecd599c ($6.6 in chips)
Hero: posts small blind $0.1
b56c4622: posts big blind $0.25
*** HOLE CARDS ***
Dealt to a4ba858f 
Dealt to Hero [8c 7s]
Dealt to b56c4622 
Dealt to 7bf7c8c9 
Dealt to cb3a82b2 
Dealt to ecd599c 
7bf7c8c9: folds
cb3a82b2: folds
ecd599c: raises $0.25 to $0.5
a4ba858f: folds
Hero: folds
b56c4622: folds
Uncalled bet ($0.25) returned to ecd599c
*** SHOWDOWN ***
ecd599c collected $0.6 from pot
*** SUMMARY ***
Total pot $0.6
Seat 1: a4ba858f (button) folded before Flop (didn't bet)
Seat 2: Hero (small blind) folded before Flop
Seat 3: b56c4622 (big blind) folded before Flop
Seat 4: 7bf7c8c9 folded before Flop (didn't bet)
Seat 5: cb3a82b2 folded before Flop (didn't bet)
Seat 6: ecd599c collected ($0.6)


Poker Hand #RC95096263: Hold'em No Limit ($0.1/$0.25) - 2020/04/07 15:40:53
Table 'RushAndCash365484' 6-max Seat #1 is the button
Seat 1: e814b201 ($27.13 in chips)
Seat 2: 30cab83a ($28.48 in chips)
Seat 3: Hero ($56.18 in chips)
Seat 4: 32953d2a ($13.51 in chips)
Seat 5: 8c86f461 ($28.07 in chips)
Seat 6: 2dd038c3 ($10.02 in chips)
30cab83a: posts small blind $0.1
Hero: posts big blind $0.25
*** HOLE CARDS ***
Dealt to e814b201 
Dealt to 30cab83a 
Dealt to Hero [8h 4d]
Dealt to 32953d2a 
Dealt to 8c86f461 
Dealt to 2dd038c3 
32953d2a: folds
8c86f461: folds
2dd038c3: raises $0.38 to $0.63
e814b201: folds
30cab83a: calls $0.53
Hero: folds
*** FLOP *** [3s 2c 4c]
30cab83a: checks
2dd038c3: bets $0.5
30cab83a: calls $0.5
*** TURN *** [3s 2c 4c] [7c]
30cab83a: bets $0.9
2dd038c3: folds
Uncalled bet ($0.9) returned to 30cab83a
*** SHOWDOWN ***
30cab83a collected $2.51 from pot
*** SUMMARY ***
Total pot $2.51
Board [3s 2c 4c 7c]
Seat 1: e814b201 (button) folded before Flop (didn't bet)
Seat 2: 30cab83a (small blind) won ($2.51)
Seat 3: Hero (big blind) folded before Flop
Seat 4: 32953d2a folded before Flop (didn't bet)
Seat 5: 8c86f461 folded before Flop (didn't bet)
Seat 6: 2dd038c3 folded on the Turn


Poker Hand #RC95096287: Hold'em No Limit ($0.1/$0.25) - 2020/04/07 15:40:57
Table 'RushAndCash365488' 6-max Seat #1 is the button
Seat 1: db97ffd8 ($11.65 in chips)
Seat 2: 6f1c538f ($24.75 in chips)
Seat 3: 7c935d24 ($25.25 in chips)
Seat 4: Hero ($55.93 in chips)
Seat 5: 8c86f461 ($28.07 in chips)
Seat 6: bf64de7f ($8.74 in chips)
6f1c538f: posts small blind $0.1
7c935d24: posts big blind $0.25
*** HOLE CARDS ***
Dealt to db97ffd8 
Dealt to 6f1c538f 
Dealt to 7c935d24 
Dealt to Hero [Kd 7h]
Dealt to 8c86f461 
Dealt to bf64de7f 
Hero: folds
8c86f461: raises $0.38 to $0.63
bf64de7f: folds
db97ffd8: folds
6f1c538f: folds
7c935d24: calls $0.38
*** FLOP *** [8s 3h 4h]
7c935d24: checks
8c86f461: bets $0.7
7c935d24: calls $0.7
*** TURN *** [8s 3h 4h] [8c]
7c935d24: checks
8c86f461: bets $1.4
7c935d24: calls $1.4
*** RIVER *** [8s 3h 4h 8c] [4c]
7c935d24: checks
8c86f461: checks
7c935d24: shows [6d 6s] (Pair of Eights and Pair of Sixes)
8c86f461: shows [9s 9d] (Pair of Nines and Pair of Eights)
*** SHOWDOWN ***
8c86f461 collected $5.56 from pot
*** SUMMARY ***
Total pot $5.56
Board [8s 3h 4h 8c 4c]
Seat 1: db97ffd8 (button) folded before Flop (didn't bet)
Seat 2: 6f1c538f (small blind) folded before Flop
Seat 3: 7c935d24 (big blind) showed [6s 6d] and lost with Pair of Eights and Pair of Sixes
Seat 4: Hero folded before Flop (didn't bet)
Seat 5: 8c86f461 showed [9s 9d] and won ($5.56) with Pair of Nines and Pair of Eights
Seat 6: bf64de7f folded before Flop (didn't bet)


Poker Hand #RC95096308: Hold'em No Limit ($0.1/$0.25) - 2020/04/07 15:41:00
Table 'RushAndCash365492' 6-max Seat #1 is the button
Seat 1: Hero ($55.93 in chips)
Seat 2: 366c47e0 ($9.42 in chips)
Seat 3: 74937d40 ($36.57 in chips)
Seat 4: bda1b4ce ($25 in chips)
Seat 5: 51c60a1c ($5.09 in chips)
Seat 6: e131407f ($29.64 in chips)
366c47e0: posts small blind $0.1
74937d40: posts big blind $0.25
*** HOLE CARDS ***
Dealt to Hero [7s 3s]
Dealt to 366c47e0 
Dealt to 74937d40 
Dealt to bda1b4ce 
Dealt to 51c60a1c 
Dealt to e131407f 
bda1b4ce: folds
51c60a1c: folds
e131407f: folds
Hero: folds
366c47e0: folds
Uncalled bet ($0.15) returned to 74937d40
*** SHOWDOWN ***
74937d40 collected $0.2 from pot
*** SUMMARY ***
Total pot $0.2
Seat 1: Hero (button) folded before Flop (didn't bet)
Seat 2: 366c47e0 (small blind) folded before Flop
Seat 3: 74937d40 (big blind) collected ($0.2)
Seat 4: bda1b4ce folded before Flop (didn't bet)
Seat 5: 51c60a1c folded before Flop (didn't bet)
Seat 6: e131407f folded before Flop (didn't bet)


Poker Hand #RC95096341: Hold'em No Limit ($0.1/$0.25) - 2020/04/07 15:41:04
Table 'RushAndCash365497' 6-max Seat #1 is the button
Seat 1: 45920dbc ($47.65 in chips)
Seat 2: bdffd813 ($25 in chips)
Seat 3: f178c62c ($25 in chips)
Seat 4: 103129d8 ($24.94 in chips)
Seat 5: Hero ($55.93 in chips)
Seat 6: a4ba858f ($39.12 in chips)
bdffd813: posts small blind $0.1
f178c62c: posts big blind $0.25
*** HOLE CARDS ***
Dealt to 45920dbc 
Dealt to bdffd813 
Dealt to f178c62c 
Dealt to 103129d8 
Dealt to Hero [Kd 3s]
Dealt to a4ba858f 
103129d8: folds
Hero: folds
a4ba858f: folds
45920dbc: folds
bdffd813: folds
Uncalled bet ($0.15) returned to f178c62c
*** SHOWDOWN ***
f178c62c collected $0.2 from pot
*** SUMMARY ***
Total pot $0.2
Seat 1: 45920dbc (button) folded before Flop (didn't bet)
Seat 2: bdffd813 (small blind) folded before Flop
Seat 3: f178c62c (big blind) collected ($0.2)
Seat 4: 103129d8 folded before Flop (didn't bet)
Seat 5: Hero folded before Flop (didn't bet)
Seat 6: a4ba858f folded before Flop (didn't bet)


Poker Hand #RC95096361: Hold'em No Limit ($0.1/$0.25) - 2020/04/07 15:41:08
Table 'RushAndCash365500' 6-max Seat #1 is the button
Seat 1: 51c60a1c ($5.09 in chips)
Seat 2: 7c0ffa93 ($34.65 in chips)
Seat 3: dbf6981f ($63.3 in chips)
Seat 4: 2c82afb5 ($12 in chips)
Seat 5: bc3db224 ($24.5 in chips)
Seat 6: Hero ($55.93 in chips)
7c0ffa93: posts small blind $0.1
dbf6981f: posts big blind $0.25
*** HOLE CARDS ***
Dealt to 51c60a1c 
Dealt to 7c0ffa93 
Dealt to dbf6981f 
Dealt to 2c82afb5 
Dealt to bc3db224 
Dealt to Hero [9d 8c]
2c82afb5: folds
bc3db224: folds
Hero: folds
51c60a1c: folds
7c0ffa93: raises $0.5 to $0.75
dbf6981f: folds
Uncalled bet ($0.5) returned to 7c0ffa93
*** SHOWDOWN ***
7c0ffa93 collected $0.5 from pot
*** SUMMARY ***
Total pot $0.5
Seat 1: 51c60a1c (button) folded before Flop (didn't bet)
Seat 2: 7c0ffa93 (small blind) collected ($0.5)
Seat 3: dbf6981f (big blind) folded before Flop
Seat 4: 2c82afb5 folded before Flop (didn't bet)
Seat 5: bc3db224 folded before Flop (didn't bet)
Seat 6: Hero folded before Flop (didn't bet)


Poker Hand #RC95096391: Hold'em No Limit ($0.1/$0.25) - 2020/04/07 15:41:11
Table 'RushAndCash365506' 6-max Seat #1 is the button
Seat 1: f178c62c ($24.75 in chips)
Seat 2: bb849ffc ($10.45 in chips)
Seat 3: Hero ($55.93 in chips)
Seat 4: 93bbad06 ($17.3 in chips)
Seat 5: 9c76a6c2 ($25 in chips)
Seat 6: b5d592d2 ($11.96 in chips)
bb849ffc: posts small blind $0.1
Hero: posts big blind $0.25
*** HOLE CARDS ***
Dealt to f178c62c 
Dealt to bb849ffc 
Dealt to Hero [Kc 4h]
Dealt to 93bbad06 
Dealt to 9c76a6c2 
Dealt to b5d592d2 
93bbad06: folds
9c76a6c2: folds
b5d592d2: raises $0.38 to $0.63
f178c62c: folds
bb849ffc: folds
Hero: folds
Uncalled bet ($0.38) returned to b5d592d2
*** SHOWDOWN ***
b5d592d2 collected $0.6 from pot
*** SUMMARY ***
Total pot $0.6
Seat 1: f178c62c (button) folded before Flop (didn't bet)
Seat 2: bb849ffc (small blind) folded before Flop
Seat 3: Hero (big blind) folded before Flop
Seat 4: 93bbad06 folded before Flop (didn't bet)
Seat 5: 9c76a6c2 folded before Flop (didn't bet)
Seat 6: b5d592d2 collected ($0.6)


Poker Hand #RC95096426: Hold'em No Limit ($0.1/$0.25) - 2020/04/07 15:41:16
Table 'RushAndCash365512' 6-max Seat #1 is the button
Seat 1: 3d05956 ($40.74 in chips)
Seat 2: Hero ($55.68 in chips)
Seat 3: 22be9faa ($12 in chips)
Seat 4: 3fe95a27 ($13.73 in chips)
Seat 5: d9a04cfb ($33.1 in chips)
Seat 6: bb849ffc ($10.35 in chips)
Hero: posts small blind $0.1
22be9faa: posts big blind $0.25
*** HOLE CARDS ***
Dealt to 3d05956 
Dealt to Hero [Kc Tc]
Dealt to 22be9faa 
Dealt to 3fe95a27 
Dealt to d9a04cfb 
Dealt to bb849ffc 
3fe95a27: folds
d9a04cfb: folds
bb849ffc: folds
3d05956: raises $0.5 to $0.75
Hero: calls $0.65
22be9faa: calls $0.5
*** FLOP *** [Ks 8s 2d]
Hero: checks
22be9faa: checks
3d05956: checks
*** TURN *** [Ks 8s 2d] [2c]
Hero: bets $1.7
22be9faa: folds
3d05956: calls $1.7
*** RIVER *** [Ks 8s 2d 2c] [3s]
Hero: checks
3d05956: checks
Hero: shows [Tc Kc] (Pair of Kings and Pair of Twos)
3d05956: shows [4h 4d] (Pair of Fours and Pair of Twos)
*** SHOWDOWN ***
Hero collected $5.65 from pot
*** SUMMARY ***
Total pot $5.65
Board [Ks 8s 2d 2c 3s]
Seat 1: 3d05956 (button) showed [4h 4d] and lost with Pair of Fours and Pair of Twos
Seat 2: Hero (small blind) showed [Kc Tc] and won ($5.65) with Pair of Kings and Pair of Twos
Seat 3: 22be9faa (big blind) folded on the Turn
Seat 4: 3fe95a27 folded before Flop (didn't bet)
Seat 5: d9a04cfb folded before Flop (didn't bet)
Seat 6: bb849ffc folded before Flop (didn't bet)


Poker Hand #RC95096777: Hold'em No Limit ($0.1/$0.25) - 2020/04/07 15:42:04
Table 'RushAndCash365553' 6-max Seat #1 is the button
Seat 1: Hero ($58.6 in chips)
Seat 2: fe3f48f4 ($25.42 in chips)
Seat 3: 3d05956 ($38.29 in chips)
Seat 4: d2986703 ($40.97 in chips)
Seat 5: fc8a29ea ($58.35 in chips)
Seat 6: 4ab4e4a3 ($26.25 in chips)
fe3f48f4: posts small blind $0.1
3d05956: posts big blind $0.25
*** HOLE CARDS ***
Dealt to Hero [As Jh]
Dealt to fe3f48f4 
Dealt to 3d05956 
Dealt to d2986703 
Dealt to fc8a29ea 
Dealt to 4ab4e4a3 
d2986703: folds
fc8a29ea: raises $0.38 to $0.63
4ab4e4a3: folds
Hero: calls $0.63
fe3f48f4: folds
3d05956: raises $1.87 to $2.5
fc8a29ea: folds
Hero: calls $1.87
*** FLOP *** [Td 3h 8h]
3d05956: bets $1.9
Hero: folds
Uncalled bet ($1.9) returned to 3d05956
*** SHOWDOWN ***
3d05956 collected $5.73 from pot
*** SUMMARY ***
Total pot $5.73
Board [Td 3h 8h]
Seat 1: Hero (button) folded on the Flop
Seat 2: fe3f48f4 (small blind) folded before Flop
Seat 3: 3d05956 (big blind) won ($5.73)
Seat 4: d2986703 folded before Flop (didn't bet)
Seat 5: fc8a29ea folded before Flop
Seat 6: 4ab4e4a3 folded before Flop (didn't bet)


Poker Hand #RC95097168: Hold'em No Limit ($0.1/$0.25) - 2020/04/07 15:42:51
Table 'RushAndCash365606' 6-max Seat #1 is the button
Seat 1: ecd599c ($6.78 in chips)
Seat 2: a4ba858f ($38.47 in chips)
Seat 3: 52ee6b3d ($31.25 in chips)
Seat 4: d6f2a39c ($5.03 in chips)
Seat 5: Hero ($56.1 in chips)
Seat 6: adb51d54 ($25.68 in chips)
a4ba858f: posts small blind $0.1
52ee6b3d: posts big blind $0.25
*** HOLE CARDS ***
Dealt to ecd599c 
Dealt to a4ba858f 
Dealt to 52ee6b3d 
Dealt to d6f2a39c 
Dealt to Hero [8h 8d]
Dealt to adb51d54 
d6f2a39c: folds
Hero: raises $0.38 to $0.63
adb51d54: calls $0.63
ecd599c: raises $6.15 to $6.78 and is all-in
a4ba858f: folds
52ee6b3d: folds
Hero: folds
adb51d54: calls $6.15
ecd599c: shows [3d Ad]
adb51d54: shows [3c 3s]
*** FIRST FLOP *** [Td Ts Qs]
*** FIRST TURN *** [Td Ts Qs] [Kd]
*** FIRST RIVER *** [Td Ts Qs Kd] [8c]
*** SECOND FLOP *** [5s 7s Ac]
*** SECOND TURN *** [5s 7s Ac] [9s]
*** SECOND RIVER *** [5s 7s Ac 9s] [4s]
*** THIRD FLOP *** [Jc Js Kc]
*** THIRD TURN *** [Jc Js Kc] [6s]
*** THIRD RIVER *** [Jc Js Kc 6s] [7d]
*** FIRST SHOWDOWN ***
adb51d54 collected $4.84 from pot
*** SECOND SHOWDOWN ***
adb51d54 collected $4.84 from pot
*** THIRD SHOWDOWN ***
adb51d54 collected $4.84 from pot
*** SUMMARY ***
Total pot $14.54
Hand was run three times
FIRST Board [Td Ts Qs Kd 8c]
SECOND Board [5s 7s Ac 9s 4s]
THIRD Board [Jc Js Kc 6s 7d]
Seat 1: ecd599c (button) showed [Ad 3d] and lost with Pair of Tens, and lost with Pair of Aces, and lost with Pair of Jacks
Seat 2: a4ba858f (small blind) folded before Flop
Seat 3: 52ee6b3d (big blind) folded before Flop
Seat 4: d6f2a39c folded before Flop (didn't bet)
Seat 5: Hero folded before Flop
Seat 6: adb51d54 showed [3s 3c] and won ($4.84) with Pair of Tens and Pair of Treys, and won ($4.84) with Nine High Flush, and won ($4.84) with Pair of Jacks and Pair of Treys


Poker Hand #RC95097597: Hold'em No Limit ($0.1/$0.25) - 2020/04/07 15:43:49
Table 'RushAndCash365662' 6-max Seat #1 is the button
Seat 1: bf64de7f ($8.59 in chips)
Seat 2: bad0409c ($12.5 in chips)
Seat 3: adb51d54 ($32.47 in chips)
Seat 4: 2dd038c3 ($9.11 in chips)
Seat 5: e131407f ($29.97 in chips)
Seat 6: Hero ($55.47 in chips)
bad0409c: posts small blind $0.1
adb51d54: posts big blind $0.25
*** HOLE CARDS ***
Dealt to bf64de7f 
Dealt to bad0409c 
Dealt to adb51d54 
Dealt to 2dd038c3 
Dealt to e131407f 
Dealt to Hero [Ks Qs]
2dd038c3: folds
e131407f: folds
Hero: raises $0.38 to $0.63
bf64de7f: folds
bad0409c: folds
adb51d54: folds
Uncalled bet ($0.38) returned to Hero
*** SHOWDOWN ***
Hero collected $0.6 from pot
*** SUMMARY ***
Total pot $0.6
Seat 1: bf64de7f (button) folded before Flop (didn't bet)
Seat 2: bad0409c (small blind) folded before Flop
Seat 3: adb51d54 (big blind) folded before Flop
Seat 4: 2dd038c3 folded before Flop (didn't bet)
Seat 5: e131407f folded before Flop (didn't bet)
Seat 6: Hero collected ($0.6)


Poker Hand #RC95097728: Hold'em No Limit ($0.1/$0.25) - 2020/04/07 15:44:06
Table 'RushAndCash365680' 6-max Seat #1 is the button
Seat 1: Hero ($55.82 in chips)
Seat 2: bdffd813 ($26.17 in chips)
Seat 3: dc1d83ec ($25.67 in chips)
Seat 4: d2986703 ($40.62 in chips)
Seat 5: 3cfd7308 ($49.63 in chips)
Seat 6: bbb85b3f ($25.53 in chips)
bdffd813: posts small blind $0.1
dc1d83ec: posts big blind $0.25
*** HOLE CARDS ***
Dealt to Hero [5s 2d]
Dealt to bdffd813 
Dealt to dc1d83ec 
Dealt to d2986703 
Dealt to 3cfd7308 
Dealt to bbb85b3f 
d2986703: folds
3cfd7308: folds
bbb85b3f: folds
Hero: folds
bdffd813: folds
Uncalled bet ($0.15) returned to dc1d83ec
*** SHOWDOWN ***
dc1d83ec collected $0.2 from pot
*** SUMMARY ***
Total pot $0.2
Seat 1: Hero (button) folded before Flop (didn't bet)
Seat 2: bdffd813 (small blind) folded before Flop
Seat 3: dc1d83ec (big blind) collected ($0.2)
Seat 4: d2986703 folded before Flop (didn't bet)
Seat 5: 3cfd7308 folded before Flop (didn't bet)
Seat 6: bbb85b3f folded before Flop (didn't bet)


Poker Hand #RC95097760: Hold'em No Limit ($0.1/$0.25) - 2020/04/07 15:44:10
Table 'RushAndCash365685' 6-max Seat #1 is the button
Seat 1: 74937d40 ($37.43 in chips)
Seat 2: fb4a5e69 ($25 in chips)
Seat 3: d2986703 ($40.62 in chips)
Seat 4: bf64de7f ($8.24 in chips)
Seat 5: Hero ($55.82 in chips)
Seat 6: d07b3de1 ($31.68 in chips)
fb4a5e69: posts small blind $0.1
d2986703: posts big blind $0.25
*** HOLE CARDS ***
Dealt to 74937d40 
Dealt to fb4a5e69 
Dealt to d2986703 
Dealt to bf64de7f 
Dealt to Hero [Kc 2c]
Dealt to d07b3de1 
bf64de7f: folds
Hero: folds
d07b3de1: raises $0.25 to $0.5
74937d40: folds
fb4a5e69: folds
d2986703: folds
Uncalled bet ($0.25) returned to d07b3de1
*** SHOWDOWN ***
d07b3de1 collected $0.6 from pot
*** SUMMARY ***
Total pot $0.6
Seat 1: 74937d40 (button) folded before Flop (didn't bet)
Seat 2: fb4a5e69 (small blind) folded before Flop
Seat 3: d2986703 (big blind) folded before Flop
Seat 4: bf64de7f folded before Flop (didn't bet)
Seat 5: Hero folded before Flop (didn't bet)
Seat 6: d07b3de1 collected ($0.6)


Poker Hand #RC95097849: Hold'em No Limit ($0.1/$0.25) - 2020/04/07 15:44:21
Table 'RushAndCash365699' 6-max Seat #1 is the button
Seat 1: adb51d54 ($32.12 in chips)
Seat 2: Hero ($55.82 in chips)
Seat 3: d2f55a32 ($13.11 in chips)
Seat 4: bad0409c ($12.5 in chips)
Seat 5: 1cf2736e ($25 in chips)
Seat 6: b56c4622 ($19.5 in chips)
Hero: posts small blind $0.1
d2f55a32: posts big blind $0.25
*** HOLE CARDS ***
Dealt to adb51d54 
Dealt to Hero [5s 2h]
Dealt to d2f55a32 
Dealt to bad0409c 
Dealt to 1cf2736e 
Dealt to b56c4622 
bad0409c: folds
1cf2736e: folds
b56c4622: folds
adb51d54: folds
Hero: folds
Uncalled bet ($0.15) returned to d2f55a32
*** SHOWDOWN ***
d2f55a32 collected $0.2 from pot
*** SUMMARY ***
Total pot $0.2
Seat 1: adb51d54 (button) folded before Flop (didn't bet)
Seat 2: Hero (small blind) folded before Flop
Seat 3: d2f55a32 (big blind) collected ($0.2)
Seat 4: bad0409c folded before Flop (didn't bet)
Seat 5: 1cf2736e folded before Flop (didn't bet)
Seat 6: b56c4622 folded before Flop (didn't bet)


Poker Hand #RC95097913: Hold'em No Limit ($0.1/$0.25) - 2020/04/07 15:44:28
Table 'RushAndCash365708' 6-max Seat #1 is the button
Seat 1: 62eebc49 ($120.87 in chips)
Seat 2: 36017ad1 ($36.66 in chips)
Seat 3: adb51d54 ($32.12 in chips)
Seat 4: 9c76a6c2 ($27.79 in chips)
Seat 5: 6bf543f8 ($25 in chips)
Seat 6: Hero ($55.72 in chips)
36017ad1: posts small blind $0.1
adb51d54: posts big blind $0.25
*** HOLE CARDS ***
Dealt to 62eebc49 
Dealt to 36017ad1 
Dealt to adb51d54 
Dealt to 9c76a6c2 
Dealt to 6bf543f8 
Dealt to Hero [8s 4s]
9c76a6c2: folds
6bf543f8: folds
Hero: folds
62eebc49: folds
36017ad1: raises $0.5 to $0.75
adb51d54: raises $2.05 to $2.8
36017ad1: raises $5.55 to $8.35
adb51d54: calls $5.55
*** FLOP *** [Qc 7d 4d]
36017ad1: bets $5
adb51d54: folds
Uncalled bet ($5) returned to 36017ad1
*** SHOWDOWN ***
36017ad1 collected $16.7 from pot
*** SUMMARY ***
Total pot $16.7
Board [Qc 7d 4d]
Seat 1: 62eebc49 (button) folded before Flop (didn't bet)
Seat 2: 36017ad1 (small blind) won ($16.7)
Seat 3: adb51d54 (big blind) folded on the Flop
Seat 4: 9c76a6c2 folded before Flop (didn't bet)
Seat 5: 6bf543f8 folded before Flop (didn't bet)
Seat 6: Hero folded before Flop (didn't bet)


Poker Hand #RC95097939: Hold'em No Limit ($0.1/$0.25) - 2020/04/07 15:44:31
Table 'RushAndCash365713' 6-max Seat #1 is the button
Seat 1: bbb85b3f ($25.43 in chips)
Seat 2: 6f1c538f ($24.32 in chips)
Seat 3: 5d2a310d ($2.47 in chips)
Seat 4: Hero ($55.72 in chips)
Seat 5: dbf6981f ($65 in chips)
Seat 6: 3f5f9735 ($19.4 in chips)
6f1c538f: posts small blind $0.1
5d2a310d: posts big blind $0.25
*** HOLE CARDS ***
Dealt to bbb85b3f 
Dealt to 6f1c538f 
Dealt to 5d2a310d 
Dealt to Hero [Kc 6s]
Dealt to dbf6981f 
Dealt to 3f5f9735 
Hero: folds
dbf6981f: folds
3f5f9735: raises $0.5 to $0.75
bbb85b3f: folds
6f1c538f: folds
5d2a310d: folds
Uncalled bet ($0.5) returned to 3f5f9735
*** SHOWDOWN ***
3f5f9735 collected $0.6 from pot
*** SUMMARY ***
Total pot $0.6
Seat 1: bbb85b3f (button) folded before Flop (didn't bet)
Seat 2: 6f1c538f (small blind) folded before Flop
Seat 3: 5d2a310d (big blind) folded before Flop
Seat 4: Hero folded before Flop (didn't bet)
Seat 5: dbf6981f folded before Flop (didn't bet)
Seat 6: 3f5f9735 collected ($0.6)


Poker Hand #RC95097965: Hold'em No Limit ($0.1/$0.25) - 2020/04/07 15:44:34
Table 'RushAndCash365717' 6-max Seat #1 is the button
Seat 1: a5268365 ($26.14 in chips)
Seat 2: 62eebc49 ($120.87 in chips)
Seat 3: Hero ($55.72 in chips)
Seat 4: e814b201 ($26.68 in chips)
Seat 5: 103129d8 ($22.21 in chips)
Seat 6: 45920dbc ($47.26 in chips)
62eebc49: posts small blind $0.1
Hero: posts big blind $0.25
*** HOLE CARDS ***
Dealt to a5268365 
Dealt to 62eebc49 
Dealt to Hero [Qs 2s]
Dealt to e814b201 
Dealt to 103129d8 
Dealt to 45920dbc 
e814b201: folds
103129d8: folds
45920dbc: folds
a5268365: folds
62eebc49: raises $0.5 to $0.75
Hero: folds
Uncalled bet ($0.5) returned to 62eebc49
*** SHOWDOWN ***
62eebc49 collected $0.5 from pot
*** SUMMARY ***
Total pot $0.5
Seat 1: a5268365 (button) folded before Flop (didn't bet)
Seat 2: 62eebc49 (small blind) collected ($0.5)
Seat 3: Hero (big blind) folded before Flop
Seat 4: e814b201 folded before Flop (didn't bet)
Seat 5: 103129d8 folded before Flop (didn't bet)
Seat 6: 45920dbc folded before Flop (didn't bet)


Poker Hand #RC95097994: Hold'em No Limit ($0.1/$0.25) - 2020/04/07 15:44:38
Table 'RushAndCash365721' 6-max Seat #1 is the button
Seat 1: d6f2a39c ($5.03 in chips)
Seat 2: 89387862 ($28.65 in chips)
Seat 3: bb849ffc ($11.37 in chips)
Seat 4: Hero ($55.47 in chips)
Seat 5: 966446c2 ($32.71 in chips)
Seat 6: deb69778 ($39.74 in chips)
89387862: posts small blind $0.1
bb849ffc: posts big blind $0.25
*** HOLE CARDS ***
Dealt to d6f2a39c 
Dealt to 89387862 
Dealt to bb849ffc 
Dealt to Hero [9h 5c]
Dealt to 966446c2 
Dealt to deb69778 
Hero: folds
966446c2: raises $0.5 to $0.75
deb69778: folds
d6f2a39c: folds
89387862: folds
bb849ffc: calls $0.5
*** FLOP *** [Tc 3h 3s]
bb849ffc: checks
966446c2: bets $0.8
bb849ffc: calls $0.8
*** TURN *** [Tc 3h 3s] [5s]
bb849ffc: checks
966446c2: checks
*** RIVER *** [Tc 3h 3s 5s] [Ts]
bb849ffc: bets $2.4
966446c2: folds
Uncalled bet ($2.4) returned to bb849ffc
*** SHOWDOWN ***
bb849ffc collected $3.2 from pot
*** SUMMARY ***
Total pot $3.2
Board [Tc 3h 3s 5s Ts]
Seat 1: d6f2a39c (button) folded before Flop (didn't bet)
Seat 2: 89387862 (small blind) folded before Flop
Seat 3: bb849ffc (big blind) won ($3.2)
Seat 4: Hero folded before Flop (didn't bet)
Seat 5: 966446c2 folded on the River
Seat 6: deb69778 folded before Flop (didn't bet)


Poker Hand #RC95098027: Hold'em No Limit ($0.1/$0.25) - 2020/04/07 15:44:42
Table 'RushAndCash365725' 6-max Seat #1 is the button
Seat 1: dbf6981f ($64.9 in chips)
Seat 2: Hero ($55.47 in chips)
Seat 3: af84e661 ($7.42 in chips)
Seat 4: bdffd813 ($26.42 in chips)
Seat 5: d2f55a32 ($13.21 in chips)
Seat 6: decd88e2 ($28.83 in chips)
Hero: posts small blind $0.1
af84e661: posts big blind $0.25
*** HOLE CARDS ***
Dealt to dbf6981f 
Dealt to Hero [Qd 4c]
Dealt to af84e661 
Dealt to bdffd813 
Dealt to d2f55a32 
Dealt to decd88e2 
bdffd813: raises $0.25 to $0.5
d2f55a32: folds
decd88e2: raises $1.75 to $2.25
dbf6981f: folds
Hero: folds
af84e661: folds
bdffd813: folds
Uncalled bet ($1.75) returned to decd88e2
*** SHOWDOWN ***
decd88e2 collected $1.35 from pot
*** SUMMARY ***
Total pot $1.35
Seat 1: dbf6981f (button) folded before Flop (didn't bet)
Seat 2: Hero (small blind) folded before Flop
Seat 3: af84e661 (big blind) folded before Flop
Seat 4: bdffd813 folded before Flop
Seat 5: d2f55a32 folded before Flop (didn't bet)
Seat 6: decd88e2 collected ($1.35)


Poker Hand #RC95098043: Hold'em No Limit ($0.1/$0.25) - 2020/04/07 15:44:45
Table 'RushAndCash365727' 6-max Seat #1 is the button
Seat 1: Hero ($55.37 in chips)
Seat 2: 9c76a6c2 ($27.54 in chips)
Seat 3: d9a04cfb ($30.1 in chips)
Seat 4: 3423a84d ($35.41 in chips)
Seat 5: 2d45ce80 ($11.3 in chips)
Seat 6: 3d05956 ($41.49 in chips)
9c76a6c2: posts small blind $0.1
d9a04cfb: posts big blind $0.25
*** HOLE CARDS ***
Dealt to Hero [Js 9h]
Dealt to 9c76a6c2 
Dealt to d9a04cfb 
Dealt to 3423a84d 
Dealt to 2d45ce80 
Dealt to 3d05956 
3423a84d: folds
2d45ce80: folds
3d05956: folds
Hero: folds
9c76a6c2: folds
Uncalled bet ($0.15) returned to d9a04cfb
*** SHOWDOWN ***
d9a04cfb collected $0.2 from pot
*** SUMMARY ***
Total pot $0.2
Seat 1: Hero (button) folded before Flop (didn't bet)
Seat 2: 9c76a6c2 (small blind) folded before Flop
Seat 3: d9a04cfb (big blind) collected ($0.2)
Seat 4: 3423a84d folded before Flop (didn't bet)
Seat 5: 2d45ce80 folded before Flop (didn't bet)
Seat 6: 3d05956 folded before Flop (didn't bet)


Poker Hand #RC95098083: Hold'em No Limit ($0.1/$0.25) - 2020/04/07 15:44:50
Table 'RushAndCash365732' 6-max Seat #1 is the button
Seat 1: 30cab83a ($44.55 in chips)
Seat 2: d2986703 ($40.37 in chips)
Seat 3: 3423a84d ($35.41 in chips)
Seat 4: 45920dbc ($47.26 in chips)
Seat 5: Hero ($55.37 in chips)
Seat 6: 2d45ce80 ($11.3 in chips)
d2986703: posts small blind $0.1
3423a84d: posts big blind $0.25
*** HOLE CARDS ***
Dealt to 30cab83a 
Dealt to d2986703 
Dealt to 3423a84d 
Dealt to 45920dbc 
Dealt to Hero [Ad Qh]
Dealt to 2d45ce80 
45920dbc: folds
Hero: raises $0.38 to $0.63
2d45ce80: folds
30cab83a: folds
d2986703: folds
3423a84d: calls $0.38
*** FLOP *** [9h Ks 9s]
3423a84d: checks
Hero: checks
*** TURN *** [9h Ks 9s] [3s]
3423a84d: checks
Hero: checks
*** RIVER *** [9h Ks 9s 3s] [3d]
3423a84d: checks
Hero: checks
3423a84d: shows [7h Ah] (Pair of Nines and Pair of Treys)
Hero: shows [Qh Ad] (Pair of Nines and Pair of Treys)
*** SHOWDOWN ***
Hero collected $0.68 from pot
3423a84d collected $0.68 from pot
*** SUMMARY ***
Total pot $1.36
Board [9h Ks 9s 3s 3d]
Seat 1: 30cab83a (button) folded before Flop (didn't bet)
Seat 2: d2986703 (small blind) folded before Flop
Seat 3: 3423a84d (big blind) showed [Ah 7h] and won ($0.68) with Pair of Nines and Pair of Treys
Seat 4: 45920dbc folded before Flop (didn't bet)
Seat 5: Hero showed [Ad Qh] and won ($0.68) with Pair of Nines and Pair of Treys
Seat 6: 2d45ce80 folded before Flop (didn't bet)


Poker Hand #RC95098386: Hold'em No Limit ($0.1/$0.25) - 2020/04/07 15:45:32
Table 'RushAndCash365776' 6-max Seat #1 is the button
Seat 1: 5794e88f ($35.2 in chips)
Seat 2: 4dd920ba ($81.85 in chips)
Seat 3: 4aa8d4e8 ($12.5 in chips)
Seat 4: 61ad32d ($17.21 in chips)
Seat 5: b58bfe0f ($26.67 in chips)
Seat 6: Hero ($55.39 in chips)
4dd920ba: posts small blind $0.1
4aa8d4e8: posts big blind $0.25
*** HOLE CARDS ***
Dealt to 5794e88f 
Dealt to 4dd920ba 
Dealt to 4aa8d4e8 
Dealt to 61ad32d 
Dealt to b58bfe0f 
Dealt to Hero [9c 5c]
61ad32d: folds
b58bfe0f: folds
Hero: folds
5794e88f: raises $0.38 to $0.63
4dd920ba: folds
4aa8d4e8: folds
Uncalled bet ($0.38) returned to 5794e88f
*** SHOWDOWN ***
5794e88f collected $0.6 from pot
*** SUMMARY ***
Total pot $0.6
Seat 1: 5794e88f (button) collected ($0.6)
Seat 2: 4dd920ba (small blind) folded before Flop
Seat 3: 4aa8d4e8 (big blind) folded before Flop
Seat 4: 61ad32d folded before Flop (didn't bet)
Seat 5: b58bfe0f folded before Flop (didn't bet)
Seat 6: Hero folded before Flop (didn't bet)


Poker Hand #RC95098407: Hold'em No Limit ($0.1/$0.25) - 2020/04/07 15:45:36
Table 'RushAndCash365780' 6-max Seat #1 is the button
Seat 1: 492c0086 ($15.05 in chips)
Seat 2: 61ad32d ($17.21 in chips)
Seat 3: Hero ($55.39 in chips)
Seat 4: f178c62c ($25.65 in chips)
Seat 5: 4dd920ba ($81.75 in chips)
Seat 6: 3423a84d ($35.33 in chips)
61ad32d: posts small blind $0.1
Hero: posts big blind $0.25
*** HOLE CARDS ***
Dealt to 492c0086 
Dealt to 61ad32d 
Dealt to Hero [Kh 6c]
Dealt to f178c62c 
Dealt to 4dd920ba 
Dealt to 3423a84d 
f178c62c: folds
4dd920ba: folds
3423a84d: folds
492c0086: folds
61ad32d: folds
Uncalled bet ($0.15) returned to Hero
*** SHOWDOWN ***
Hero collected $0.2 from pot
*** SUMMARY ***
Total pot $0.2
Seat 1: 492c0086 (button) folded before Flop (didn't bet)
Seat 2: 61ad32d (small blind) folded before Flop
Seat 3: Hero (big blind) collected ($0.2)
Seat 4: f178c62c folded before Flop (didn't bet)
Seat 5: 4dd920ba folded before Flop (didn't bet)
Seat 6: 3423a84d folded before Flop (didn't bet)


Poker Hand #RC95098432: Hold'em No Limit ($0.1/$0.25) - 2020/04/07 15:45:40
Table 'RushAndCash365783' 6-max Seat #1 is the button
Seat 1: Hero ($55.14 in chips)
Seat 2: 4aa8d4e8 ($12.5 in chips)
Seat 3: 89387862 ($28.3 in chips)
Seat 4: 9f138297 ($28.58 in chips)
Seat 5: 2dd038c3 ($8.86 in chips)
Seat 6: 366c47e0 ($6.38 in chips)
4aa8d4e8: posts small blind $0.1
89387862: posts big blind $0.25
*** HOLE CARDS ***
Dealt to Hero [2s 2h]
Dealt to 4aa8d4e8 
Dealt to 89387862 
Dealt to 9f138297 
Dealt to 2dd038c3 
Dealt to 366c47e0 
9f138297: folds
2dd038c3: raises $0.63 to $0.88
366c47e0: folds
Hero: folds
4aa8d4e8: raises $1.82 to $2.7
89387862: folds
2dd038c3: calls $1.82
*** FLOP *** [8d 6c Kh]
4aa8d4e8: bets $1.9
2dd038c3: calls $1.9
*** TURN *** [8d 6c Kh] [9d]
4aa8d4e8: bets $7.9 and is all-in
2dd038c3: calls $4.26 and is all-in
Uncalled bet ($3.64) returned to 4aa8d4e8
4aa8d4e8: shows [Jh Th] (King-High)
2dd038c3: shows [Td Tc] (Pair of Tens)
*** FIRST RIVER *** [8d 6c Kh 9d] [7d]
*** SECOND RIVER *** [8d 6c Kh 9d] [9h]
*** FIRST SHOWDOWN ***
4aa8d4e8 collected $8.98 from pot
*** SECOND SHOWDOWN ***
2dd038c3 collected $8.98 from pot
*** SUMMARY ***
Total pot $17.97
Hand was run two times
FIRST Board [8d 6c Kh 9d 7d]
SECOND Board [8d 6c Kh 9d 9h]
Seat 1: Hero (button) folded before Flop (didn't bet)
Seat 2: 4aa8d4e8 (small blind) showed [Jh Th] and won ($8.98) with Jacks-High Straight, and lost with Pair of Nines
Seat 3: 89387862 (big blind) folded before Flop
Seat 4: 9f138297 folded before Flop (didn't bet)
Seat 5: 2dd038c3 showed [Td Tc] and lost with Tens-High Straight, and won ($8.98) with Pair of Tens and Pair of Nines
Seat 6: 366c47e0 folded before Flop (didn't bet)


Poker Hand #RC95098509: Hold'em No Limit ($0.1/$0.25) - 2020/04/07 15:45:51
Table 'RushAndCash365794' 6-max Seat #1 is the button
Seat 1: a4ba858f ($38.27 in chips)
Seat 2: d6f2a39c ($3.13 in chips)
Seat 3: b56c4622 ($19.15 in chips)
Seat 4: 3f5f9735 ($19.4 in chips)
Seat 5: 275e7f74 ($29.99 in chips)
Seat 6: Hero ($55.14 in chips)
d6f2a39c: posts small blind $0.1
b56c4622: posts big blind $0.25
*** HOLE CARDS ***
Dealt to a4ba858f 
Dealt to d6f2a39c 
Dealt to b56c4622 
Dealt to 3f5f9735 
Dealt to 275e7f74 
Dealt to Hero [Ah 3d]
3f5f9735: folds
275e7f74: raises $0.38 to $0.63
Hero: folds
a4ba858f: folds
d6f2a39c: folds
b56c4622: folds
Uncalled bet ($0.38) returned to 275e7f74
*** SHOWDOWN ***
275e7f74 collected $0.6 from pot
*** SUMMARY ***
Total pot $0.6
Seat 1: a4ba858f (button) folded before Flop (didn't bet)
Seat 2: d6f2a39c (small blind) folded before Flop
Seat 3: b56c4622 (big blind) folded before Flop
Seat 4: 3f5f9735 folded before Flop (didn't bet)
Seat 5: 275e7f74 collected ($0.6)
Seat 6: Hero folded before Flop (didn't bet)


Poker Hand #RC95098537: Hold'em No Limit ($0.1/$0.25) - 2020/04/07 15:45:54
Table 'RushAndCash365798' 6-max Seat #1 is the button
Seat 1: ec1c524d ($25 in chips)
Seat 2: Hero ($55.14 in chips)
Seat 3: 3dafe47e ($14.89 in chips)
Seat 4: deb69778 ($39.29 in chips)
Seat 5: 3cfd7308 ($51.36 in chips)
Seat 6: 8004b155 ($5.98 in chips)
Hero: posts small blind $0.1
3dafe47e: posts big blind $0.25
*** HOLE CARDS ***
Dealt to ec1c524d 
Dealt to Hero [Ah 7c]
Dealt to 3dafe47e 
Dealt to deb69778 
Dealt to 3cfd7308 
Dealt to 8004b155 
deb69778: folds
3cfd7308: folds
8004b155: raises $0.25 to $0.5
ec1c524d: folds
Hero: folds
3dafe47e: folds
Uncalled bet ($0.25) returned to 8004b155
*** SHOWDOWN ***
8004b155 collected $0.6 from pot
*** SUMMARY ***
Total pot $0.6
Seat 1: ec1c524d (button) folded before Flop (didn't bet)
Seat 2: Hero (small blind) folded before Flop
Seat 3: 3dafe47e (big blind) folded before Flop
Seat 4: deb69778 folded before Flop (didn't bet)
Seat 5: 3cfd7308 folded before Flop (didn't bet)
Seat 6: 8004b155 collected ($0.6)


Poker Hand #RC95098564: Hold'em No Limit ($0.1/$0.25) - 2020/04/07 15:45:57
Table 'RushAndCash365802' 6-max Seat #1 is the button
Seat 1: 36017ad1 ($43.66 in chips)
Seat 2: acf1a889 ($22.25 in chips)
Seat 3: b58bfe0f ($26.67 in chips)
Seat 4: 6185872b ($12.5 in chips)
Seat 5: decd88e2 ($29.87 in chips)
Seat 6: Hero ($55.39 in chips)
acf1a889: posts small blind $0.1
b58bfe0f: posts big blind $0.25
*** HOLE CARDS ***
Dealt to 36017ad1 
Dealt to acf1a889 
Dealt to b58bfe0f 
Dealt to 6185872b 
Dealt to decd88e2 
Dealt to Hero [6c 5h]
6185872b: folds
decd88e2: folds
Hero: folds
36017ad1: raises $0.38 to $0.63
acf1a889: folds
b58bfe0f: calls $0.38
*** FLOP *** [Kd 2d 4c]
b58bfe0f: checks
36017ad1: bets $0.7
b58bfe0f: raises $3.1 to $3.8
36017ad1: folds
Uncalled bet ($3.1) returned to b58bfe0f
*** SHOWDOWN ***
b58bfe0f collected $2.76 from pot
*** SUMMARY ***
Total pot $2.76
Board [Kd 2d 4c]
Seat 1: 36017ad1 (button) folded on the Flop
Seat 2: acf1a889 (small blind) folded before Flop
Seat 3: b58bfe0f (big blind) won ($2.76)
Seat 4: 6185872b folded before Flop (didn't bet)
Seat 5: decd88e2 folded before Flop (didn't bet)
Seat 6: Hero folded before Flop (didn't bet)


Poker Hand #RC95098594: Hold'em No Limit ($0.1/$0.25) - 2020/04/07 15:46:00
Table 'RushAndCash365807' 6-max Seat #1 is the button
Seat 1: 7bf7c8c9 ($29.22 in chips)
Seat 2: 6f1c538f ($22.39 in chips)
Seat 3: 93bbad06 ($25.69 in chips)
Seat 4: ac90cf4e ($11.83 in chips)
Seat 5: Hero ($55.39 in chips)
Seat 6: e814b201 ($28.45 in chips)
6f1c538f: posts small blind $0.1
93bbad06: posts big blind $0.25
*** HOLE CARDS ***
Dealt to 7bf7c8c9 
Dealt to 6f1c538f 
Dealt to 93bbad06 
Dealt to ac90cf4e 
Dealt to Hero [Kh Kc]
Dealt to e814b201 
ac90cf4e: folds
Hero: raises $0.38 to $0.63
e814b201: folds
7bf7c8c9: folds
6f1c538f: raises $1.57 to $2.2
93bbad06: folds
Hero: raises $3.1 to $5.3
6f1c538f: folds
Uncalled bet ($3.1) returned to Hero
*** SHOWDOWN ***
Hero collected $4.65 from pot
*** SUMMARY ***
Total pot $4.65
Seat 1: 7bf7c8c9 (button) folded before Flop (didn't bet)
Seat 2: 6f1c538f (small blind) folded before Flop
Seat 3: 93bbad06 (big blind) folded before Flop
Seat 4: ac90cf4e folded before Flop (didn't bet)
Seat 5: Hero collected ($4.65)
Seat 6: e814b201 folded before Flop (didn't bet)


Poker Hand #RC95098944: Hold'em No Limit ($0.1/$0.25) - 2020/04/07 15:46:43
Table 'RushAndCash365854' 6-max Seat #1 is the button
Seat 1: af84e661 ($7.52 in chips)
Seat 2: be3950eb ($27.05 in chips)
Seat 3: Hero ($57.61 in chips)
Seat 4: ce59b684 ($26.11 in chips)
Seat 5: deb69778 ($40.29 in chips)
Seat 6: 181b6319 ($24.07 in chips)
be3950eb: posts small blind $0.1
Hero: posts big blind $0.25
*** HOLE CARDS ***
Dealt to af84e661 
Dealt to be3950eb 
Dealt to Hero [Tc 6c]
Dealt to ce59b684 
Dealt to deb69778 
Dealt to 181b6319 
ce59b684: raises $0.38 to $0.63
deb69778: folds
181b6319: folds
af84e661: folds
be3950eb: folds
Hero: folds
Uncalled bet ($0.38) returned to ce59b684
*** SHOWDOWN ***
ce59b684 collected $0.6 from pot
*** SUMMARY ***
Total pot $0.6
Seat 1: af84e661 (button) folded before Flop (didn't bet)
Seat 2: be3950eb (small blind) folded before Flop
Seat 3: Hero (big blind) folded before Flop
Seat 4: ce59b684 collected ($0.6)
Seat 5: deb69778 folded before Flop (didn't bet)
Seat 6: 181b6319 folded before Flop (didn't bet)


Poker Hand #RC95098974: Hold'em No Limit ($0.1/$0.25) - 2020/04/07 15:46:46
Table 'RushAndCash365857' 6-max Seat #1 is the button
Seat 1: 32953d2a ($12.5 in chips)
Seat 2: Hero ($57.36 in chips)
Seat 3: cf91ce53 ($27.47 in chips)
Seat 4: d936f9ac ($15 in chips)
Seat 5: 7c935d24 ($25 in chips)
Seat 6: d6f2a39c ($2.93 in chips)
Hero: posts small blind $0.1
cf91ce53: posts big blind $0.25
*** HOLE CARDS ***
Dealt to 32953d2a 
Dealt to Hero [Qs Js]
Dealt to cf91ce53 
Dealt to d936f9ac 
Dealt to 7c935d24 
Dealt to d6f2a39c 
d936f9ac: folds
7c935d24: folds
d6f2a39c: folds
32953d2a: folds
Hero: raises $0.5 to $0.75
cf91ce53: calls $0.5
*** FLOP *** [8h Qd 5c]
Hero: bets $0.5
cf91ce53: folds
Uncalled bet ($0.5) returned to Hero
*** SHOWDOWN ***
Hero collected $1.5 from pot
*** SUMMARY ***
Total pot $1.5
Board [8h Qd 5c]
Seat 1: 32953d2a (button) folded before Flop (didn't bet)
Seat 2: Hero (small blind) won ($1.5)
Seat 3: cf91ce53 (big blind) folded on the Flop
Seat 4: d936f9ac folded before Flop (didn't bet)
Seat 5: 7c935d24 folded before Flop (didn't bet)
Seat 6: d6f2a39c folded before Flop (didn't bet)


Poker Hand #RC95099187: Hold'em No Limit ($0.1/$0.25) - 2020/04/07 15:47:13
Table 'RushAndCash365890' 6-max Seat #1 is the button
Seat 1: decd88e2 ($29.87 in chips)
Seat 2: d2986703 ($39.72 in chips)
Seat 3: 30cab83a ($42.52 in chips)
Seat 4: bbb85b3f ($25 in chips)
Seat 5: Hero ($58.04 in chips)
Seat 6: 4dd920ba ($82.42 in chips)
d2986703: posts small blind $0.1
30cab83a: posts big blind $0.25
*** HOLE CARDS ***
Dealt to decd88e2 
Dealt to d2986703 
Dealt to 30cab83a 
Dealt to bbb85b3f 
Dealt to Hero [Kh 9s]
Dealt to 4dd920ba 
bbb85b3f: folds
Hero: folds
4dd920ba: folds
decd88e2: folds
d2986703: raises $0.5 to $0.75
30cab83a: calls $0.5
*** FLOP *** [4d 5s 7s]
d2986703: checks
30cab83a: checks
*** TURN *** [4d 5s 7s] [6c]
d2986703: checks
30cab83a: bets $0.5
d2986703: folds
Uncalled bet ($0.5) returned to 30cab83a
*** SHOWDOWN ***
30cab83a collected $1.5 from pot
*** SUMMARY ***
Total pot $1.5
Board [4d 5s 7s 6c]
Seat 1: decd88e2 (button) folded before Flop (didn't bet)
Seat 2: d2986703 (small blind) folded on the Turn
Seat 3: 30cab83a (big blind) won ($1.5)
Seat 4: bbb85b3f folded before Flop (didn't bet)
Seat 5: Hero folded before Flop (didn't bet)
Seat 6: 4dd920ba folded before Flop (didn't bet)


Poker Hand #RC95099269: Hold'em No Limit ($0.1/$0.25) - 2020/04/07 15:47:22
Table 'RushAndCash365901' 6-max Seat #1 is the button
Seat 1: 4ab4e4a3 ($25 in chips)
Seat 2: fc8a29ea ($56.82 in chips)
Seat 3: Hero ($58.04 in chips)
Seat 4: caa68458 ($25 in chips)
Seat 5: 103129d8 ($31.16 in chips)
Seat 6: 37389880 ($14.02 in chips)
fc8a29ea: posts small blind $0.1
Hero: posts big blind $0.25
*** HOLE CARDS ***
Dealt to 4ab4e4a3 
Dealt to fc8a29ea 
Dealt to Hero [Ks Qs]
Dealt to caa68458 
Dealt to 103129d8 
Dealt to 37389880 
caa68458: folds
103129d8: folds
37389880: folds
4ab4e4a3: folds
fc8a29ea: calls $0.15
Hero: raises $0.55 to $0.8
fc8a29ea: calls $0.55
*** FLOP *** [3d 9h Qh]
fc8a29ea: checks
Hero: bets $0.92
fc8a29ea: folds
Uncalled bet ($0.92) returned to Hero
*** SHOWDOWN ***
Hero collected $1.6 from pot
*** SUMMARY ***
Total pot $1.6
Board [3d 9h Qh]
Seat 1: 4ab4e4a3 (button) folded before Flop (didn't bet)
Seat 2: fc8a29ea (small blind) folded on the Flop
Seat 3: Hero (big blind) won ($1.6)
Seat 4: caa68458 folded before Flop (didn't bet)
Seat 5: 103129d8 folded before Flop (didn't bet)
Seat 6: 37389880 folded before Flop (didn't bet)


Poker Hand #RC95099717: Hold'em No Limit ($0.1/$0.25) - 2020/04/07 15:48:16
Table 'RushAndCash365956' 6-max Seat #1 is the button
Seat 1: Hero ($58.76 in chips)
Seat 2: 51c60a1c ($12.16 in chips)
Seat 3: e814b201 ($28.59 in chips)
Seat 4: a5268365 ($28.17 in chips)
Seat 5: fc8a29ea ($56.02 in chips)
Seat 6: 3cfd7308 ($52.18 in chips)
51c60a1c: posts small blind $0.1
e814b201: posts big blind $0.25
*** HOLE CARDS ***
Dealt to Hero [Qc Th]
Dealt to 51c60a1c 
Dealt to e814b201 
Dealt to a5268365 
Dealt to fc8a29ea 
Dealt to 3cfd7308 
a5268365: folds
fc8a29ea: folds
3cfd7308: folds
Hero: raises $0.38 to $0.63
51c60a1c: calls $0.53
e814b201: folds
*** FLOP *** [3h 7s Qh]
51c60a1c: checks
Hero: bets $0.82
51c60a1c: calls $0.82
*** TURN *** [3h 7s Qh] [Qs]
51c60a1c: checks
Hero: bets $2.4
51c60a1c: folds
Uncalled bet ($2.4) returned to Hero
*** SHOWDOWN ***
Hero collected $3.15 from pot
*** SUMMARY ***
Total pot $3.15
Board [3h 7s Qh Qs]
Seat 1: Hero (button) won ($3.15)
Seat 2: 51c60a1c (small blind) folded on the Turn
Seat 3: e814b201 (big blind) folded before Flop
Seat 4: a5268365 folded before Flop (didn't bet)
Seat 5: fc8a29ea folded before Flop (didn't bet)
Seat 6: 3cfd7308 folded before Flop (didn't bet)


Poker Hand #RC95100032: Hold'em No Limit ($0.1/$0.25) - 2020/04/07 15:48:55
Table 'RushAndCash365996' 6-max Seat #1 is the button
Seat 1: 492c0086 ($14.99 in chips)
Seat 2: 93bbad06 ($29.33 in chips)
Seat 3: 51c60a1c ($10.71 in chips)
Seat 4: Hero ($60.31 in chips)
Seat 5: ec1c524d ($25.35 in chips)
Seat 6: 74937d40 ($36.27 in chips)
93bbad06: posts small blind $0.1
51c60a1c: posts big blind $0.25
*** HOLE CARDS ***
Dealt to 492c0086 
Dealt to 93bbad06 
Dealt to 51c60a1c 
Dealt to Hero [Qs 3c]
Dealt to ec1c524d 
Dealt to 74937d40 
Hero: folds
ec1c524d: folds
74937d40: raises $0.38 to $0.63
492c0086: folds
93bbad06: folds
51c60a1c: folds
Uncalled bet ($0.38) returned to 74937d40
*** SHOWDOWN ***
74937d40 collected $0.6 from pot
*** SUMMARY ***
Total pot $0.6
Seat 1: 492c0086 (button) folded before Flop (didn't bet)
Seat 2: 93bbad06 (small blind) folded before Flop
Seat 3: 51c60a1c (big blind) folded before Flop
Seat 4: Hero folded before Flop (didn't bet)
Seat 5: ec1c524d folded before Flop (didn't bet)
Seat 6: 74937d40 collected ($0.6)


Poker Hand #RC95100078: Hold'em No Limit ($0.1/$0.25) - 2020/04/07 15:49:01
Table 'RushAndCash366002' 6-max Seat #1 is the button
Seat 1: 51c60a1c ($10.46 in chips)
Seat 2: fb4a5e69 ($25.65 in chips)
Seat 3: adb51d54 ($26.16 in chips)
Seat 4: 52ee6b3d ($25 in chips)
Seat 5: 6736194e ($27.01 in chips)
Seat 6: Hero ($60.31 in chips)
fb4a5e69: posts small blind $0.1
adb51d54: posts big blind $0.25
*** HOLE CARDS ***
Dealt to 51c60a1c 
Dealt to fb4a5e69 
Dealt to adb51d54 
Dealt to 52ee6b3d 
Dealt to 6736194e 
Dealt to Hero [Tc 7s]
52ee6b3d: folds
6736194e: folds
Hero: folds
51c60a1c: folds
fb4a5e69: folds
Uncalled bet ($0.15) returned to adb51d54
*** SHOWDOWN ***
adb51d54 collected $0.2 from pot
*** SUMMARY ***
Total pot $0.2
Seat 1: 51c60a1c (button) folded before Flop (didn't bet)
Seat 2: fb4a5e69 (small blind) folded before Flop
Seat 3: adb51d54 (big blind) collected ($0.2)
Seat 4: 52ee6b3d folded before Flop (didn't bet)
Seat 5: 6736194e folded before Flop (didn't bet)
Seat 6: Hero folded before Flop (didn't bet)


Poker Hand #RC95100122: Hold'em No Limit ($0.1/$0.25) - 2020/04/07 15:49:06
Table 'RushAndCash366008' 6-max Seat #1 is the button
Seat 1: f178c62c ($27.61 in chips)
Seat 2: 37389880 ($13.27 in chips)
Seat 3: 22be9faa ($10.9 in chips)
Seat 4: 1cf2736e ($27.85 in chips)
Seat 5: Hero ($60.31 in chips)
Seat 6: 3423a84d ($50.58 in chips)
37389880: posts small blind $0.1
22be9faa: posts big blind $0.25
*** HOLE CARDS ***
Dealt to f178c62c 
Dealt to 37389880 
Dealt to 22be9faa 
Dealt to 1cf2736e 
Dealt to Hero [7d 3d]
Dealt to 3423a84d 
1cf2736e: raises $0.38 to $0.63
Hero: folds
3423a84d: folds
f178c62c: folds
37389880: folds
22be9faa: folds
Uncalled bet ($0.38) returned to 1cf2736e
*** SHOWDOWN ***
1cf2736e collected $0.6 from pot
*** SUMMARY ***
Total pot $0.6
Seat 1: f178c62c (button) folded before Flop (didn't bet)
Seat 2: 37389880 (small blind) folded before Flop
Seat 3: 22be9faa (big blind) folded before Flop
Seat 4: 1cf2736e collected ($0.6)
Seat 5: Hero folded before Flop (didn't bet)
Seat 6: 3423a84d folded before Flop (didn't bet)


Poker Hand #RC95100146: Hold'em No Limit ($0.1/$0.25) - 2020/04/07 15:49:10
Table 'RushAndCash366011' 6-max Seat #1 is the button
Seat 1: Hero ($60.31 in chips)
Seat 2: 346ec01 ($12.5 in chips)
Seat 3: e131407f ($27.02 in chips)
Seat 4: 51c60a1c ($10.46 in chips)
Seat 5: 8004b155 ($12.76 in chips)
Seat 6: 103129d8 ($30.81 in chips)
346ec01: posts small blind $0.1
e131407f: posts big blind $0.25
*** HOLE CARDS ***
Dealt to Hero [Kc 4c]
Dealt to 346ec01 
Dealt to e131407f 
Dealt to 51c60a1c 
Dealt to 8004b155 
Dealt to 103129d8 
51c60a1c: folds
8004b155: folds
103129d8: raises $0.75 to $1
Hero: folds
346ec01: folds
e131407f: folds
Uncalled bet ($0.75) returned to 103129d8
*** SHOWDOWN ***
103129d8 collected $0.6 from pot
*** SUMMARY ***
Total pot $0.6
Seat 1: Hero (button) folded before Flop (didn't bet)
Seat 2: 346ec01 (small blind) folded before Flop
Seat 3: e131407f (big blind) folded before Flop
Seat 4: 51c60a1c folded before Flop (didn't bet)
Seat 5: 8004b155 folded before Flop (didn't bet)
Seat 6: 103129d8 collected ($0.6)


Poker Hand #RC95100276: Hold'em No Limit ($0.1/$0.25) - 2020/04/07 15:49:27
Table 'RushAndCash366031' 6-max Seat #1 is the button
Seat 1: bbb85b3f ($25.92 in chips)
Seat 2: d263ef65 ($11.75 in chips)
Seat 3: 6736194e ($27.36 in chips)
Seat 4: fb4a5e69 ($25.9 in chips)
Seat 5: Hero ($60.31 in chips)
Seat 6: bad0409c ($15.37 in chips)
d263ef65: posts small blind $0.1
6736194e: posts big blind $0.25
*** HOLE CARDS ***
Dealt to bbb85b3f 
Dealt to d263ef65 
Dealt to 6736194e 
Dealt to fb4a5e69 
Dealt to Hero [5s 5h]
Dealt to bad0409c 
fb4a5e69: folds
Hero: raises $0.38 to $0.63
bad0409c: folds
bbb85b3f: folds
d263ef65: folds
6736194e: folds
Uncalled bet ($0.38) returned to Hero
*** SHOWDOWN ***
Hero collected $0.6 from pot
*** SUMMARY ***
Total pot $0.6
Seat 1: bbb85b3f (button) folded before Flop (didn't bet)
Seat 2: d263ef65 (small blind) folded before Flop
Seat 3: 6736194e (big blind) folded before Flop
Seat 4: fb4a5e69 folded before Flop (didn't bet)
Seat 5: Hero collected ($0.6)
Seat 6: bad0409c folded before Flop (didn't bet)


Poker Hand #RC95100469: Hold'em No Limit ($0.1/$0.25) - 2020/04/07 15:49:50
Table 'RushAndCash366059' 6-max Seat #1 is the button
Seat 1: ac90cf4e ($10.54 in chips)
Seat 2: cdd7700a ($14.1 in chips)
Seat 3: d07b3de1 ($35.84 in chips)
Seat 4: Hero ($60.66 in chips)
Seat 5: 275e7f74 ($26.41 in chips)
Seat 6: 6736194e ($27.01 in chips)
cdd7700a: posts small blind $0.1
d07b3de1: posts big blind $0.25
*** HOLE CARDS ***
Dealt to ac90cf4e 
Dealt to cdd7700a 
Dealt to d07b3de1 
Dealt to Hero [Qd 9c]
Dealt to 275e7f74 
Dealt to 6736194e 
Hero: folds
275e7f74: folds
6736194e: folds
ac90cf4e: raises $0.25 to $0.5
cdd7700a: folds
d07b3de1: calls $0.25
*** FLOP *** [8h Kh 3d]
d07b3de1: checks
ac90cf4e: bets $0.5
d07b3de1: folds
Uncalled bet ($0.5) returned to ac90cf4e
*** SHOWDOWN ***
ac90cf4e collected $1.1 from pot
*** SUMMARY ***
Total pot $1.1
Board [8h Kh 3d]
Seat 1: ac90cf4e (button) won ($1.1)
Seat 2: cdd7700a (small blind) folded before Flop
Seat 3: d07b3de1 (big blind) folded on the Flop
Seat 4: Hero folded before Flop (didn't bet)
Seat 5: 275e7f74 folded before Flop (didn't bet)
Seat 6: 6736194e folded before Flop (didn't bet)


Poker Hand #RC95100496: Hold'em No Limit ($0.1/$0.25) - 2020/04/07 15:49:53
Table 'RushAndCash366064' 6-max Seat #1 is the button
Seat 1: 22be9faa ($10.8 in chips)
Seat 2: 4c077ac6 ($11.94 in chips)
Seat 3: 346ec01 ($12.5 in chips)
Seat 4: Hero ($60.66 in chips)
Seat 5: 3423a84d ($50.23 in chips)
Seat 6: 6f1c538f ($25.07 in chips)
4c077ac6: posts small blind $0.1
346ec01: posts big blind $0.25
*** HOLE CARDS ***
Dealt to 22be9faa 
Dealt to 4c077ac6 
Dealt to 346ec01 
Dealt to Hero [Td 2d]
Dealt to 3423a84d 
Dealt to 6f1c538f 
Hero: folds
3423a84d: folds
6f1c538f: folds
22be9faa: folds
4c077ac6: folds
Uncalled bet ($0.15) returned to 346ec01
*** SHOWDOWN ***
346ec01 collected $0.2 from pot
*** SUMMARY ***
Total pot $0.2
Seat 1: 22be9faa (button) folded before Flop (didn't bet)
Seat 2: 4c077ac6 (small blind) folded before Flop
Seat 3: 346ec01 (big blind) collected ($0.2)
Seat 4: Hero folded before Flop (didn't bet)
Seat 5: 3423a84d folded before Flop (didn't bet)
Seat 6: 6f1c538f folded before Flop (didn't bet)


Poker Hand #RC95100523: Hold'em No Limit ($0.1/$0.25) - 2020/04/07 15:49:57
Table 'RushAndCash366068' 6-max Seat #1 is the button
Seat 1: cdd7700a ($14 in chips)
Seat 2: Hero ($60.66 in chips)
Seat 3: 22be9faa ($10.8 in chips)
Seat 4: 3423a84d ($50.23 in chips)
Seat 5: 103129d8 ($30.81 in chips)
Seat 6: 811232a3 ($35.83 in chips)
Hero: posts small blind $0.1
22be9faa: posts big blind $0.25
*** HOLE CARDS ***
Dealt to cdd7700a 
Dealt to Hero [7s 6s]
Dealt to 22be9faa 
Dealt to 3423a84d 
Dealt to 103129d8 
Dealt to 811232a3 
3423a84d: raises $0.25 to $0.5
103129d8: calls $0.5
811232a3: folds
cdd7700a: folds
Hero: calls $0.4
22be9faa: folds
*** FLOP *** [2c Ah Ad]
Hero: checks
3423a84d: checks
103129d8: checks
*** TURN *** [2c Ah Ad] [4d]
Hero: checks
3423a84d: bets $1.2
103129d8: folds
Hero: folds
Uncalled bet ($1.2) returned to 3423a84d
*** SHOWDOWN ***
3423a84d collected $1.75 from pot
*** SUMMARY ***
Total pot $1.75
Board [2c Ah Ad 4d]
Seat 1: cdd7700a (button) folded before Flop (didn't bet)
Seat 2: Hero (small blind) folded on the Turn
Seat 3: 22be9faa (big blind) folded before Flop
Seat 4: 3423a84d won ($1.75)
Seat 5: 103129d8 folded on the Turn
Seat 6: 811232a3 folded before Flop (didn't bet)


Poker Hand #RC95100727: Hold'em No Limit ($0.1/$0.25) - 2020/04/07 15:50:25
Table 'RushAndCash366099' 6-max Seat #1 is the button
Seat 1: deb69778 ($38.94 in chips)
Seat 2: 7c935d24 ($26.15 in chips)
Seat 3: Hero ($60.16 in chips)
Seat 4: 8004b155 ($12.86 in chips)
Seat 5: 94943589 ($25.9 in chips)
Seat 6: 87ffc01b ($25.7 in chips)
7c935d24: posts small blind $0.1
Hero: posts big blind $0.25
*** HOLE CARDS ***
Dealt to deb69778 
Dealt to 7c935d24 
Dealt to Hero [Td 4h]
Dealt to 8004b155 
Dealt to 94943589 
Dealt to 87ffc01b 
8004b155: folds
94943589: folds
87ffc01b: folds
deb69778: folds
7c935d24: folds
Uncalled bet ($0.15) returned to Hero
*** SHOWDOWN ***
Hero collected $0.2 from pot
*** SUMMARY ***
Total pot $0.2
Seat 1: deb69778 (button) folded before Flop (didn't bet)
Seat 2: 7c935d24 (small blind) folded before Flop
Seat 3: Hero (big blind) collected ($0.2)
Seat 4: 8004b155 folded before Flop (didn't bet)
Seat 5: 94943589 folded before Flop (didn't bet)
Seat 6: 87ffc01b folded before Flop (didn't bet)


Poker Hand #RC95100786: Hold'em No Limit ($0.1/$0.25) - 2020/04/07 15:50:32
Table 'RushAndCash366109' 6-max Seat #1 is the button
Seat 1: Hero ($59.91 in chips)
Seat 2: f178c62c ($28.03 in chips)
Seat 3: d3a18552 ($12.65 in chips)
Seat 4: a4ba858f ($37.18 in chips)
Seat 5: af84e661 ($11.56 in chips)
Seat 6: fe2378bf ($11.52 in chips)
f178c62c: posts small blind $0.1
d3a18552: posts big blind $0.25
*** HOLE CARDS ***
Dealt to Hero [Ac 3d]
Dealt to f178c62c 
Dealt to d3a18552 
Dealt to a4ba858f 
Dealt to af84e661 
Dealt to fe2378bf 
a4ba858f: folds
af84e661: folds
fe2378bf: folds
Hero: folds
f178c62c: raises $0.38 to $0.63
d3a18552: folds
Uncalled bet ($0.38) returned to f178c62c
*** SHOWDOWN ***
f178c62c collected $0.5 from pot
*** SUMMARY ***
Total pot $0.5
Seat 1: Hero (button) folded before Flop (didn't bet)
Seat 2: f178c62c (small blind) collected ($0.5)
Seat 3: d3a18552 (big blind) folded before Flop
Seat 4: a4ba858f folded before Flop (didn't bet)
Seat 5: af84e661 folded before Flop (didn't bet)
Seat 6: fe2378bf folded before Flop (didn't bet)


Poker Hand #RC95100817: Hold'em No Limit ($0.1/$0.25) - 2020/04/07 15:50:36
Table 'RushAndCash366113' 6-max Seat #1 is the button
Seat 1: 8c4d6eff ($36.9 in chips)
Seat 2: be3950eb ($27.73 in chips)
Seat 3: 2c82afb5 ($13.81 in chips)
Seat 4: a4ba858f ($37.18 in chips)
Seat 5: Hero ($59.91 in chips)
Seat 6: 704c37d9 ($40.12 in chips)
be3950eb: posts small blind $0.1
2c82afb5: posts big blind $0.25
*** HOLE CARDS ***
Dealt to 8c4d6eff 
Dealt to be3950eb 
Dealt to 2c82afb5 
Dealt to a4ba858f 
Dealt to Hero [Ts 2d]
Dealt to 704c37d9 
a4ba858f: folds
Hero: folds
704c37d9: raises $0.38 to $0.63
8c4d6eff: folds
be3950eb: folds
2c82afb5: calls $0.38
*** FLOP *** [5c 8c 8d]
2c82afb5: checks
704c37d9: checks
*** TURN *** [5c 8c 8d] [2c]
2c82afb5: bets $1.8
704c37d9: folds
Uncalled bet ($1.8) returned to 2c82afb5
*** SHOWDOWN ***
2c82afb5 collected $1.36 from pot
*** SUMMARY ***
Total pot $1.36
Board [5c 8c 8d 2c]
Seat 1: 8c4d6eff (button) folded before Flop (didn't bet)
Seat 2: be3950eb (small blind) folded before Flop
Seat 3: 2c82afb5 (big blind) won ($1.36)
Seat 4: a4ba858f folded before Flop (didn't bet)
Seat 5: Hero folded before Flop (didn't bet)
Seat 6: 704c37d9 folded on the Turn


Poker Hand #RC95100846: Hold'em No Limit ($0.1/$0.25) - 2020/04/07 15:50:40
Table 'RushAndCash366118' 6-max Seat #1 is the button
Seat 1: a4ba858f ($37.18 in chips)
Seat 2: Hero ($59.91 in chips)
Seat 3: cdd7700a ($14.35 in chips)
Seat 4: 8c4d6eff ($37.25 in chips)
Seat 5: 2d45ce80 ($8.7 in chips)
Seat 6: 98ddea23 ($7.65 in chips)
Hero: posts small blind $0.1
cdd7700a: posts big blind $0.25
*** HOLE CARDS ***
Dealt to a4ba858f 
Dealt to Hero [4h 3c]
Dealt to cdd7700a 
Dealt to 8c4d6eff 
Dealt to 2d45ce80 
Dealt to 98ddea23 
8c4d6eff: folds
2d45ce80: folds
98ddea23: raises $0.5 to $0.75
a4ba858f: folds
Hero: folds
cdd7700a: raises $1.45 to $2.2
98ddea23: raises $1.45 to $3.65
cdd7700a: folds
Uncalled bet ($1.45) returned to 98ddea23
*** SHOWDOWN ***
98ddea23 collected $4.5 from pot
*** SUMMARY ***
Total pot $4.5
Seat 1: a4ba858f (button) folded before Flop (didn't bet)
Seat 2: Hero (small blind) folded before Flop
Seat 3: cdd7700a (big blind) folded before Flop
Seat 4: 8c4d6eff folded before Flop (didn't bet)
Seat 5: 2d45ce80 folded before Flop (didn't bet)
Seat 6: 98ddea23 collected ($4.5)


Poker Hand #RC95100885: Hold'em No Limit ($0.1/$0.25) - 2020/04/07 15:50:45
Table 'RushAndCash366123' 6-max Seat #1 is the button
Seat 1: 87ffc01b ($25.7 in chips)
Seat 2: a4ba858f ($37.18 in chips)
Seat 3: Hero ($60.16 in chips)
Seat 4: 492c0086 ($14.64 in chips)
Seat 5: 37389880 ($12.35 in chips)
Seat 6: 551c4b87 ($12.3 in chips)
a4ba858f: posts small blind $0.1
Hero: posts big blind $0.25
*** HOLE CARDS ***
Dealt to 87ffc01b 
Dealt to a4ba858f 
Dealt to Hero [9c 7s]
Dealt to 492c0086 
Dealt to 37389880 
Dealt to 551c4b87 
492c0086: raises $0.38 to $0.63
37389880: folds
551c4b87: folds
87ffc01b: calls $0.63
a4ba858f: folds
Hero: folds
*** FLOP *** [5d 2s 9h]
492c0086: checks
87ffc01b: checks
*** TURN *** [5d 2s 9h] [Jh]
492c0086: bets $1.3
87ffc01b: folds
Uncalled bet ($1.3) returned to 492c0086
*** SHOWDOWN ***
492c0086 collected $1.61 from pot
*** SUMMARY ***
Total pot $1.61
Board [5d 2s 9h Jh]
Seat 1: 87ffc01b (button) folded on the Turn
Seat 2: a4ba858f (small blind) folded before Flop
Seat 3: Hero (big blind) folded before Flop
Seat 4: 492c0086 won ($1.61)
Seat 5: 37389880 folded before Flop (didn't bet)
Seat 6: 551c4b87 folded before Flop (didn't bet)


Poker Hand #RC95100917: Hold'em No Limit ($0.1/$0.25) - 2020/04/07 15:50:49
Table 'RushAndCash366128' 6-max Seat #1 is the button
Seat 1: 8c86f461 ($34.96 in chips)
Seat 2: 1cf2736e ($29.79 in chips)
Seat 3: 551c4b87 ($12.3 in chips)
Seat 4: dbf6981f ($49.16 in chips)
Seat 5: Hero ($59.91 in chips)
Seat 6: 36017ad1 ($34.63 in chips)
1cf2736e: posts small blind $0.1
551c4b87: posts big blind $0.25
*** HOLE CARDS ***
Dealt to 8c86f461 
Dealt to 1cf2736e 
Dealt to 551c4b87 
Dealt to dbf6981f 
Dealt to Hero [9c 5h]
Dealt to 36017ad1 
dbf6981f: folds
Hero: folds
36017ad1: folds
8c86f461: folds
1cf2736e: folds
Uncalled bet ($0.15) returned to 551c4b87
*** SHOWDOWN ***
551c4b87 collected $0.2 from pot
*** SUMMARY ***
Total pot $0.2
Seat 1: 8c86f461 (button) folded before Flop (didn't bet)
Seat 2: 1cf2736e (small blind) folded before Flop
Seat 3: 551c4b87 (big blind) collected ($0.2)
Seat 4: dbf6981f folded before Flop (didn't bet)
Seat 5: Hero folded before Flop (didn't bet)
Seat 6: 36017ad1 folded before Flop (didn't bet)


Poker Hand #RC95100943: Hold'em No Limit ($0.1/$0.25) - 2020/04/07 15:50:51
Table 'RushAndCash366131' 6-max Seat #1 is the button
Seat 1: 4ab4e4a3 ($25 in chips)
Seat 2: bf64de7f ($7.17 in chips)
Seat 3: 4c077ac6 ($13.16 in chips)
Seat 4: d6f2a39c ($2.72 in chips)
Seat 5: 45920dbc ($75.43 in chips)
Seat 6: Hero ($59.91 in chips)
bf64de7f: posts small blind $0.1
4c077ac6: posts big blind $0.25
*** HOLE CARDS ***
Dealt to 4ab4e4a3 
Dealt to bf64de7f 
Dealt to 4c077ac6 
Dealt to d6f2a39c 
Dealt to 45920dbc 
Dealt to Hero [As 4c]
d6f2a39c: folds
45920dbc: raises $0.38 to $0.63
Hero: folds
4ab4e4a3: folds
bf64de7f: folds
4c077ac6: folds
Uncalled bet ($0.38) returned to 45920dbc
*** SHOWDOWN ***
45920dbc collected $0.6 from pot
*** SUMMARY ***
Total pot $0.6
Seat 1: 4ab4e4a3 (button) folded before Flop (didn't bet)
Seat 2: bf64de7f (small blind) folded before Flop
Seat 3: 4c077ac6 (big blind) folded before Flop
Seat 4: d6f2a39c folded before Flop (didn't bet)
Seat 5: 45920dbc collected ($0.6)
Seat 6: Hero folded before Flop (didn't bet)


Poker Hand #RC95100974: Hold'em No Limit ($0.1/$0.25) - 2020/04/07 15:50:55
Table 'RushAndCash366133' 6-max Seat #1 is the button
Seat 1: e6fa23c9 ($20.84 in chips)
Seat 2: Hero ($59.91 in chips)
Seat 3: adb51d54 ($28.05 in chips)
Seat 4: 40a91d41 ($29.5 in chips)
Seat 5: 30cab83a ($43.88 in chips)
Seat 6: 2d45ce80 ($8.7 in chips)
Hero: posts small blind $0.1
adb51d54: posts big blind $0.25
*** HOLE CARDS ***
Dealt to e6fa23c9 
Dealt to Hero [Ad Js]
Dealt to adb51d54 
Dealt to 40a91d41 
Dealt to 30cab83a 
Dealt to 2d45ce80 
40a91d41: folds
30cab83a: folds
2d45ce80: folds
e6fa23c9: raises $0.25 to $0.5
Hero: raises $1.7 to $2.2
adb51d54: folds
e6fa23c9: folds
Uncalled bet ($1.7) returned to Hero
*** SHOWDOWN ***
Hero collected $1.25 from pot
*** SUMMARY ***
Total pot $1.25
Seat 1: e6fa23c9 (button) folded before Flop
Seat 2: Hero (small blind) collected ($1.25)
Seat 3: adb51d54 (big blind) folded before Flop
Seat 4: 40a91d41 folded before Flop (didn't bet)
Seat 5: 30cab83a folded before Flop (didn't bet)
Seat 6: 2d45ce80 folded before Flop (didn't bet)


Poker Hand #RC95101214: Hold'em No Limit ($0.1/$0.25) - 2020/04/07 15:51:27
Table 'RushAndCash366166' 6-max Seat #1 is the button
Seat 1: d07b3de1 ($35.34 in chips)
Seat 2: 4dd920ba ($84.86 in chips)
Seat 3: 52ee6b3d ($25 in chips)
Seat 4: 6185872b ($12.69 in chips)
Seat 5: d263ef65 ($11.15 in chips)
Seat 6: Hero ($60.6 in chips)
4dd920ba: posts small blind $0.1
52ee6b3d: posts big blind $0.25
*** HOLE CARDS ***
Dealt to d07b3de1 
Dealt to 4dd920ba 
Dealt to 52ee6b3d 
Dealt to 6185872b 
Dealt to d263ef65 
Dealt to Hero [Ah 3h]
6185872b: raises $0.44 to $0.69
d263ef65: folds
Hero: folds
d07b3de1: folds
4dd920ba: folds
52ee6b3d: folds
Uncalled bet ($0.44) returned to 6185872b
*** SHOWDOWN ***
6185872b collected $0.6 from pot
*** SUMMARY ***
Total pot $0.6
Seat 1: d07b3de1 (button) folded before Flop (didn't bet)
Seat 2: 4dd920ba (small blind) folded before Flop
Seat 3: 52ee6b3d (big blind) folded before Flop
Seat 4: 6185872b collected ($0.6)
Seat 5: d263ef65 folded before Flop (didn't bet)
Seat 6: Hero folded before Flop (didn't bet)


Poker Hand #RC95101322: Hold'em No Limit ($0.1/$0.25) - 2020/04/07 15:51:41
Table 'RushAndCash366180' 6-max Seat #1 is the button
Seat 1: Hero ($60.6 in chips)
Seat 2: fb4a5e69 ($25.55 in chips)
Seat 3: 87ffc01b ($25.07 in chips)
Seat 4: 40a91d41 ($30.17 in chips)
Seat 5: 492c0086 ($15.54 in chips)
Seat 6: fc8a29ea ($55.87 in chips)
fb4a5e69: posts small blind $0.1
87ffc01b: posts big blind $0.25
*** HOLE CARDS ***
Dealt to Hero [As 9s]
Dealt to fb4a5e69 
Dealt to 87ffc01b 
Dealt to 40a91d41 
Dealt to 492c0086 
Dealt to fc8a29ea 
40a91d41: folds
492c0086: folds
fc8a29ea: raises $0.38 to $0.63
Hero: calls $0.63
fb4a5e69: calls $0.53
87ffc01b: raises $2.87 to $3.5
fc8a29ea: folds
Hero: folds
fb4a5e69: calls $2.87
*** FLOP *** [Qh Qc 5d]
fb4a5e69: checks
87ffc01b: bets $4.75
fb4a5e69: calls $4.75
*** TURN *** [Qh Qc 5d] [4s]
fb4a5e69: checks
87ffc01b: bets $16.82 and is all-in
fb4a5e69: calls $16.82
87ffc01b: shows [Td Th] (Pair of Queens and Pair of Tens)
fb4a5e69: shows [7d 7c] (Pair of Queens and Pair of Sevens)
*** FIRST RIVER *** [Qh Qc 5d 4s] [Js]
*** SECOND RIVER *** [Qh Qc 5d 4s] [3c]
*** FIRST SHOWDOWN ***
87ffc01b collected $25.7 from pot
*** SECOND SHOWDOWN ***
87ffc01b collected $25.7 from pot
*** SUMMARY ***
Total pot $51.4
Hand was run two times
FIRST Board [Qh Qc 5d 4s Js]
SECOND Board [Qh Qc 5d 4s 3c]
Seat 1: Hero (button) folded before Flop
Seat 2: fb4a5e69 (small blind) showed [7d 7c] and lost with Pair of Queens and Pair of Sevens, and lost with Pair of Queens and Pair of Sevens
Seat 3: 87ffc01b (big blind) showed [Th Td] and won ($25.7) with Pair of Queens and Pair of Tens, and won ($25.7) with Pair of Queens and Pair of Tens
Seat 4: 40a91d41 folded before Flop (didn't bet)
Seat 5: 492c0086 folded before Flop (didn't bet)
Seat 6: fc8a29ea folded before Flop


Poker Hand #RC95101817: Hold'em No Limit ($0.1/$0.25) - 2020/04/07 15:52:51
Table 'RushAndCash366230' 6-max Seat #1 is the button
Seat 1: ea254934 ($13.95 in chips)
Seat 2: d2986703 ($38.53 in chips)
Seat 3: Hero ($59.97 in chips)
Seat 4: 44d6b861 ($25.54 in chips)
Seat 5: 2d45ce80 ($8.7 in chips)
Seat 6: acf1a889 ($22.45 in chips)
d2986703: posts small blind $0.1
Hero: posts big blind $0.25
*** HOLE CARDS ***
Dealt to ea254934 
Dealt to d2986703 
Dealt to Hero [Ad Jd]
Dealt to 44d6b861 
Dealt to 2d45ce80 
Dealt to acf1a889 
44d6b861: folds
2d45ce80: folds
acf1a889: folds
ea254934: folds
d2986703: folds
Uncalled bet ($0.15) returned to Hero
*** SHOWDOWN ***
Hero collected $0.2 from pot
*** SUMMARY ***
Total pot $0.2
Seat 1: ea254934 (button) folded before Flop (didn't bet)
Seat 2: d2986703 (small blind) folded before Flop
Seat 3: Hero (big blind) collected ($0.2)
Seat 4: 44d6b861 folded before Flop (didn't bet)
Seat 5: 2d45ce80 folded before Flop (didn't bet)
Seat 6: acf1a889 folded before Flop (didn't bet)


Poker Hand #RC95101938: Hold'em No Limit ($0.1/$0.25) - 2020/04/07 15:53:08
Table 'RushAndCash366240' 6-max Seat #1 is the button
Seat 1: Hero ($60.07 in chips)
Seat 2: ed488d2d ($15.73 in chips)
Seat 3: 81765e66 ($12 in chips)
Seat 4: 3423a84d ($50.84 in chips)
Seat 5: 4c077ac6 ($12.21 in chips)
Seat 6: 6508fb99 ($13.22 in chips)
ed488d2d: posts small blind $0.1
81765e66: posts big blind $0.25
*** HOLE CARDS ***
Dealt to Hero [Ad 6h]
Dealt to ed488d2d 
Dealt to 81765e66 
Dealt to 3423a84d 
Dealt to 4c077ac6 
Dealt to 6508fb99 
3423a84d: folds
4c077ac6: raises $0.25 to $0.5
6508fb99: folds
Hero: folds
ed488d2d: folds
81765e66: folds
Uncalled bet ($0.25) returned to 4c077ac6
*** SHOWDOWN ***
4c077ac6 collected $0.6 from pot
*** SUMMARY ***
Total pot $0.6
Seat 1: Hero (button) folded before Flop (didn't bet)
Seat 2: ed488d2d (small blind) folded before Flop
Seat 3: 81765e66 (big blind) folded before Flop
Seat 4: 3423a84d folded before Flop (didn't bet)
Seat 5: 4c077ac6 collected ($0.6)
Seat 6: 6508fb99 folded before Flop (didn't bet)


Poker Hand #RC95102057: Hold'em No Limit ($0.1/$0.25) - 2020/04/07 15:53:25
Table 'RushAndCash366251' 6-max Seat #1 is the button
Seat 1: d07b3de1 ($37.93 in chips)
Seat 2: Hero ($60.07 in chips)
Seat 3: fc8a29ea ($55.24 in chips)
Seat 4: d9a04cfb ($25.35 in chips)
Seat 5: a4ba858f ($36.38 in chips)
Seat 6: e1071a91 ($25 in chips)
Hero: posts small blind $0.1
fc8a29ea: posts big blind $0.25
*** HOLE CARDS ***
Dealt to d07b3de1 
Dealt to Hero [Td 7c]
Dealt to fc8a29ea 
Dealt to d9a04cfb 
Dealt to a4ba858f 
Dealt to e1071a91 
d9a04cfb: folds
a4ba858f: folds
e1071a91: folds
d07b3de1: folds
Hero: folds
Uncalled bet ($0.15) returned to fc8a29ea
*** SHOWDOWN ***
fc8a29ea collected $0.2 from pot
*** SUMMARY ***
Total pot $0.2
Seat 1: d07b3de1 (button) folded before Flop (didn't bet)
Seat 2: Hero (small blind) folded before Flop
Seat 3: fc8a29ea (big blind) collected ($0.2)
Seat 4: d9a04cfb folded before Flop (didn't bet)
Seat 5: a4ba858f folded before Flop (didn't bet)
Seat 6: e1071a91 folded before Flop (didn't bet)


Poker Hand #RC95102084: Hold'em No Limit ($0.1/$0.25) - 2020/04/07 15:53:29
Table 'RushAndCash366254' 6-max Seat #1 is the button
Seat 1: e1071a91 ($25 in chips)
Seat 2: 811232a3 ($35.68 in chips)
Seat 3: 44d6b861 ($25.44 in chips)
Seat 4: Hero ($59.97 in chips)
Seat 5: 9a4fbdbb ($14.24 in chips)
Seat 6: 492c0086 ($15.86 in chips)
811232a3: posts small blind $0.1
44d6b861: posts big blind $0.25
*** HOLE CARDS ***
Dealt to e1071a91 
Dealt to 811232a3 
Dealt to 44d6b861 
Dealt to Hero [9s 4s]
Dealt to 9a4fbdbb 
Dealt to 492c0086 
Hero: folds
9a4fbdbb: folds
492c0086: folds
e1071a91: raises $0.38 to $0.63
811232a3: folds
44d6b861: folds
Uncalled bet ($0.38) returned to e1071a91
*** SHOWDOWN ***
e1071a91 collected $0.6 from pot
*** SUMMARY ***
Total pot $0.6
Seat 1: e1071a91 (button) collected ($0.6)
Seat 2: 811232a3 (small blind) folded before Flop
Seat 3: 44d6b861 (big blind) folded before Flop
Seat 4: Hero folded before Flop (didn't bet)
Seat 5: 9a4fbdbb folded before Flop (didn't bet)
Seat 6: 492c0086 folded before Flop (didn't bet)


Poker Hand #RC95102118: Hold'em No Limit ($0.1/$0.25) - 2020/04/07 15:53:33
Table 'RushAndCash366258' 6-max Seat #1 is the button
Seat 1: e131407f ($25.82 in chips)
Seat 2: 4aa8d4e8 ($12.5 in chips)
Seat 3: Hero ($59.97 in chips)
Seat 4: 403fa816 ($5.43 in chips)
Seat 5: 275e7f74 ($26.06 in chips)
Seat 6: 22be9faa ($7.57 in chips)
4aa8d4e8: posts small blind $0.1
Hero: posts big blind $0.25
*** HOLE CARDS ***
Dealt to e131407f 
Dealt to 4aa8d4e8 
Dealt to Hero [Jc 8c]
Dealt to 403fa816 
Dealt to 275e7f74 
Dealt to 22be9faa 
403fa816: folds
275e7f74: raises $0.38 to $0.63
22be9faa: folds
e131407f: folds
4aa8d4e8: folds
Hero: folds
Uncalled bet ($0.38) returned to 275e7f74
*** SHOWDOWN ***
275e7f74 collected $0.6 from pot
*** SUMMARY ***
Total pot $0.6
Seat 1: e131407f (button) folded before Flop (didn't bet)
Seat 2: 4aa8d4e8 (small blind) folded before Flop
Seat 3: Hero (big blind) folded before Flop
Seat 4: 403fa816 folded before Flop (didn't bet)
Seat 5: 275e7f74 collected ($0.6)
Seat 6: 22be9faa folded before Flop (didn't bet)


Poker Hand #RC95102285: Hold'em No Limit ($0.1/$0.25) - 2020/04/07 15:53:54
Table 'RushAndCash366280' 6-max Seat #1 is the button
Seat 1: f178c62c ($31.46 in chips)
Seat 2: 91db230c ($25.1 in chips)
Seat 3: 9a4fbdbb ($14.24 in chips)
Seat 4: Hero ($59.72 in chips)
Seat 5: d2986703 ($38.03 in chips)
Seat 6: adb51d54 ($28.19 in chips)
91db230c: posts small blind $0.1
9a4fbdbb: posts big blind $0.25
*** HOLE CARDS ***
Dealt to f178c62c 
Dealt to 91db230c 
Dealt to 9a4fbdbb 
Dealt to Hero [Qd 3h]
Dealt to d2986703 
Dealt to adb51d54 
Hero: folds
d2986703: folds
adb51d54: folds
f178c62c: folds
91db230c: folds
Uncalled bet ($0.15) returned to 9a4fbdbb
*** SHOWDOWN ***
9a4fbdbb collected $0.2 from pot
*** SUMMARY ***
Total pot $0.2
Seat 1: f178c62c (button) folded before Flop (didn't bet)
Seat 2: 91db230c (small blind) folded before Flop
Seat 3: 9a4fbdbb (big blind) collected ($0.2)
Seat 4: Hero folded before Flop (didn't bet)
Seat 5: d2986703 folded before Flop (didn't bet)
Seat 6: adb51d54 folded before Flop (didn't bet)


Poker Hand #RC95102435: Hold'em No Limit ($0.1/$0.25) - 2020/04/07 15:54:14
Table 'RushAndCash366300' 6-max Seat #1 is the button
Seat 1: 6736194e ($28.98 in chips)
Seat 2: 6bf543f8 ($25.85 in chips)
Seat 3: bc3db224 ($43.27 in chips)
Seat 4: Hero ($59.72 in chips)
Seat 5: 91db230c ($25 in chips)
Seat 6: e131407f ($25.72 in chips)
6bf543f8: posts small blind $0.1
bc3db224: posts big blind $0.25
*** HOLE CARDS ***
Dealt to 6736194e 
Dealt to 6bf543f8 
Dealt to bc3db224 
Dealt to Hero [8h 6d]
Dealt to 91db230c 
Dealt to e131407f 
Hero: folds
91db230c: folds
e131407f: folds
6736194e: raises $0.75 to $1
6bf543f8: folds
bc3db224: calls $0.75
*** FLOP *** [Kd 2d 3d]
bc3db224: checks
6736194e: checks
*** TURN *** [Kd 2d 3d] [6s]
bc3db224: bets $1
6736194e: calls $1
*** RIVER *** [Kd 2d 3d 6s] [8c]
bc3db224: bets $3
6736194e: calls $3
bc3db224: shows [Th Ad] (Ace-High)
6736194e: shows [Qs Ks] (Pair of Kings)
*** SHOWDOWN ***
6736194e collected $10.1 from pot
*** SUMMARY ***
Total pot $10.1
Board [Kd 2d 3d 6s 8c]
Seat 1: 6736194e (button) showed [Ks Qs] and won ($10.1) with Pair of Kings
Seat 2: 6bf543f8 (small blind) folded before Flop
Seat 3: bc3db224 (big blind) showed [Ad Th] and lost with Ace-High
Seat 4: Hero folded before Flop (didn't bet)
Seat 5: 91db230c folded before Flop (didn't bet)
Seat 6: e131407f folded before Flop (didn't bet)


Poker Hand #RC95102465: Hold'em No Limit ($0.1/$0.25) - 2020/04/07 15:54:18
Table 'RushAndCash366303' 6-max Seat #1 is the button
Seat 1: 7441dc97 ($26.9 in chips)
Seat 2: 3423a84d ($50.24 in chips)
Seat 3: 6bf543f8 ($25.75 in chips)
Seat 4: 62eebc49 ($109.76 in chips)
Seat 5: f5b7e608 ($11.72 in chips)
Seat 6: Hero ($59.72 in chips)
3423a84d: posts small blind $0.1
6bf543f8: posts big blind $0.25
*** HOLE CARDS ***
Dealt to 7441dc97 
Dealt to 3423a84d 
Dealt to 6bf543f8 
Dealt to 62eebc49 
Dealt to f5b7e608 
Dealt to Hero [9d 8s]
62eebc49: folds
f5b7e608: raises $0.38 to $0.63
Hero: folds
7441dc97: folds
3423a84d: folds
6bf543f8: folds
Uncalled bet ($0.38) returned to f5b7e608
*** SHOWDOWN ***
f5b7e608 collected $0.6 from pot
*** SUMMARY ***
Total pot $0.6
Seat 1: 7441dc97 (button) folded before Flop (didn't bet)
Seat 2: 3423a84d (small blind) folded before Flop
Seat 3: 6bf543f8 (big blind) folded before Flop
Seat 4: 62eebc49 folded before Flop (didn't bet)
Seat 5: f5b7e608 collected ($0.6)
Seat 6: Hero folded before Flop (didn't bet)


Poker Hand #RC95102637: Hold'em No Limit ($0.1/$0.25) - 2020/04/07 15:54:42
Table 'RushAndCash366322' 6-max Seat #1 is the button
Seat 1: 8b8d197c ($34.47 in chips)
Seat 2: Hero ($59.72 in chips)
Seat 3: 4aa8d4e8 ($12.5 in chips)
Seat 4: e1071a91 ($25 in chips)
Seat 5: 6bf543f8 ($25.5 in chips)
Seat 6: 181b6319 ($25 in chips)
Hero: posts small blind $0.1
4aa8d4e8: posts big blind $0.25
*** HOLE CARDS ***
Dealt to 8b8d197c 
Dealt to Hero [Kc 9c]
Dealt to 4aa8d4e8 
Dealt to e1071a91 
Dealt to 6bf543f8 
Dealt to 181b6319 
e1071a91: folds
6bf543f8: folds
181b6319: folds
8b8d197c: raises $0.38 to $0.63
Hero: calls $0.53
4aa8d4e8: folds
*** FLOP *** [Ks Qc 2c]
Hero: checks
8b8d197c: checks
*** TURN *** [Ks Qc 2c] [9d]
Hero: bets $1.6
8b8d197c: folds
Uncalled bet ($1.6) returned to Hero
*** SHOWDOWN ***
Hero collected $1.51 from pot
*** SUMMARY ***
Total pot $1.51
Board [Ks Qc 2c 9d]
Seat 1: 8b8d197c (button) folded on the Turn
Seat 2: Hero (small blind) won ($1.51)
Seat 3: 4aa8d4e8 (big blind) folded before Flop
Seat 4: e1071a91 folded before Flop (didn't bet)
Seat 5: 6bf543f8 folded before Flop (didn't bet)
Seat 6: 181b6319 folded before Flop (didn't bet)


Poker Hand #RC95103030: Hold'em No Limit ($0.1/$0.25) - 2020/04/07 15:55:34
Table 'RushAndCash366368' 6-max Seat #1 is the button
Seat 1: ea254934 ($16.76 in chips)
Seat 2: 45920dbc ($77.61 in chips)
Seat 3: b56c4622 ($24.92 in chips)
Seat 4: 40a91d41 ($25 in chips)
Seat 5: Hero ($60.53 in chips)
Seat 6: 4dd920ba ($83.93 in chips)
45920dbc: posts small blind $0.1
b56c4622: posts big blind $0.25
*** HOLE CARDS ***
Dealt to ea254934 
Dealt to 45920dbc 
Dealt to b56c4622 
Dealt to 40a91d41 
Dealt to Hero [Jc 4d]
Dealt to 4dd920ba 
40a91d41: folds
Hero: folds
4dd920ba: folds
ea254934: folds
45920dbc: folds
Uncalled bet ($0.15) returned to b56c4622
*** SHOWDOWN ***
b56c4622 collected $0.2 from pot
*** SUMMARY ***
Total pot $0.2
Seat 1: ea254934 (button) folded before Flop (didn't bet)
Seat 2: 45920dbc (small blind) folded before Flop
Seat 3: b56c4622 (big blind) collected ($0.2)
Seat 4: 40a91d41 folded before Flop (didn't bet)
Seat 5: Hero folded before Flop (didn't bet)
Seat 6: 4dd920ba folded before Flop (didn't bet)


Poker Hand #RC95103053: Hold'em No Limit ($0.1/$0.25) - 2020/04/07 15:55:37
Table 'RushAndCash366370' 6-max Seat #1 is the button
Seat 1: be3950eb ($27.9 in chips)
Seat 2: d9a04cfb ($25 in chips)
Seat 3: 9a4fbdbb ($14.49 in chips)
Seat 4: bdffd813 ($26.91 in chips)
Seat 5: 5d2a310d ($5.79 in chips)
Seat 6: Hero ($60.53 in chips)
d9a04cfb: posts small blind $0.1
9a4fbdbb: posts big blind $0.25
*** HOLE CARDS ***
Dealt to be3950eb 
Dealt to d9a04cfb 
Dealt to 9a4fbdbb 
Dealt to bdffd813 
Dealt to 5d2a310d 
Dealt to Hero [8c 7c]
bdffd813: folds
5d2a310d: raises $0.63 to $0.88
Hero: folds
be3950eb: folds
d9a04cfb: folds
9a4fbdbb: folds
Uncalled bet ($0.63) returned to 5d2a310d
*** SHOWDOWN ***
5d2a310d collected $0.6 from pot
*** SUMMARY ***
Total pot $0.6
Seat 1: be3950eb (button) folded before Flop (didn't bet)
Seat 2: d9a04cfb (small blind) folded before Flop
Seat 3: 9a4fbdbb (big blind) folded before Flop
Seat 4: bdffd813 folded before Flop (didn't bet)
Seat 5: 5d2a310d collected ($0.6)
Seat 6: Hero folded before Flop (didn't bet)


Poker Hand #RC95103209: Hold'em No Limit ($0.1/$0.25) - 2020/04/07 15:55:57
Table 'RushAndCash366390' 6-max Seat #1 is the button
Seat 1: 3dafe47e ($14.2 in chips)
Seat 2: aabcb588 ($25 in chips)
Seat 3: 2d45ce80 ($11.09 in chips)
Seat 4: acf1a889 ($22.3 in chips)
Seat 5: Hero ($60.53 in chips)
Seat 6: 4ab4e4a3 ($25 in chips)
aabcb588: posts small blind $0.1
2d45ce80: posts big blind $0.25
*** HOLE CARDS ***
Dealt to 3dafe47e 
Dealt to aabcb588 
Dealt to 2d45ce80 
Dealt to acf1a889 
Dealt to Hero [6d 3s]
Dealt to 4ab4e4a3 
acf1a889: raises $0.38 to $0.63
Hero: folds
4ab4e4a3: folds
3dafe47e: folds
aabcb588: folds
2d45ce80: folds
Uncalled bet ($0.38) returned to acf1a889
*** SHOWDOWN ***
acf1a889 collected $0.6 from pot
*** SUMMARY ***
Total pot $0.6
Seat 1: 3dafe47e (button) folded before Flop (didn't bet)
Seat 2: aabcb588 (small blind) folded before Flop
Seat 3: 2d45ce80 (big blind) folded before Flop
Seat 4: acf1a889 collected ($0.6)
Seat 5: Hero folded before Flop (didn't bet)
Seat 6: 4ab4e4a3 folded before Flop (didn't bet)


Poker Hand #RC95103234: Hold'em No Limit ($0.1/$0.25) - 2020/04/07 15:56:00
Table 'RushAndCash366393' 6-max Seat #1 is the button
Seat 1: Hero ($60.53 in chips)
Seat 2: bad0409c ($15.4 in chips)
Seat 3: bdffd813 ($26.81 in chips)
Seat 4: 98ddea23 ($13.01 in chips)
Seat 5: 6736194e ($33.58 in chips)
Seat 6: d6f2a39c ($3.07 in chips)
bad0409c: posts small blind $0.1
bdffd813: posts big blind $0.25
*** HOLE CARDS ***
Dealt to Hero [Kh 4h]
Dealt to bad0409c 
Dealt to bdffd813 
Dealt to 98ddea23 
Dealt to 6736194e 
Dealt to d6f2a39c 
98ddea23: folds
6736194e: folds
d6f2a39c: raises $2.82 to $3.07 and is all-in
Hero: folds
bad0409c: folds
bdffd813: folds
Uncalled bet ($2.82) returned to d6f2a39c
*** SHOWDOWN ***
d6f2a39c collected $0.6 from pot
*** SUMMARY ***
Total pot $0.6
Seat 1: Hero (button) folded before Flop (didn't bet)
Seat 2: bad0409c (small blind) folded before Flop
Seat 3: bdffd813 (big blind) folded before Flop
Seat 4: 98ddea23 folded before Flop (didn't bet)
Seat 5: 6736194e folded before Flop (didn't bet)
Seat 6: d6f2a39c collected ($0.6)


Poker Hand #RC95103274: Hold'em No Limit ($0.1/$0.25) - 2020/04/07 15:56:05
Table 'RushAndCash366398' 6-max Seat #1 is the button
Seat 1: be711e9d ($32.42 in chips)
Seat 2: be3950eb ($27.9 in chips)
Seat 3: Hero ($60.53 in chips)
Seat 4: b56c4622 ($25.02 in chips)
Seat 5: 2dd038c3 ($11.75 in chips)
Seat 6: da17c979 ($12.5 in chips)
be3950eb: posts small blind $0.1
Hero: posts big blind $0.25
*** HOLE CARDS ***
Dealt to be711e9d 
Dealt to be3950eb 
Dealt to Hero [Ah Qc]
Dealt to b56c4622 
Dealt to 2dd038c3 
Dealt to da17c979 
b56c4622: folds
2dd038c3: folds
da17c979: folds
be711e9d: folds
be3950eb: folds
Uncalled bet ($0.15) returned to Hero
*** SHOWDOWN ***
Hero collected $0.2 from pot
*** SUMMARY ***
Total pot $0.2
Seat 1: be711e9d (button) folded before Flop (didn't bet)
Seat 2: be3950eb (small blind) folded before Flop
Seat 3: Hero (big blind) collected ($0.2)
Seat 4: b56c4622 folded before Flop (didn't bet)
Seat 5: 2dd038c3 folded before Flop (didn't bet)
Seat 6: da17c979 folded before Flop (didn't bet)


Poker Hand #RC95103361: Hold'em No Limit ($0.1/$0.25) - 2020/04/07 15:56:17
Table 'RushAndCash366408' 6-max Seat #1 is the button
Seat 1: Hero ($60.63 in chips)
Seat 2: 2dd038c3 ($11.75 in chips)
Seat 3: bc3db224 ($38.87 in chips)
Seat 4: a4ba858f ($47.78 in chips)
Seat 5: 6f1c538f ($26.19 in chips)
Seat 6: 103129d8 ($34.11 in chips)
2dd038c3: posts small blind $0.1
bc3db224: posts big blind $0.25
*** HOLE CARDS ***
Dealt to Hero [8c 4h]
Dealt to 2dd038c3 
Dealt to bc3db224 
Dealt to a4ba858f 
Dealt to 6f1c538f 
Dealt to 103129d8 
a4ba858f: folds
6f1c538f: raises $0.38 to $0.63
103129d8: folds
Hero: folds
2dd038c3: folds
bc3db224: folds
Uncalled bet ($0.38) returned to 6f1c538f
*** SHOWDOWN ***
6f1c538f collected $0.6 from pot
*** SUMMARY ***
Total pot $0.6
Seat 1: Hero (button) folded before Flop (didn't bet)
Seat 2: 2dd038c3 (small blind) folded before Flop
Seat 3: bc3db224 (big blind) folded before Flop
Seat 4: a4ba858f folded before Flop (didn't bet)
Seat 5: 6f1c538f collected ($0.6)
Seat 6: 103129d8 folded before Flop (didn't bet)


Poker Hand #RC95103399: Hold'em No Limit ($0.1/$0.25) - 2020/04/07 15:56:22
Table 'RushAndCash366414' 6-max Seat #1 is the button
Seat 1: be711e9d ($32.42 in chips)
Seat 2: 8372bca9 ($25 in chips)
Seat 3: d2986703 ($39.3 in chips)
Seat 4: 91db230c ($26.46 in chips)
Seat 5: ec1c524d ($25.65 in chips)
Seat 6: Hero ($60.63 in chips)
8372bca9: posts small blind $0.1
d2986703: posts big blind $0.25
*** HOLE CARDS ***
Dealt to be711e9d 
Dealt to 8372bca9 
Dealt to d2986703 
Dealt to 91db230c 
Dealt to ec1c524d 
Dealt to Hero [Jc 2s]
91db230c: folds
ec1c524d: raises $0.38 to $0.63
Hero: folds
be711e9d: folds
8372bca9: folds
d2986703: folds
Uncalled bet ($0.38) returned to ec1c524d
*** SHOWDOWN ***
ec1c524d collected $0.6 from pot
*** SUMMARY ***
Total pot $0.6
Seat 1: be711e9d (button) folded before Flop (didn't bet)
Seat 2: 8372bca9 (small blind) folded before Flop
Seat 3: d2986703 (big blind) folded before Flop
Seat 4: 91db230c folded before Flop (didn't bet)
Seat 5: ec1c524d collected ($0.6)
Seat 6: Hero folded before Flop (didn't bet)


Poker Hand #RC95103429: Hold'em No Limit ($0.1/$0.25) - 2020/04/07 15:56:25
Table 'RushAndCash366417' 6-max Seat #1 is the button
Seat 1: 62eebc49 ($109.66 in chips)
Seat 2: ea254934 ($15.88 in chips)
Seat 3: 488a0674 ($25 in chips)
Seat 4: acf1a889 ($22.65 in chips)
Seat 5: bc3db224 ($38.62 in chips)
Seat 6: Hero ($60.63 in chips)
ea254934: posts small blind $0.1
488a0674: posts big blind $0.25
*** HOLE CARDS ***
Dealt to 62eebc49 
Dealt to ea254934 
Dealt to 488a0674 
Dealt to acf1a889 
Dealt to bc3db224 
Dealt to Hero [Ks 6c]
acf1a889: raises $0.38 to $0.63
bc3db224: folds
Hero: folds
62eebc49: folds
ea254934: folds
488a0674: folds
Uncalled bet ($0.38) returned to acf1a889
*** SHOWDOWN ***
acf1a889 collected $0.6 from pot
*** SUMMARY ***
Total pot $0.6
Seat 1: 62eebc49 (button) folded before Flop (didn't bet)
Seat 2: ea254934 (small blind) folded before Flop
Seat 3: 488a0674 (big blind) folded before Flop
Seat 4: acf1a889 collected ($0.6)
Seat 5: bc3db224 folded before Flop (didn't bet)
Seat 6: Hero folded before Flop (didn't bet)


Poker Hand #RC95103466: Hold'em No Limit ($0.1/$0.25) - 2020/04/07 15:56:30
Table 'RushAndCash366421' 6-max Seat #1 is the button
Seat 1: ed488d2d ($15.38 in chips)
Seat 2: Hero ($60.63 in chips)
Seat 3: 4ab4e4a3 ($25 in chips)
Seat 4: f5b7e608 ($13.06 in chips)
Seat 5: 2d45ce80 ($10.84 in chips)
Seat 6: fb4a5e69 ($26.03 in chips)
Hero: posts small blind $0.1
4ab4e4a3: posts big blind $0.25
*** HOLE CARDS ***
Dealt to ed488d2d 
Dealt to Hero [9c 7d]
Dealt to 4ab4e4a3 
Dealt to f5b7e608 
Dealt to 2d45ce80 
Dealt to fb4a5e69 
f5b7e608: folds
2d45ce80: folds
fb4a5e69: folds
ed488d2d: folds
Hero: folds
Uncalled bet ($0.15) returned to 4ab4e4a3
*** SHOWDOWN ***
4ab4e4a3 collected $0.2 from pot
*** SUMMARY ***
Total pot $0.2
Seat 1: ed488d2d (button) folded before Flop (didn't bet)
Seat 2: Hero (small blind) folded before Flop
Seat 3: 4ab4e4a3 (big blind) collected ($0.2)
Seat 4: f5b7e608 folded before Flop (didn't bet)
Seat 5: 2d45ce80 folded before Flop (didn't bet)
Seat 6: fb4a5e69 folded before Flop (didn't bet)


Poker Hand #RC95103502: Hold'em No Limit ($0.1/$0.25) - 2020/04/07 15:56:34
Table 'RushAndCash366425' 6-max Seat #1 is the button
Seat 1: 62eebc49 ($109.66 in chips)
Seat 2: 57ff778 ($28.86 in chips)
Seat 3: Hero ($60.53 in chips)
Seat 4: 2dd038c3 ($11.65 in chips)
Seat 5: fb4a5e69 ($26.03 in chips)
Seat 6: 9a4fbdbb ($15.05 in chips)
57ff778: posts small blind $0.1
Hero: posts big blind $0.25
*** HOLE CARDS ***
Dealt to 62eebc49 
Dealt to 57ff778 
Dealt to Hero [Kc 2c]
Dealt to 2dd038c3 
Dealt to fb4a5e69 
Dealt to 9a4fbdbb 
2dd038c3: folds
fb4a5e69: folds
9a4fbdbb: folds
62eebc49: raises $0.38 to $0.63
57ff778: raises $2.12 to $2.75
Hero: folds
62eebc49: calls $2.12
*** FLOP *** [4c 4d 3c]
57ff778: bets $2.5
62eebc49: calls $2.5
*** TURN *** [4c 4d 3c] [3h]
57ff778: bets $6
62eebc49: folds
Uncalled bet ($6) returned to 57ff778
*** SHOWDOWN ***
57ff778 collected $10.75 from pot
*** SUMMARY ***
Total pot $10.75
Board [4c 4d 3c 3h]
Seat 1: 62eebc49 (button) folded on the Turn
Seat 2: 57ff778 (small blind) won ($10.75)
Seat 3: Hero (big blind) folded before Flop
Seat 4: 2dd038c3 folded before Flop (didn't bet)
Seat 5: fb4a5e69 folded before Flop (didn't bet)
Seat 6: 9a4fbdbb folded before Flop (didn't bet)


Poker Hand #RC95103526: Hold'em No Limit ($0.1/$0.25) - 2020/04/07 15:56:37
Table 'RushAndCash366428' 6-max Seat #1 is the button
Seat 1: 8372bca9 ($25 in chips)
Seat 2: d2986703 ($39.05 in chips)
Seat 3: bad0409c ($15.3 in chips)
Seat 4: f5b7e608 ($13.06 in chips)
Seat 5: 24755d41 ($14.34 in chips)
Seat 6: Hero ($60.28 in chips)
d2986703: posts small blind $0.1
bad0409c: posts big blind $0.25
*** HOLE CARDS ***
Dealt to 8372bca9 
Dealt to d2986703 
Dealt to bad0409c 
Dealt to f5b7e608 
Dealt to 24755d41 
Dealt to Hero [Th 8h]
f5b7e608: folds
24755d41: folds
Hero: raises $0.38 to $0.63
8372bca9: folds
d2986703: folds
bad0409c: calls $0.38
*** FLOP *** [Ah 3d Ts]
bad0409c: checks
Hero: bets $0.92
bad0409c: raises $1.58 to $2.5
Hero: folds
Uncalled bet ($1.58) returned to bad0409c
*** SHOWDOWN ***
bad0409c collected $3.2 from pot
*** SUMMARY ***
Total pot $3.2
Board [Ah 3d Ts]
Seat 1: 8372bca9 (button) folded before Flop (didn't bet)
Seat 2: d2986703 (small blind) folded before Flop
Seat 3: bad0409c (big blind) won ($3.2)
Seat 4: f5b7e608 folded before Flop (didn't bet)
Seat 5: 24755d41 folded before Flop (didn't bet)
Seat 6: Hero folded on the Flop


Poker Hand #RC95103857: Hold'em No Limit ($0.1/$0.25) - 2020/04/07 15:57:19
Table 'RushAndCash366469' 6-max Seat #1 is the button
Seat 1: d6f2a39c ($5.87 in chips)
Seat 2: 811232a3 ($33.27 in chips)
Seat 3: ac90cf4e ($7.35 in chips)
Seat 4: Hero ($58.73 in chips)
Seat 5: dbf6981f ($46.54 in chips)
Seat 6: 275e7f74 ($35.12 in chips)
811232a3: posts small blind $0.1
ac90cf4e: posts big blind $0.25
*** HOLE CARDS ***
Dealt to d6f2a39c 
Dealt to 811232a3 
Dealt to ac90cf4e 
Dealt to Hero [Kc 6c]
Dealt to dbf6981f 
Dealt to 275e7f74 
Hero: folds
dbf6981f: folds
275e7f74: folds
d6f2a39c: folds
811232a3: raises $0.38 to $0.63
ac90cf4e: calls $0.38
*** FLOP *** [Kd Ts Qc]
811232a3: bets $0.5
ac90cf4e: folds
Uncalled bet ($0.5) returned to 811232a3
*** SHOWDOWN ***
811232a3 collected $1.26 from pot
*** SUMMARY ***
Total pot $1.26
Board [Kd Ts Qc]
Seat 1: d6f2a39c (button) folded before Flop (didn't bet)
Seat 2: 811232a3 (small blind) won ($1.26)
Seat 3: ac90cf4e (big blind) folded on the Flop
Seat 4: Hero folded before Flop (didn't bet)
Seat 5: dbf6981f folded before Flop (didn't bet)
Seat 6: 275e7f74 folded before Flop (didn't bet)


Poker Hand #RC95103892: Hold'em No Limit ($0.1/$0.25) - 2020/04/07 15:57:23
Table 'RushAndCash366474' 6-max Seat #1 is the button
Seat 1: baf670cf ($9.19 in chips)
Seat 2: 7c935d24 ($25 in chips)
Seat 3: Hero ($58.73 in chips)
Seat 4: 38e0f2fb ($24.27 in chips)
Seat 5: 6508fb99 ($11.26 in chips)
Seat 6: fb4a5e69 ($25.68 in chips)
7c935d24: posts small blind $0.1
Hero: posts big blind $0.25
*** HOLE CARDS ***
Dealt to baf670cf 
Dealt to 7c935d24 
Dealt to Hero [8s 3d]
Dealt to 38e0f2fb 
Dealt to 6508fb99 
Dealt to fb4a5e69 
38e0f2fb: folds
6508fb99: folds
fb4a5e69: folds
baf670cf: folds
7c935d24: folds
Uncalled bet ($0.15) returned to Hero
*** SHOWDOWN ***
Hero collected $0.2 from pot
*** SUMMARY ***
Total pot $0.2
Seat 1: baf670cf (button) folded before Flop (didn't bet)
Seat 2: 7c935d24 (small blind) folded before Flop
Seat 3: Hero (big blind) collected ($0.2)
Seat 4: 38e0f2fb folded before Flop (didn't bet)
Seat 5: 6508fb99 folded before Flop (didn't bet)
Seat 6: fb4a5e69 folded before Flop (didn't bet)


Poker Hand #RC95103917: Hold'em No Limit ($0.1/$0.25) - 2020/04/07 15:57:27
Table 'RushAndCash366477' 6-max Seat #1 is the button
Seat 1: 7441dc97 ($30.78 in chips)
Seat 2: Hero ($58.48 in chips)
Seat 3: 275e7f74 ($34.87 in chips)
Seat 4: 6508fb99 ($11.26 in chips)
Seat 5: ea254934 ($15.78 in chips)
Seat 6: 2aaed573 ($11.3 in chips)
Hero: posts small blind $0.1
275e7f74: posts big blind $0.25
*** HOLE CARDS ***
Dealt to 7441dc97 
Dealt to Hero [Kc 6s]
Dealt to 275e7f74 
Dealt to 6508fb99 
Dealt to ea254934 
Dealt to 2aaed573 
6508fb99: folds
ea254934: folds
2aaed573: raises $0.38 to $0.63
7441dc97: calls $0.63
Hero: folds
275e7f74: calls $0.38
*** FLOP *** [8s 8d 9s]
275e7f74: checks
2aaed573: bets $1.5
7441dc97: calls $1.5
275e7f74: raises $4.05 to $5.55
2aaed573: folds
7441dc97: calls $4.05
*** TURN *** [8s 8d 9s] [6h]
275e7f74: bets $6.4
7441dc97: raises $8.6 to $15
275e7f74: calls $8.6
*** RIVER *** [8s 8d 9s 6h] [Td]
275e7f74: bets $13.69 and is all-in
7441dc97: calls $9.6 and is all-in
Uncalled bet ($4.09) returned to 275e7f74
275e7f74: shows [Js Qs] (Queens-High Straight)
7441dc97: shows [Ts 7s] (Tens-High Straight)
*** SHOWDOWN ***
275e7f74 collected $63.79 from pot
*** SUMMARY ***
Total pot $63.79
Board [8s 8d 9s 6h Td]
Seat 1: 7441dc97 (button) showed [Ts 7s] and lost with Tens-High Straight
Seat 2: Hero (small blind) folded before Flop
Seat 3: 275e7f74 (big blind) showed [Qs Js] and won ($63.79) with Queens-High Straight
Seat 4: 6508fb99 folded before Flop (didn't bet)
Seat 5: ea254934 folded before Flop (didn't bet)
Seat 6: 2aaed573 folded on the Flop


Poker Hand #RC95103941: Hold'em No Limit ($0.1/$0.25) - 2020/04/07 15:57:30
Table 'RushAndCash366479' 6-max Seat #1 is the button
Seat 1: Hero ($58.38 in chips)
Seat 2: d6f2a39c ($5.87 in chips)
Seat 3: 4dd920ba ($85.6 in chips)
Seat 4: baf670cf ($9.19 in chips)
Seat 5: 181b6319 ($23.9 in chips)
Seat 6: be3950eb ($25.7 in chips)
d6f2a39c: posts small blind $0.1
4dd920ba: posts big blind $0.25
*** HOLE CARDS ***
Dealt to Hero [Qh 2h]
Dealt to d6f2a39c 
Dealt to 4dd920ba 
Dealt to baf670cf 
Dealt to 181b6319 
Dealt to be3950eb 
baf670cf: raises $0.25 to $0.5
181b6319: folds
be3950eb: folds
Hero: folds
d6f2a39c: folds
4dd920ba: calls $0.25
*** FLOP *** [8s Qc 3h]
4dd920ba: checks
baf670cf: bets $0.85
4dd920ba: folds
Uncalled bet ($0.85) returned to baf670cf
*** SHOWDOWN ***
baf670cf collected $1.1 from pot
*** SUMMARY ***
Total pot $1.1
Board [8s Qc 3h]
Seat 1: Hero (button) folded before Flop (didn't bet)
Seat 2: d6f2a39c (small blind) folded before Flop
Seat 3: 4dd920ba (big blind) folded on the Flop
Seat 4: baf670cf won ($1.1)
Seat 5: 181b6319 folded before Flop (didn't bet)
Seat 6: be3950eb folded before Flop (didn't bet)


Poker Hand #RC95104013: Hold'em No Limit ($0.1/$0.25) - 2020/04/07 15:57:40
Table 'RushAndCash366487' 6-max Seat #1 is the button
Seat 1: 7c935d24 ($25 in chips)
Seat 2: d6f2a39c ($5.77 in chips)
Seat 3: d9a04cfb ($27.17 in chips)
Seat 4: 61ad32d ($12.75 in chips)
Seat 5: Hero ($58.73 in chips)
Seat 6: 8b8d197c ($35.88 in chips)
d6f2a39c: posts small blind $0.1
d9a04cfb: posts big blind $0.25
*** HOLE CARDS ***
Dealt to 7c935d24 
Dealt to d6f2a39c 
Dealt to d9a04cfb 
Dealt to 61ad32d 
Dealt to Hero [8s 5h]
Dealt to 8b8d197c 
61ad32d: raises $0.5 to $0.75
Hero: folds
8b8d197c: folds
7c935d24: folds
d6f2a39c: folds
d9a04cfb: calls $0.5
*** FLOP *** [9s 2d 4c]
d9a04cfb: checks
61ad32d: bets $0.85
d9a04cfb: calls $0.85
*** TURN *** [9s 2d 4c] [Qd]
d9a04cfb: checks
61ad32d: bets $2.2
d9a04cfb: raises $5.8 to $8
61ad32d: raises $3.15 to $11.15 and is all-in
d9a04cfb: calls $3.15
61ad32d: shows [Tc Th] (Pair of Tens)
d9a04cfb: shows [9d 9c] (Three Nines)
*** FIRST RIVER *** [9s 2d 4c Qd] [4d]
*** SECOND RIVER *** [9s 2d 4c Qd] [3h]
*** FIRST SHOWDOWN ***
d9a04cfb collected $12.8 from pot
*** SECOND SHOWDOWN ***
d9a04cfb collected $12.8 from pot
*** SUMMARY ***
Total pot $25.6
Hand was run two times
FIRST Board [9s 2d 4c Qd 4d]
SECOND Board [9s 2d 4c Qd 3h]
Seat 1: 7c935d24 (button) folded before Flop (didn't bet)
Seat 2: d6f2a39c (small blind) folded before Flop
Seat 3: d9a04cfb (big blind) showed [9d 9c] and won ($12.8) with Nines Full over Fours, and won ($12.8) with Three Nines
Seat 4: 61ad32d showed [Th Tc] and lost with Pair of Tens and Pair of Fours, and lost with Pair of Tens
Seat 5: Hero folded before Flop (didn't bet)
Seat 6: 8b8d197c folded before Flop (didn't bet)


Poker Hand #RC95104029: Hold'em No Limit ($0.1/$0.25) - 2020/04/07 15:57:42
Table 'RushAndCash366489' 6-max Seat #1 is the button
Seat 1: 103129d8 ($35.17 in chips)
Seat 2: e131407f ($26.72 in chips)
Seat 3: a6846758 ($25.79 in chips)
Seat 4: adb51d54 ($25.71 in chips)
Seat 5: Hero ($58.73 in chips)
Seat 6: 2d45ce80 ($13.19 in chips)
e131407f: posts small blind $0.1
a6846758: posts big blind $0.25
*** HOLE CARDS ***
Dealt to 103129d8 
Dealt to e131407f 
Dealt to a6846758 
Dealt to adb51d54 
Dealt to Hero [Qd 9d]
Dealt to 2d45ce80 
adb51d54: folds
Hero: folds
2d45ce80: folds
103129d8: folds
e131407f: raises $0.5 to $0.75
a6846758: raises $1.5 to $2.25
e131407f: calls $1.5
*** FLOP *** [Jc 6s 2s]
e131407f: checks
a6846758: checks
*** TURN *** [Jc 6s 2s] [9s]
e131407f: bets $3.4
a6846758: folds
Uncalled bet ($3.4) returned to e131407f
*** SHOWDOWN ***
e131407f collected $4.5 from pot
*** SUMMARY ***
Total pot $4.5
Board [Jc 6s 2s 9s]
Seat 1: 103129d8 (button) folded before Flop (didn't bet)
Seat 2: e131407f (small blind) won ($4.5)
Seat 3: a6846758 (big blind) folded on the Turn
Seat 4: adb51d54 folded before Flop (didn't bet)
Seat 5: Hero folded before Flop (didn't bet)
Seat 6: 2d45ce80 folded before Flop (didn't bet)


Poker Hand #RC95104064: Hold'em No Limit ($0.1/$0.25) - 2020/04/07 15:57:47
Table 'RushAndCash366493' 6-max Seat #1 is the button
Seat 1: 1cf2736e ($28.95 in chips)
Seat 2: da17c979 ($12.5 in chips)
Seat 3: Hero ($58.73 in chips)
Seat 4: adb51d54 ($25.71 in chips)
Seat 5: ce59b684 ($39.13 in chips)
Seat 6: 6736194e ($32.3 in chips)
da17c979: posts small blind $0.1
Hero: posts big blind $0.25
*** HOLE CARDS ***
Dealt to 1cf2736e 
Dealt to da17c979 
Dealt to Hero [Jh 8s]
Dealt to adb51d54 
Dealt to ce59b684 
Dealt to 6736194e 
adb51d54: folds
ce59b684: folds
6736194e: raises $0.75 to $1
1cf2736e: folds
da17c979: folds
Hero: folds
Uncalled bet ($0.75) returned to 6736194e
*** SHOWDOWN ***
6736194e collected $0.6 from pot
*** SUMMARY ***
Total pot $0.6
Seat 1: 1cf2736e (button) folded before Flop (didn't bet)
Seat 2: da17c979 (small blind) folded before Flop
Seat 3: Hero (big blind) folded before Flop
Seat 4: adb51d54 folded before Flop (didn't bet)
Seat 5: ce59b684 folded before Flop (didn't bet)
Seat 6: 6736194e collected ($0.6)


Poker Hand #RC95104085: Hold'em No Limit ($0.1/$0.25) - 2020/04/07 15:57:50
Table 'RushAndCash366495' 6-max Seat #1 is the button
Seat 1: Hero ($58.48 in chips)
Seat 2: 36017ad1 ($47.59 in chips)
Seat 3: fe2378bf ($15.24 in chips)
Seat 4: 3423a84d ($43.69 in chips)
Seat 5: 103129d8 ($35.17 in chips)
Seat 6: d3a18552 ($12.6 in chips)
36017ad1: posts small blind $0.1
fe2378bf: posts big blind $0.25
*** HOLE CARDS ***
Dealt to Hero [Ks 4s]
Dealt to 36017ad1 
Dealt to fe2378bf 
Dealt to 3423a84d 
Dealt to 103129d8 
Dealt to d3a18552 
3423a84d: raises $0.25 to $0.5
103129d8: folds
d3a18552: folds
Hero: folds
36017ad1: folds
fe2378bf: folds
Uncalled bet ($0.25) returned to 3423a84d
*** SHOWDOWN ***
3423a84d collected $0.6 from pot
*** SUMMARY ***
Total pot $0.6
Seat 1: Hero (button) folded before Flop (didn't bet)
Seat 2: 36017ad1 (small blind) folded before Flop
Seat 3: fe2378bf (big blind) folded before Flop
Seat 4: 3423a84d collected ($0.6)
Seat 5: 103129d8 folded before Flop (didn't bet)
Seat 6: d3a18552 folded before Flop (didn't bet)


Poker Hand #RC95104171: Hold'em No Limit ($0.1/$0.25) - 2020/04/07 15:58:00
Table 'RushAndCash366507' 6-max Seat #1 is the button
Seat 1: eea83586 ($11.65 in chips)
Seat 2: Hero ($58.48 in chips)
Seat 3: 8c4d6eff ($39.12 in chips)
Seat 4: 6736194e ($32.65 in chips)
Seat 5: fe2378bf ($14.99 in chips)
Seat 6: 6185872b ($12.48 in chips)
Hero: posts small blind $0.1
8c4d6eff: posts big blind $0.25
*** HOLE CARDS ***
Dealt to eea83586 
Dealt to Hero [Jc 8h]
Dealt to 8c4d6eff 
Dealt to 6736194e 
Dealt to fe2378bf 
Dealt to 6185872b 
6736194e: calls $0.25
fe2378bf: calls $0.25
6185872b: raises $0.73 to $0.98
eea83586: folds
Hero: folds
8c4d6eff: calls $0.73
6736194e: calls $0.73
fe2378bf: calls $0.73
*** FLOP *** [2s 5c 8c]
8c4d6eff: checks
6736194e: checks
fe2378bf: checks
6185872b: checks
*** TURN *** [2s 5c 8c] [Tc]
8c4d6eff: checks
6736194e: checks
fe2378bf: checks
6185872b: checks
*** RIVER *** [2s 5c 8c Tc] [9s]
8c4d6eff: checks
6736194e: checks
fe2378bf: checks
6185872b: checks
8c4d6eff: shows [Kh Js] (King-High)
6736194e: shows [Jd Ad] (Ace-High)
fe2378bf: shows [3c 3h] (Pair of Treys)
6185872b: shows [Kd 7c] (King-High)
*** SHOWDOWN ***
fe2378bf collected $4.02 from pot
*** SUMMARY ***
Total pot $4.02
Board [2s 5c 8c Tc 9s]
Seat 1: eea83586 (button) folded before Flop (didn't bet)
Seat 2: Hero (small blind) folded before Flop
Seat 3: 8c4d6eff (big blind) showed [Kh Js] and lost with King-High
Seat 4: 6736194e showed [Ad Jd] and lost with Ace-High
Seat 5: fe2378bf showed [3h 3c] and won ($4.02) with Pair of Treys
Seat 6: 6185872b showed [Kd 7c] and lost with King-High


Poker Hand #RC95104199: Hold'em No Limit ($0.1/$0.25) - 2020/04/07 15:58:04
Table 'RushAndCash366511' 6-max Seat #1 is the button
Seat 1: ac90cf4e ($6.72 in chips)
Seat 2: Hero ($58.38 in chips)
Seat 3: 3423a84d ($44.04 in chips)
Seat 4: 99af0510 ($11.65 in chips)
Seat 5: 403fa816 ($8.75 in chips)
Seat 6: 811232a3 ($33.84 in chips)
Hero: posts small blind $0.1
3423a84d: posts big blind $0.25
*** HOLE CARDS ***
Dealt to ac90cf4e 
Dealt to Hero [Ts 4c]
Dealt to 3423a84d 
Dealt to 99af0510 
Dealt to 403fa816 
Dealt to 811232a3 
99af0510: folds
403fa816: folds
811232a3: folds
ac90cf4e: raises $0.25 to $0.5
Hero: folds
3423a84d: raises $1.5 to $2
ac90cf4e: calls $1.5
*** FLOP *** [5d 4s Ad]
3423a84d: bets $1.25
ac90cf4e: calls $1.25
*** TURN *** [5d 4s Ad] [Kh]
3423a84d: checks
ac90cf4e: checks
*** RIVER *** [5d 4s Ad Kh] [9h]
3423a84d: bets $0.5
ac90cf4e: calls $0.5
3423a84d: shows [As Kd] (Pair of Aces and Pair of Kings)
ac90cf4e: shows [2c Ac] (Pair of Aces)
*** SHOWDOWN ***
3423a84d collected $7.6 from pot
*** SUMMARY ***
Total pot $7.6
Board [5d 4s Ad Kh 9h]
Seat 1: ac90cf4e (button) showed [Ac 2c] and lost with Pair of Aces
Seat 2: Hero (small blind) folded before Flop
Seat 3: 3423a84d (big blind) showed [As Kd] and won ($7.6) with Pair of Aces and Pair of Kings
Seat 4: 99af0510 folded before Flop (didn't bet)
Seat 5: 403fa816 folded before Flop (didn't bet)
Seat 6: 811232a3 folded before Flop (didn't bet)


Poker Hand #RC95104218: Hold'em No Limit ($0.1/$0.25) - 2020/04/07 15:58:06
Table 'RushAndCash366514' 6-max Seat #1 is the button
Seat 1: 36017ad1 ($47.24 in chips)
Seat 2: 57ff778 ($33.58 in chips)
Seat 3: 2d45ce80 ($13.19 in chips)
Seat 4: Hero ($58.28 in chips)
Seat 5: 8ac4f082 ($25.32 in chips)
Seat 6: cdd7700a ($12.68 in chips)
57ff778: posts small blind $0.1
2d45ce80: posts big blind $0.25
*** HOLE CARDS ***
Dealt to 36017ad1 
Dealt to 57ff778 
Dealt to 2d45ce80 
Dealt to Hero [2s 2d]
Dealt to 8ac4f082 
Dealt to cdd7700a 
Hero: folds
8ac4f082: raises $0.38 to $0.63
cdd7700a: folds
36017ad1: folds
57ff778: folds
2d45ce80: folds
Uncalled bet ($0.38) returned to 8ac4f082
*** SHOWDOWN ***
8ac4f082 collected $0.6 from pot
*** SUMMARY ***
Total pot $0.6
Seat 1: 36017ad1 (button) folded before Flop (didn't bet)
Seat 2: 57ff778 (small blind) folded before Flop
Seat 3: 2d45ce80 (big blind) folded before Flop
Seat 4: Hero folded before Flop (didn't bet)
Seat 5: 8ac4f082 collected ($0.6)
Seat 6: cdd7700a folded before Flop (didn't bet)


Poker Hand #RC95104240: Hold'em No Limit ($0.1/$0.25) - 2020/04/07 15:58:09
Table 'RushAndCash366517' 6-max Seat #1 is the button
Seat 1: 4ab4e4a3 ($25 in chips)
Seat 2: 4aa8d4e8 ($12.5 in chips)
Seat 3: baf670cf ($9.74 in chips)
Seat 4: Hero ($58.28 in chips)
Seat 5: ec1c524d ($25.8 in chips)
Seat 6: eea83586 ($11.65 in chips)
4aa8d4e8: posts small blind $0.1
baf670cf: posts big blind $0.25
*** HOLE CARDS ***
Dealt to 4ab4e4a3 
Dealt to 4aa8d4e8 
Dealt to baf670cf 
Dealt to Hero [Td 9h]
Dealt to ec1c524d 
Dealt to eea83586 
Hero: folds
ec1c524d: folds
eea83586: folds
4ab4e4a3: folds
4aa8d4e8: folds
Uncalled bet ($0.15) returned to baf670cf
*** SHOWDOWN ***
baf670cf collected $0.2 from pot
*** SUMMARY ***
Total pot $0.2
Seat 1: 4ab4e4a3 (button) folded before Flop (didn't bet)
Seat 2: 4aa8d4e8 (small blind) folded before Flop
Seat 3: baf670cf (big blind) collected ($0.2)
Seat 4: Hero folded before Flop (didn't bet)
Seat 5: ec1c524d folded before Flop (didn't bet)
Seat 6: eea83586 folded before Flop (didn't bet)


Poker Hand #RC95104265: Hold'em No Limit ($0.1/$0.25) - 2020/04/07 15:58:13
Table 'RushAndCash366520' 6-max Seat #1 is the button
Seat 1: e6dc139a ($14.24 in chips)
Seat 2: 4dd920ba ($85.1 in chips)
Seat 3: Hero ($58.28 in chips)
Seat 4: 346ec01 ($12.5 in chips)
Seat 5: 6bf543f8 ($27.64 in chips)
Seat 6: 36017ad1 ($47.24 in chips)
4dd920ba: posts small blind $0.1
Hero: posts big blind $0.25
*** HOLE CARDS ***
Dealt to e6dc139a 
Dealt to 4dd920ba 
Dealt to Hero [Ks Jh]
Dealt to 346ec01 
Dealt to 6bf543f8 
Dealt to 36017ad1 
346ec01: folds
6bf543f8: folds
36017ad1: folds
e6dc139a: calls $0.25
4dd920ba: folds
Hero: checks
*** FLOP *** [Ts 7d 8d]
Hero: checks
e6dc139a: checks
*** TURN *** [Ts 7d 8d] [6d]
Hero: checks
e6dc139a: checks
*** RIVER *** [Ts 7d 8d 6d] [Qs]
Hero: checks
e6dc139a: checks
Hero: shows [Ks Jh] (King-High)
e6dc139a: shows [Qc Kc] (Pair of Queens)
*** SHOWDOWN ***
e6dc139a collected $0.6 from pot
*** SUMMARY ***
Total pot $0.6
Board [Ts 7d 8d 6d Qs]
Seat 1: e6dc139a (button) showed [Kc Qc] and won ($0.6) with Pair of Queens
Seat 2: 4dd920ba (small blind) folded before Flop
Seat 3: Hero (big blind) showed [Ks Jh] and lost with King-High
Seat 4: 346ec01 folded before Flop (didn't bet)
Seat 5: 6bf543f8 folded before Flop (didn't bet)
Seat 6: 36017ad1 folded before Flop (didn't bet)


Poker Hand #RC95104515: Hold'em No Limit ($0.1/$0.25) - 2020/04/07 15:58:49
Table 'RushAndCash366548' 6-max Seat #1 is the button
Seat 1: 6bf543f8 ($27.64 in chips)
Seat 2: 4dd920ba ($84.75 in chips)
Seat 3: c32ac86b ($25 in chips)
Seat 4: Hero ($58.03 in chips)
Seat 5: da17c979 ($12.5 in chips)
Seat 6: e6dc139a ($14.56 in chips)
4dd920ba: posts small blind $0.1
c32ac86b: posts big blind $0.25
*** HOLE CARDS ***
Dealt to 6bf543f8 
Dealt to 4dd920ba 
Dealt to c32ac86b 
Dealt to Hero [5c 4d]
Dealt to da17c979 
Dealt to e6dc139a 
Hero: folds
da17c979: raises $0.38 to $0.63
e6dc139a: folds
6bf543f8: raises $1.92 to $2.55
4dd920ba: folds
c32ac86b: folds
da17c979: folds
Uncalled bet ($1.92) returned to 6bf543f8
*** SHOWDOWN ***
6bf543f8 collected $1.61 from pot
*** SUMMARY ***
Total pot $1.61
Seat 1: 6bf543f8 (button) collected ($1.61)
Seat 2: 4dd920ba (small blind) folded before Flop
Seat 3: c32ac86b (big blind) folded before Flop
Seat 4: Hero folded before Flop (didn't bet)
Seat 5: da17c979 folded before Flop
Seat 6: e6dc139a folded before Flop (didn't bet)


Poker Hand #RC95104546: Hold'em No Limit ($0.1/$0.25) - 2020/04/07 15:58:54
Table 'RushAndCash366551' 6-max Seat #1 is the button
Seat 1: 38e0f2fb ($23.57 in chips)
Seat 2: c32ac86b ($25 in chips)
Seat 3: 8b8d197c ($35.25 in chips)
Seat 4: d6f2a39c ($5.77 in chips)
Seat 5: Hero ($58.03 in chips)
Seat 6: e6dc139a ($14.56 in chips)
c32ac86b: posts small blind $0.1
8b8d197c: posts big blind $0.25
*** HOLE CARDS ***
Dealt to 38e0f2fb 
Dealt to c32ac86b 
Dealt to 8b8d197c 
Dealt to d6f2a39c 
Dealt to Hero [9c 3d]
Dealt to e6dc139a 
d6f2a39c: folds
Hero: folds
e6dc139a: calls $0.25
38e0f2fb: folds
c32ac86b: calls $0.15
8b8d197c: raises $0.85 to $1.1
e6dc139a: calls $0.85
c32ac86b: folds
*** FLOP *** [8c Kd Ac]
8b8d197c: bets $1.3
e6dc139a: folds
Uncalled bet ($1.3) returned to 8b8d197c
*** SHOWDOWN ***
8b8d197c collected $2.45 from pot
*** SUMMARY ***
Total pot $2.45
Board [8c Kd Ac]
Seat 1: 38e0f2fb (button) folded before Flop (didn't bet)
Seat 2: c32ac86b (small blind) folded before Flop
Seat 3: 8b8d197c (big blind) won ($2.45)
Seat 4: d6f2a39c folded before Flop (didn't bet)
Seat 5: Hero folded before Flop (didn't bet)
Seat 6: e6dc139a folded on the Flop


Poker Hand #RC95104580: Hold'em No Limit ($0.1/$0.25) - 2020/04/07 15:58:58
Table 'RushAndCash366555' 6-max Seat #1 is the button
Seat 1: Hero ($58.03 in chips)
Seat 2: 4ab4e4a3 ($25 in chips)
Seat 3: d07b3de1 ($37.75 in chips)
Seat 4: 811232a3 ($34.51 in chips)
Seat 5: 38e0f2fb ($23.57 in chips)
Seat 6: d6f2a39c ($5.77 in chips)
4ab4e4a3: posts small blind $0.1
d07b3de1: posts big blind $0.25
*** HOLE CARDS ***
Dealt to Hero [Jh 9d]
Dealt to 4ab4e4a3 
Dealt to d07b3de1 
Dealt to 811232a3 
Dealt to 38e0f2fb 
Dealt to d6f2a39c 
811232a3: folds
38e0f2fb: folds
d6f2a39c: raises $0.5 to $0.75
Hero: folds
4ab4e4a3: folds
d07b3de1: folds
Uncalled bet ($0.5) returned to d6f2a39c
*** SHOWDOWN ***
d6f2a39c collected $0.6 from pot
*** SUMMARY ***
Total pot $0.6
Seat 1: Hero (button) folded before Flop (didn't bet)
Seat 2: 4ab4e4a3 (small blind) folded before Flop
Seat 3: d07b3de1 (big blind) folded before Flop
Seat 4: 811232a3 folded before Flop (didn't bet)
Seat 5: 38e0f2fb folded before Flop (didn't bet)
Seat 6: d6f2a39c collected ($0.6)


Poker Hand #RC95104613: Hold'em No Limit ($0.1/$0.25) - 2020/04/07 15:59:03
Table 'RushAndCash366559' 6-max Seat #1 is the button
Seat 1: ec1c524d ($25.45 in chips)
Seat 2: be711e9d ($33.69 in chips)
Seat 3: 2dd038c3 ($10.95 in chips)
Seat 4: bc3db224 ($39.79 in chips)
Seat 5: a1e9a341 ($26.82 in chips)
Seat 6: Hero ($58.03 in chips)
be711e9d: posts small blind $0.1
2dd038c3: posts big blind $0.25
*** HOLE CARDS ***
Dealt to ec1c524d 
Dealt to be711e9d 
Dealt to 2dd038c3 
Dealt to bc3db224 
Dealt to a1e9a341 
Dealt to Hero [Jd 7d]
bc3db224: folds
a1e9a341: folds
Hero: folds
ec1c524d: folds
be711e9d: raises $0.5 to $0.75
2dd038c3: folds
Uncalled bet ($0.5) returned to be711e9d
*** SHOWDOWN ***
be711e9d collected $0.5 from pot
*** SUMMARY ***
Total pot $0.5
Seat 1: ec1c524d (button) folded before Flop (didn't bet)
Seat 2: be711e9d (small blind) collected ($0.5)
Seat 3: 2dd038c3 (big blind) folded before Flop
Seat 4: bc3db224 folded before Flop (didn't bet)
Seat 5: a1e9a341 folded before Flop (didn't bet)
Seat 6: Hero folded before Flop (didn't bet)


Poker Hand #RC95104645: Hold'em No Limit ($0.1/$0.25) - 2020/04/07 15:59:06
Table 'RushAndCash366563' 6-max Seat #1 is the button
Seat 1: Hero ($58.03 in chips)
Seat 2: 3423a84d ($47.26 in chips)
Seat 3: eea83586 ($10.9 in chips)
Seat 4: a6846758 ($25 in chips)
Seat 5: ac90cf4e ($2.97 in chips)
Seat 6: 5d2a310d ($4.56 in chips)
3423a84d: posts small blind $0.1
eea83586: posts big blind $0.25
*** HOLE CARDS ***
Dealt to Hero [As Jh]
Dealt to 3423a84d 
Dealt to eea83586 
Dealt to a6846758 
Dealt to ac90cf4e 
Dealt to 5d2a310d 
a6846758: folds
ac90cf4e: folds
5d2a310d: raises $0.38 to $0.63
Hero: calls $0.63
3423a84d: folds
eea83586: calls $0.38
*** FLOP *** [9s Qc 2s]
eea83586: checks
5d2a310d: checks
Hero: checks
*** TURN *** [9s Qc 2s] [Ks]
eea83586: bets $1.5
5d2a310d: folds
Hero: calls $1.5
*** RIVER *** [9s Qc 2s Ks] [Kh]
eea83586: bets $2.5
Hero: folds
Uncalled bet ($2.5) returned to eea83586
*** SHOWDOWN ***
eea83586 collected $4.99 from pot
*** SUMMARY ***
Total pot $4.99
Board [9s Qc 2s Ks Kh]
Seat 1: Hero (button) folded on the River
Seat 2: 3423a84d (small blind) folded before Flop
Seat 3: eea83586 (big blind) won ($4.99)
Seat 4: a6846758 folded before Flop (didn't bet)
Seat 5: ac90cf4e folded before Flop (didn't bet)
Seat 6: 5d2a310d folded on the Turn


Poker Hand #RC95104992: Hold'em No Limit ($0.1/$0.25) - 2020/04/07 15:59:51
Table 'RushAndCash366616' 6-max Seat #1 is the button
Seat 1: eea83586 ($13.51 in chips)
Seat 2: 459706be ($25.55 in chips)
Seat 3: 7ed3ab6b ($42.4 in chips)
Seat 4: adb51d54 ($27.22 in chips)
Seat 5: Hero ($55.9 in chips)
Seat 6: 5d2a310d ($3.93 in chips)
459706be: posts small blind $0.1
7ed3ab6b: posts big blind $0.25
*** HOLE CARDS ***
Dealt to eea83586 
Dealt to 459706be 
Dealt to 7ed3ab6b 
Dealt to adb51d54 
Dealt to Hero [Qc 7d]
Dealt to 5d2a310d 
adb51d54: raises $0.38 to $0.63
Hero: folds
5d2a310d: raises $3.3 to $3.93 and is all-in
eea83586: raises $9.58 to $13.51 and is all-in
459706be: folds
7ed3ab6b: folds
adb51d54: folds
Uncalled bet ($9.58) returned to eea83586
eea83586: shows [Qd Qs]
5d2a310d: shows [8d 8s]
*** FLOP *** [Kc 3c 4c]
*** TURN *** [Kc 3c 4c] [9d]
*** RIVER *** [Kc 3c 4c 9d] [4d]
*** SHOWDOWN ***
eea83586 collected $8.84 from pot
*** SUMMARY ***
Total pot $8.84
Board [Kc 3c 4c 9d 4d]
Seat 1: eea83586 (button) showed [Qs Qd] and won ($8.84) with Pair of Queens and Pair of Fours
Seat 2: 459706be (small blind) folded before Flop
Seat 3: 7ed3ab6b (big blind) folded before Flop
Seat 4: adb51d54 folded before Flop
Seat 5: Hero folded before Flop (didn't bet)
Seat 6: 5d2a310d showed [8s 8d] and lost with Pair of Eights and Pair of Fours


Poker Hand #RC95105029: Hold'em No Limit ($0.1/$0.25) - 2020/04/07 15:59:57
Table 'RushAndCash366621' 6-max Seat #1 is the button
Seat 1: ed488d2d ($18.21 in chips)
Seat 2: Hero ($55.9 in chips)
Seat 3: 8b8d197c ($36.48 in chips)
Seat 4: baf670cf ($25.25 in chips)
Seat 5: ec1c524d ($25.2 in chips)
Seat 6: 8372bca9 ($29.93 in chips)
Hero: posts small blind $0.1
8b8d197c: posts big blind $0.25
*** HOLE CARDS ***
Dealt to ed488d2d 
Dealt to Hero [Kc 4c]
Dealt to 8b8d197c 
Dealt to baf670cf 
Dealt to ec1c524d 
Dealt to 8372bca9 
baf670cf: folds
ec1c524d: folds
8372bca9: folds
ed488d2d: folds
Hero: folds
Uncalled bet ($0.15) returned to 8b8d197c
*** SHOWDOWN ***
8b8d197c collected $0.2 from pot
*** SUMMARY ***
Total pot $0.2
Seat 1: ed488d2d (button) folded before Flop (didn't bet)
Seat 2: Hero (small blind) folded before Flop
Seat 3: 8b8d197c (big blind) collected ($0.2)
Seat 4: baf670cf folded before Flop (didn't bet)
Seat 5: ec1c524d folded before Flop (didn't bet)
Seat 6: 8372bca9 folded before Flop (didn't bet)


Poker Hand #RC95105051: Hold'em No Limit ($0.1/$0.25) - 2020/04/07 16:00:00
Table 'RushAndCash366624' 6-max Seat #1 is the button
Seat 1: d3a18552 ($13.8 in chips)
Seat 2: be3950eb ($25 in chips)
Seat 3: bdffd813 ($29.08 in chips)
Seat 4: Hero ($55.8 in chips)
Seat 5: 9ec2c109 ($12.91 in chips)
Seat 6: d6f2a39c ($5.77 in chips)
be3950eb: posts small blind $0.1
bdffd813: posts big blind $0.25
*** HOLE CARDS ***
Dealt to d3a18552 
Dealt to be3950eb 
Dealt to bdffd813 
Dealt to Hero [8s 2c]
Dealt to 9ec2c109 
Dealt to d6f2a39c 
Hero: folds
9ec2c109: folds
d6f2a39c: folds
d3a18552: raises $0.38 to $0.63
be3950eb: folds
bdffd813: folds
Uncalled bet ($0.38) returned to d3a18552
*** SHOWDOWN ***
d3a18552 collected $0.6 from pot
*** SUMMARY ***
Total pot $0.6
Seat 1: d3a18552 (button) collected ($0.6)
Seat 2: be3950eb (small blind) folded before Flop
Seat 3: bdffd813 (big blind) folded before Flop
Seat 4: Hero folded before Flop (didn't bet)
Seat 5: 9ec2c109 folded before Flop (didn't bet)
Seat 6: d6f2a39c folded before Flop (didn't bet)


Poker Hand #RC95105075: Hold'em No Limit ($0.1/$0.25) - 2020/04/07 16:00:04
Table 'RushAndCash366627' 6-max Seat #1 is the button
Seat 1: dc1d83ec ($22.94 in chips)
Seat 2: bad0409c ($16.26 in chips)
Seat 3: ac90cf4e ($2.87 in chips)
Seat 4: fb4a5e69 ($25.4 in chips)
Seat 5: 45920dbc ($75.68 in chips)
Seat 6: Hero ($55.8 in chips)
bad0409c: posts small blind $0.1
ac90cf4e: posts big blind $0.25
*** HOLE CARDS ***
Dealt to dc1d83ec 
Dealt to bad0409c 
Dealt to ac90cf4e 
Dealt to fb4a5e69 
Dealt to 45920dbc 
Dealt to Hero [Kd 4h]
fb4a5e69: folds
45920dbc: folds
Hero: folds
dc1d83ec: folds
bad0409c: folds
Uncalled bet ($0.15) returned to ac90cf4e
*** SHOWDOWN ***
ac90cf4e collected $0.2 from pot
*** SUMMARY ***
Total pot $0.2
Seat 1: dc1d83ec (button) folded before Flop (didn't bet)
Seat 2: bad0409c (small blind) folded before Flop
Seat 3: ac90cf4e (big blind) collected ($0.2)
Seat 4: fb4a5e69 folded before Flop (didn't bet)
Seat 5: 45920dbc folded before Flop (didn't bet)
Seat 6: Hero folded before Flop (didn't bet)


Poker Hand #RC95105102: Hold'em No Limit ($0.1/$0.25) - 2020/04/07 16:00:07
Table 'RushAndCash366631' 6-max Seat #1 is the button
Seat 1: d2986703 ($38.13 in chips)
Seat 2: 3dafe47e ($17.93 in chips)
Seat 3: 421d7a8a ($25 in chips)
Seat 4: 8c4d6eff ($37.69 in chips)
Seat 5: Hero ($55.8 in chips)
Seat 6: a1e9a341 ($28.97 in chips)
3dafe47e: posts small blind $0.1
421d7a8a: posts big blind $0.25
*** HOLE CARDS ***
Dealt to d2986703 
Dealt to 3dafe47e 
Dealt to 421d7a8a 
Dealt to 8c4d6eff 
Dealt to Hero [9h 2d]
Dealt to a1e9a341 
8c4d6eff: folds
Hero: folds
a1e9a341: folds
d2986703: raises $0.5 to $0.75
3dafe47e: folds
421d7a8a: folds
Uncalled bet ($0.5) returned to d2986703
*** SHOWDOWN ***
d2986703 collected $0.6 from pot
*** SUMMARY ***
Total pot $0.6
Seat 1: d2986703 (button) collected ($0.6)
Seat 2: 3dafe47e (small blind) folded before Flop
Seat 3: 421d7a8a (big blind) folded before Flop
Seat 4: 8c4d6eff folded before Flop (didn't bet)
Seat 5: Hero folded before Flop (didn't bet)
Seat 6: a1e9a341 folded before Flop (didn't bet)


Poker Hand #RC95105131: Hold'em No Limit ($0.1/$0.25) - 2020/04/07 16:00:11
Table 'RushAndCash366635' 6-max Seat #1 is the button
Seat 1: ce59b684 ($39.1 in chips)
Seat 2: 8c4d6eff ($37.69 in chips)
Seat 3: 24755d41 ($14.17 in chips)
Seat 4: Hero ($55.8 in chips)
Seat 5: 4aa8d4e8 ($12.6 in chips)
Seat 6: 40a91d41 ($25.23 in chips)
8c4d6eff: posts small blind $0.1
24755d41: posts big blind $0.25
*** HOLE CARDS ***
Dealt to ce59b684 
Dealt to 8c4d6eff 
Dealt to 24755d41 
Dealt to Hero [6d 3h]
Dealt to 4aa8d4e8 
Dealt to 40a91d41 
Hero: folds
4aa8d4e8: folds
40a91d41: raises $0.38 to $0.63
ce59b684: folds
8c4d6eff: folds
24755d41: folds
Uncalled bet ($0.38) returned to 40a91d41
*** SHOWDOWN ***
40a91d41 collected $0.6 from pot
*** SUMMARY ***
Total pot $0.6
Seat 1: ce59b684 (button) folded before Flop (didn't bet)
Seat 2: 8c4d6eff (small blind) folded before Flop
Seat 3: 24755d41 (big blind) folded before Flop
Seat 4: Hero folded before Flop (didn't bet)
Seat 5: 4aa8d4e8 folded before Flop (didn't bet)
Seat 6: 40a91d41 collected ($0.6)


Poker Hand #RC95105158: Hold'em No Limit ($0.1/$0.25) - 2020/04/07 16:00:16
Table 'RushAndCash366638' 6-max Seat #1 is the button
Seat 1: 8c4d6eff ($37.59 in chips)
Seat 2: deb69778 ($33.52 in chips)
Seat 3: Hero ($55.8 in chips)
Seat 4: 2c82afb5 ($10.42 in chips)
Seat 5: b5ef92ca ($12.75 in chips)
Seat 6: 7ed3ab6b ($42.05 in chips)
deb69778: posts small blind $0.1
Hero: posts big blind $0.25
*** HOLE CARDS ***
Dealt to 8c4d6eff 
Dealt to deb69778 
Dealt to Hero [As 7s]
Dealt to 2c82afb5 
Dealt to b5ef92ca 
Dealt to 7ed3ab6b 
2c82afb5: raises $0.63 to $0.88
b5ef92ca: folds
7ed3ab6b: folds
8c4d6eff: folds
deb69778: folds
Hero: calls $0.63
*** FLOP *** [8c Td 3s]
Hero: checks
2c82afb5: bets $0.7
Hero: calls $0.7
*** TURN *** [8c Td 3s] [Qh]
Hero: checks
2c82afb5: bets $2.5
Hero: folds
Uncalled bet ($2.5) returned to 2c82afb5
*** SHOWDOWN ***
2c82afb5 collected $3.26 from pot
*** SUMMARY ***
Total pot $3.26
Board [8c Td 3s Qh]
Seat 1: 8c4d6eff (button) folded before Flop (didn't bet)
Seat 2: deb69778 (small blind) folded before Flop
Seat 3: Hero (big blind) folded on the Turn
Seat 4: 2c82afb5 won ($3.26)
Seat 5: b5ef92ca folded before Flop (didn't bet)
Seat 6: 7ed3ab6b folded before Flop (didn't bet)


Poker Hand #RC95105368: Hold'em No Limit ($0.1/$0.25) - 2020/04/07 16:00:48
Table 'RushAndCash366665' 6-max Seat #1 is the button
Seat 1: 38e0f2fb ($23.57 in chips)
Seat 2: Hero ($54.22 in chips)
Seat 3: deb69778 ($33.32 in chips)
Seat 4: ce59b684 ($38.85 in chips)
Seat 5: 8ac4f082 ($27.27 in chips)
Seat 6: 2c82afb5 ($11.94 in chips)
Hero: posts small blind $0.1
deb69778: posts big blind $0.25
*** HOLE CARDS ***
Dealt to 38e0f2fb 
Dealt to Hero [8c 5d]
Dealt to deb69778 
Dealt to ce59b684 
Dealt to 8ac4f082 
Dealt to 2c82afb5 
ce59b684: raises $0.38 to $0.63
8ac4f082: calls $0.63
2c82afb5: folds
38e0f2fb: folds
Hero: folds
deb69778: calls $0.38
*** FLOP *** [9c 6d Jh]
deb69778: checks
ce59b684: checks
8ac4f082: bets $0.7
deb69778: folds
ce59b684: calls $0.7
*** TURN *** [9c 6d Jh] [7s]
ce59b684: checks
8ac4f082: checks
*** RIVER *** [9c 6d Jh 7s] [2c]
ce59b684: checks
8ac4f082: bets $1.2
ce59b684: calls $1.2
8ac4f082: shows [Qh Kh] (King-High)
ce59b684: shows [7c Ac] (Pair of Sevens)
*** SHOWDOWN ***
ce59b684 collected $5.79 from pot
*** SUMMARY ***
Total pot $5.79
Board [9c 6d Jh 7s 2c]
Seat 1: 38e0f2fb (button) folded before Flop (didn't bet)
Seat 2: Hero (small blind) folded before Flop
Seat 3: deb69778 (big blind) folded on the Flop
Seat 4: ce59b684 showed [Ac 7c] and won ($5.79) with Pair of Sevens
Seat 5: 8ac4f082 showed [Kh Qh] and lost with King-High
Seat 6: 2c82afb5 folded before Flop (didn't bet)


Poker Hand #RC95105397: Hold'em No Limit ($0.1/$0.25) - 2020/04/07 16:00:53
Table 'RushAndCash366668' 6-max Seat #1 is the button
Seat 1: Hero ($54.12 in chips)
Seat 2: dbf6981f ($47.36 in chips)
Seat 3: 5d2a310d ($12 in chips)
Seat 4: 38e0f2fb ($23.57 in chips)
Seat 5: 7ed3ab6b ($41.8 in chips)
Seat 6: ea254934 ($15.43 in chips)
dbf6981f: posts small blind $0.1
5d2a310d: posts big blind $0.25
*** HOLE CARDS ***
Dealt to Hero [6h 4d]
Dealt to dbf6981f 
Dealt to 5d2a310d 
Dealt to 38e0f2fb 
Dealt to 7ed3ab6b 
Dealt to ea254934 
38e0f2fb: folds
7ed3ab6b: folds
ea254934: raises $0.38 to $0.63
Hero: folds
dbf6981f: folds
5d2a310d: folds
Uncalled bet ($0.38) returned to ea254934
*** SHOWDOWN ***
ea254934 collected $0.6 from pot
*** SUMMARY ***
Total pot $0.6
Seat 1: Hero (button) folded before Flop (didn't bet)
Seat 2: dbf6981f (small blind) folded before Flop
Seat 3: 5d2a310d (big blind) folded before Flop
Seat 4: 38e0f2fb folded before Flop (didn't bet)
Seat 5: 7ed3ab6b folded before Flop (didn't bet)
Seat 6: ea254934 collected ($0.6)


Poker Hand #RC95105425: Hold'em No Limit ($0.1/$0.25) - 2020/04/07 16:00:58
Table 'RushAndCash366671' 6-max Seat #1 is the button
Seat 1: 6185872b ($12.06 in chips)
Seat 2: 91db230c ($25 in chips)
Seat 3: Hero ($54.12 in chips)
Seat 4: 51c60a1c ($17.72 in chips)
Seat 5: 38e0f2fb ($23.57 in chips)
Seat 6: 4dd920ba ($95.65 in chips)
91db230c: posts small blind $0.1
Hero: posts big blind $0.25
*** HOLE CARDS ***
Dealt to 6185872b 
Dealt to 91db230c 
Dealt to Hero [4s 2c]
Dealt to 51c60a1c 
Dealt to 38e0f2fb 
Dealt to 4dd920ba 
51c60a1c: folds
38e0f2fb: raises $0.38 to $0.63
4dd920ba: folds
6185872b: calls $0.63
91db230c: folds
Hero: folds
*** FLOP *** [Jc Kh Tc]
38e0f2fb: bets $0.6
6185872b: raises $1.5 to $2.1
38e0f2fb: folds
Uncalled bet ($1.5) returned to 6185872b
*** SHOWDOWN ***
6185872b collected $2.81 from pot
*** SUMMARY ***
Total pot $2.81
Board [Jc Kh Tc]
Seat 1: 6185872b (button) won ($2.81)
Seat 2: 91db230c (small blind) folded before Flop
Seat 3: Hero (big blind) folded before Flop
Seat 4: 51c60a1c folded before Flop (didn't bet)
Seat 5: 38e0f2fb folded on the Flop
Seat 6: 4dd920ba folded before Flop (didn't bet)


Poker Hand #RC95105446: Hold'em No Limit ($0.1/$0.25) - 2020/04/07 16:01:01
Table 'RushAndCash366674' 6-max Seat #1 is the button
Seat 1: e131407f ($28.12 in chips)
Seat 2: 403fa816 ($9.67 in chips)
Seat 3: da17c979 ($12.5 in chips)
Seat 4: 32953d2a ($13.52 in chips)
Seat 5: Hero ($53.87 in chips)
Seat 6: 24755d41 ($13.82 in chips)
403fa816: posts small blind $0.1
da17c979: posts big blind $0.25
*** HOLE CARDS ***
Dealt to e131407f 
Dealt to 403fa816 
Dealt to da17c979 
Dealt to 32953d2a 
Dealt to Hero [Ad 5d]
Dealt to 24755d41 
32953d2a: raises $0.38 to $0.63
Hero: raises $1.49 to $2.12
24755d41: folds
e131407f: folds
403fa816: folds
da17c979: folds
32953d2a: folds
Uncalled bet ($1.49) returned to Hero
*** SHOWDOWN ***
Hero collected $1.61 from pot
*** SUMMARY ***
Total pot $1.61
Seat 1: e131407f (button) folded before Flop (didn't bet)
Seat 2: 403fa816 (small blind) folded before Flop
Seat 3: da17c979 (big blind) folded before Flop
Seat 4: 32953d2a folded before Flop
Seat 5: Hero collected ($1.61)
Seat 6: 24755d41 folded before Flop (didn't bet)


Poker Hand #RC95105592: Hold'em No Limit ($0.1/$0.25) - 2020/04/07 16:01:28
Table 'RushAndCash366692' 6-max Seat #1 is the button
Seat 1: 37ae2dd7 ($26.97 in chips)
Seat 2: a4ba858f ($47.51 in chips)
Seat 3: cdd7700a ($12.68 in chips)
Seat 4: 62eebc49 ($103.28 in chips)
Seat 5: Hero ($54.77 in chips)
Seat 6: d18357ce ($21.58 in chips)
a4ba858f: posts small blind $0.1
cdd7700a: posts big blind $0.25
*** HOLE CARDS ***
Dealt to 37ae2dd7 
Dealt to a4ba858f 
Dealt to cdd7700a 
Dealt to 62eebc49 
Dealt to Hero [8s 2c]
Dealt to d18357ce 
62eebc49: folds
Hero: folds
d18357ce: folds
37ae2dd7: folds
a4ba858f: folds
Uncalled bet ($0.15) returned to cdd7700a
*** SHOWDOWN ***
cdd7700a collected $0.2 from pot
*** SUMMARY ***
Total pot $0.2
Seat 1: 37ae2dd7 (button) folded before Flop (didn't bet)
Seat 2: a4ba858f (small blind) folded before Flop
Seat 3: cdd7700a (big blind) collected ($0.2)
Seat 4: 62eebc49 folded before Flop (didn't bet)
Seat 5: Hero folded before Flop (didn't bet)
Seat 6: d18357ce folded before Flop (didn't bet)


Poker Hand #RC95105614: Hold'em No Limit ($0.1/$0.25) - 2020/04/07 16:01:32
Table 'RushAndCash366695' 6-max Seat #1 is the button
Seat 1: 2aaed573 ($8.47 in chips)
Seat 2: 4ab4e4a3 ($25 in chips)
Seat 3: 62eebc49 ($103.28 in chips)
Seat 4: da17c979 ($12.5 in chips)
Seat 5: 57ff778 ($33.43 in chips)
Seat 6: Hero ($54.77 in chips)
4ab4e4a3: posts small blind $0.1
62eebc49: posts big blind $0.25
*** HOLE CARDS ***
Dealt to 2aaed573 
Dealt to 4ab4e4a3 
Dealt to 62eebc49 
Dealt to da17c979 
Dealt to 57ff778 
Dealt to Hero [9s 3c]
da17c979: folds
57ff778: folds
Hero: folds
2aaed573: folds
4ab4e4a3: folds
Uncalled bet ($0.15) returned to 62eebc49
*** SHOWDOWN ***
62eebc49 collected $0.2 from pot
*** SUMMARY ***
Total pot $0.2
Seat 1: 2aaed573 (button) folded before Flop (didn't bet)
Seat 2: 4ab4e4a3 (small blind) folded before Flop
Seat 3: 62eebc49 (big blind) collected ($0.2)
Seat 4: da17c979 folded before Flop (didn't bet)
Seat 5: 57ff778 folded before Flop (didn't bet)
Seat 6: Hero folded before Flop (didn't bet)


Poker Hand #RC95105642: Hold'em No Limit ($0.1/$0.25) - 2020/04/07 16:01:36
Table 'RushAndCash366698' 6-max Seat #1 is the button
Seat 1: Hero ($54.77 in chips)
Seat 2: 2c82afb5 ($12.29 in chips)
Seat 3: ac90cf4e ($3.57 in chips)
Seat 4: d07b3de1 ($37.22 in chips)
Seat 5: decd88e2 ($26.5 in chips)
Seat 6: acf1a889 ($21.52 in chips)
2c82afb5: posts small blind $0.1
ac90cf4e: posts big blind $0.25
*** HOLE CARDS ***
Dealt to Hero [Jc 8c]
Dealt to 2c82afb5 
Dealt to ac90cf4e 
Dealt to d07b3de1 
Dealt to decd88e2 
Dealt to acf1a889 
d07b3de1: folds
decd88e2: folds
acf1a889: raises $0.38 to $0.63
Hero: folds
2c82afb5: calls $0.53
ac90cf4e: calls $0.38
*** FLOP *** [4s 8d 5s]
2c82afb5: checks
ac90cf4e: checks
acf1a889: checks
*** TURN *** [4s 8d 5s] [7c]
2c82afb5: bets $1.5
ac90cf4e: folds
acf1a889: folds
Uncalled bet ($1.5) returned to 2c82afb5
*** SHOWDOWN ***
2c82afb5 collected $1.89 from pot
*** SUMMARY ***
Total pot $1.89
Board [4s 8d 5s 7c]
Seat 1: Hero (button) folded before Flop (didn't bet)
Seat 2: 2c82afb5 (small blind) won ($1.89)
Seat 3: ac90cf4e (big blind) folded on the Turn
Seat 4: d07b3de1 folded before Flop (didn't bet)
Seat 5: decd88e2 folded before Flop (didn't bet)
Seat 6: acf1a889 folded on the Turn


Poker Hand #RC95105718: Hold'em No Limit ($0.1/$0.25) - 2020/04/07 16:01:48
Table 'RushAndCash366707' 6-max Seat #1 is the button
Seat 1: 2d45ce80 ($14.05 in chips)
Seat 2: Hero ($54.77 in chips)
Seat 3: 8902e20 ($12 in chips)
Seat 4: 13cda138 ($26.85 in chips)
Seat 5: a4ba858f ($47.41 in chips)
Seat 6: 6736194e ($31.22 in chips)
Hero: posts small blind $0.1
8902e20: posts big blind $0.25
*** HOLE CARDS ***
Dealt to 2d45ce80 
Dealt to Hero [Qh Jc]
Dealt to 8902e20 
Dealt to 13cda138 
Dealt to a4ba858f 
Dealt to 6736194e 
13cda138: raises $0.38 to $0.63
a4ba858f: folds
6736194e: folds
2d45ce80: raises $1.37 to $2
Hero: folds
8902e20: folds
13cda138: raises $24.85 to $26.85 and is all-in
2d45ce80: calls $12.05 and is all-in
Uncalled bet ($12.8) returned to 13cda138
13cda138: shows [Ad Kd]
2d45ce80: shows [Ah Ks]
*** FLOP *** [3s 5c 2h]
*** TURN *** [3s 5c 2h] [5s]
*** RIVER *** [3s 5c 2h 5s] [9h]
*** SHOWDOWN ***
2d45ce80 collected $14.22 from pot
13cda138 collected $14.22 from pot
*** SUMMARY ***
Total pot $28.45
Board [3s 5c 2h 5s 9h]
Seat 1: 2d45ce80 (button) showed [Ah Ks] and won ($14.22) with Pair of Fives
Seat 2: Hero (small blind) folded before Flop
Seat 3: 8902e20 (big blind) folded before Flop
Seat 4: 13cda138 showed [Ad Kd] and won ($14.22) with Pair of Fives
Seat 5: a4ba858f folded before Flop (didn't bet)
Seat 6: 6736194e folded before Flop (didn't bet)


Poker Hand #RC95105790: Hold'em No Limit ($0.1/$0.25) - 2020/04/07 16:01:59
Table 'RushAndCash366715' 6-max Seat #1 is the button
Seat 1: 51c60a1c ($19.63 in chips)
Seat 2: 5be1f3e6 ($25 in chips)
Seat 3: 16e6db78 ($12 in chips)
Seat 4: Hero ($54.67 in chips)
Seat 5: 7441dc97 ($25.82 in chips)
Seat 6: 38e0f2fb ($21.99 in chips)
5be1f3e6: posts small blind $0.1
16e6db78: posts big blind $0.25
*** HOLE CARDS ***
Dealt to 51c60a1c 
Dealt to 5be1f3e6 
Dealt to 16e6db78 
Dealt to Hero [Qh Ts]
Dealt to 7441dc97 
Dealt to 38e0f2fb 
Hero: folds
7441dc97: raises $0.5 to $0.75
38e0f2fb: folds
51c60a1c: folds
5be1f3e6: calls $0.65
16e6db78: folds
*** FLOP *** [Kc Kh 9s]
5be1f3e6: checks
7441dc97: checks
*** TURN *** [Kc Kh 9s] [4d]
5be1f3e6: checks
7441dc97: bets $1
5be1f3e6: folds
Uncalled bet ($1) returned to 7441dc97
*** SHOWDOWN ***
7441dc97 collected $1.75 from pot
*** SUMMARY ***
Total pot $1.75
Board [Kc Kh 9s 4d]
Seat 1: 51c60a1c (button) folded before Flop (didn't bet)
Seat 2: 5be1f3e6 (small blind) folded on the Turn
Seat 3: 16e6db78 (big blind) folded before Flop
Seat 4: Hero folded before Flop (didn't bet)
Seat 5: 7441dc97 won ($1.75)
Seat 6: 38e0f2fb folded before Flop (didn't bet)


Poker Hand #RC95105812: Hold'em No Limit ($0.1/$0.25) - 2020/04/07 16:02:02
Table 'RushAndCash366717' 6-max Seat #1 is the button
Seat 1: dbf6981f ($50.23 in chips)
Seat 2: 982f33b1 ($24.75 in chips)
Seat 3: ac131ba6 ($25.25 in chips)
Seat 4: 4ab4e4a3 ($25 in chips)
Seat 5: Hero ($54.67 in chips)
Seat 6: bc3db224 ($39.46 in chips)
982f33b1: posts small blind $0.1
ac131ba6: posts big blind $0.25
*** HOLE CARDS ***
Dealt to dbf6981f 
Dealt to 982f33b1 
Dealt to ac131ba6 
Dealt to 4ab4e4a3 
Dealt to Hero [6c 5c]
Dealt to bc3db224 
4ab4e4a3: folds
Hero: raises $0.38 to $0.63
bc3db224: folds
dbf6981f: folds
982f33b1: calls $0.53
ac131ba6: folds
*** FLOP *** [Ad 5s 2s]
982f33b1: bets $0.8
Hero: calls $0.8
*** TURN *** [Ad 5s 2s] [7d]
982f33b1: checks
Hero: checks
*** RIVER *** [Ad 5s 2s 7d] [4h]
982f33b1: checks
Hero: bets $3.2
982f33b1: folds
Uncalled bet ($3.2) returned to Hero
*** SHOWDOWN ***
Hero collected $3.11 from pot
*** SUMMARY ***
Total pot $3.11
Board [Ad 5s 2s 7d 4h]
Seat 1: dbf6981f (button) folded before Flop (didn't bet)
Seat 2: 982f33b1 (small blind) folded on the River
Seat 3: ac131ba6 (big blind) folded before Flop
Seat 4: 4ab4e4a3 folded before Flop (didn't bet)
Seat 5: Hero won ($3.11)
Seat 6: bc3db224 folded before Flop (didn't bet)


Poker Hand #RC95106072: Hold'em No Limit ($0.1/$0.25) - 2020/04/07 16:02:42
Table 'RushAndCash366752' 6-max Seat #1 is the button
Seat 1: 982f33b1 ($23.32 in chips)
Seat 2: a4ba858f ($47.06 in chips)
Seat 3: 13cda138 ($26.53 in chips)
Seat 4: Hero ($56.2 in chips)
Seat 5: 2d45ce80 ($13.72 in chips)
Seat 6: 38e0f2fb ($21.99 in chips)
a4ba858f: posts small blind $0.1
13cda138: posts big blind $0.25
*** HOLE CARDS ***
Dealt to 982f33b1 
Dealt to a4ba858f 
Dealt to 13cda138 
Dealt to Hero [Kh 4h]
Dealt to 2d45ce80 
Dealt to 38e0f2fb 
Hero: folds
2d45ce80: folds
38e0f2fb: folds
982f33b1: folds
a4ba858f: raises $0.5 to $0.75
13cda138: calls $0.5
*** FLOP *** [8h 2s 6h]
a4ba858f: checks
13cda138: bets $0.8
a4ba858f: folds
Uncalled bet ($0.8) returned to 13cda138
*** SHOWDOWN ***
13cda138 collected $1.5 from pot
*** SUMMARY ***
Total pot $1.5
Board [8h 2s 6h]
Seat 1: 982f33b1 (button) folded before Flop (didn't bet)
Seat 2: a4ba858f (small blind) folded on the Flop
Seat 3: 13cda138 (big blind) won ($1.5)
Seat 4: Hero folded before Flop (didn't bet)
Seat 5: 2d45ce80 folded before Flop (didn't bet)
Seat 6: 38e0f2fb folded before Flop (didn't bet)


Poker Hand #RC95106095: Hold'em No Limit ($0.1/$0.25) - 2020/04/07 16:02:46
Table 'RushAndCash366755' 6-max Seat #1 is the button
Seat 1: 459706be ($28.62 in chips)
Seat 2: e6fa23c9 ($29.59 in chips)
Seat 3: Hero ($56.2 in chips)
Seat 4: 45920dbc ($74.88 in chips)
Seat 5: 65837850 ($117.74 in chips)
Seat 6: ac131ba6 ($25.35 in chips)
e6fa23c9: posts small blind $0.1
Hero: posts big blind $0.25
*** HOLE CARDS ***
Dealt to 459706be 
Dealt to e6fa23c9 
Dealt to Hero [Ah Jh]
Dealt to 45920dbc 
Dealt to 65837850 
Dealt to ac131ba6 
45920dbc: folds
65837850: folds
ac131ba6: folds
459706be: folds
e6fa23c9: raises $0.5 to $0.75
Hero: raises $1.75 to $2.5
e6fa23c9: calls $1.75
*** FLOP *** [5d Jc 2h]
e6fa23c9: checks
Hero: bets $2.92
e6fa23c9: folds
Uncalled bet ($2.92) returned to Hero
*** SHOWDOWN ***
Hero collected $5 from pot
*** SUMMARY ***
Total pot $5
Board [5d Jc 2h]
Seat 1: 459706be (button) folded before Flop (didn't bet)
Seat 2: e6fa23c9 (small blind) folded on the Flop
Seat 3: Hero (big blind) won ($5)
Seat 4: 45920dbc folded before Flop (didn't bet)
Seat 5: 65837850 folded before Flop (didn't bet)
Seat 6: ac131ba6 folded before Flop (didn't bet)


Poker Hand #RC95106349: Hold'em No Limit ($0.1/$0.25) - 2020/04/07 16:03:27
Table 'RushAndCash366784' 6-max Seat #1 is the button
Seat 1: Hero ($58.45 in chips)
Seat 2: 32953d2a ($13.07 in chips)
Seat 3: e6fa23c9 ($27.09 in chips)
Seat 4: d3a18552 ($13.02 in chips)
Seat 5: 8372bca9 ($27.63 in chips)
Seat 6: e131407f ($27.04 in chips)
32953d2a: posts small blind $0.1
e6fa23c9: posts big blind $0.25
*** HOLE CARDS ***
Dealt to Hero [8d 8c]
Dealt to 32953d2a 
Dealt to e6fa23c9 
Dealt to d3a18552 
Dealt to 8372bca9 
Dealt to e131407f 
d3a18552: folds
8372bca9: folds
e131407f: folds
Hero: raises $0.38 to $0.63
32953d2a: folds
e6fa23c9: calls $0.38
*** FLOP *** [5c Qs 5s]
e6fa23c9: bets $0.7
Hero: calls $0.7
*** TURN *** [5c Qs 5s] [Ad]
e6fa23c9: bets $2.1
Hero: folds
Uncalled bet ($2.1) returned to e6fa23c9
*** SHOWDOWN ***
e6fa23c9 collected $2.76 from pot
*** SUMMARY ***
Total pot $2.76
Board [5c Qs 5s Ad]
Seat 1: Hero (button) folded on the Turn
Seat 2: 32953d2a (small blind) folded before Flop
Seat 3: e6fa23c9 (big blind) won ($2.76)
Seat 4: d3a18552 folded before Flop (didn't bet)
Seat 5: 8372bca9 folded before Flop (didn't bet)
Seat 6: e131407f folded before Flop (didn't bet)


Poker Hand #RC95106551: Hold'em No Limit ($0.1/$0.25) - 2020/04/07 16:04:00
Table 'RushAndCash366810' 6-max Seat #1 is the button
Seat 1: be3950eb ($25 in chips)
Seat 2: 8902e20 ($11.75 in chips)
Seat 3: Hero ($57.12 in chips)
Seat 4: be711e9d ($33.98 in chips)
Seat 5: 6185872b ($20.31 in chips)
Seat 6: a4ba858f ($46.41 in chips)
8902e20: posts small blind $0.1
Hero: posts big blind $0.25
*** HOLE CARDS ***
Dealt to be3950eb 
Dealt to 8902e20 
Dealt to Hero [Kc Th]
Dealt to be711e9d 
Dealt to 6185872b 
Dealt to a4ba858f 
be711e9d: folds
6185872b: raises $0.56 to $0.81
a4ba858f: calls $0.81
be3950eb: folds
8902e20: folds
Hero: folds
*** FLOP *** [5d Qs 9d]
6185872b: bets $1.5
a4ba858f: calls $1.5
*** TURN *** [5d Qs 9d] [Tc]
6185872b: bets $2.5
a4ba858f: calls $2.5
*** RIVER *** [5d Qs 9d Tc] [Td]
6185872b: bets $5
a4ba858f: calls $5
6185872b: shows [6h Qh] (Pair of Queens and Pair of Tens)
a4ba858f: shows [Jc Kd] (Kings-High Straight)
*** SHOWDOWN ***
a4ba858f collected $19.97 from pot
*** SUMMARY ***
Total pot $19.97
Board [5d Qs 9d Tc Td]
Seat 1: be3950eb (button) folded before Flop (didn't bet)
Seat 2: 8902e20 (small blind) folded before Flop
Seat 3: Hero (big blind) folded before Flop
Seat 4: be711e9d folded before Flop (didn't bet)
Seat 5: 6185872b showed [Qh 6h] and lost with Pair of Queens and Pair of Tens
Seat 6: a4ba858f showed [Kd Jc] and won ($19.97) with Kings-High Straight


Poker Hand #RC95106576: Hold'em No Limit ($0.1/$0.25) - 2020/04/07 16:04:04
Table 'RushAndCash366813' 6-max Seat #1 is the button
Seat 1: 181b6319 ($27.59 in chips)
Seat 2: Hero ($56.87 in chips)
Seat 3: 4ab4e4a3 ($28.27 in chips)
Seat 4: d07b3de1 ($36.87 in chips)
Seat 5: 5be1f3e6 ($25 in chips)
Seat 6: acf1a889 ($20.79 in chips)
Hero: posts small blind $0.1
4ab4e4a3: posts big blind $0.25
*** HOLE CARDS ***
Dealt to 181b6319 
Dealt to Hero [9d 8c]
Dealt to 4ab4e4a3 
Dealt to d07b3de1 
Dealt to 5be1f3e6 
Dealt to acf1a889 
d07b3de1: folds
5be1f3e6: folds
acf1a889: folds
181b6319: folds
Hero: folds
Uncalled bet ($0.15) returned to 4ab4e4a3
*** SHOWDOWN ***
4ab4e4a3 collected $0.2 from pot
*** SUMMARY ***
Total pot $0.2
Seat 1: 181b6319 (button) folded before Flop (didn't bet)
Seat 2: Hero (small blind) folded before Flop
Seat 3: 4ab4e4a3 (big blind) collected ($0.2)
Seat 4: d07b3de1 folded before Flop (didn't bet)
Seat 5: 5be1f3e6 folded before Flop (didn't bet)
Seat 6: acf1a889 folded before Flop (didn't bet)


Poker Hand #RC95106599: Hold'em No Limit ($0.1/$0.25) - 2020/04/07 16:04:07
Table 'RushAndCash366815' 6-max Seat #1 is the button
Seat 1: 8372bca9 ($27.63 in chips)
Seat 2: 37ae2dd7 ($27.07 in chips)
Seat 3: 982f33b1 ($19.27 in chips)
Seat 4: bdffd813 ($29.66 in chips)
Seat 5: Hero ($56.77 in chips)
Seat 6: 65837850 ($117.51 in chips)
37ae2dd7: posts small blind $0.1
982f33b1: posts big blind $0.25
*** HOLE CARDS ***
Dealt to 8372bca9 
Dealt to 37ae2dd7 
Dealt to 982f33b1 
Dealt to bdffd813 
Dealt to Hero [7c 2h]
Dealt to 65837850 
bdffd813: raises $0.38 to $0.63
Hero: folds
65837850: folds
8372bca9: folds
37ae2dd7: folds
982f33b1: folds
Uncalled bet ($0.38) returned to bdffd813
*** SHOWDOWN ***
bdffd813 collected $0.6 from pot
*** SUMMARY ***
Total pot $0.6
Seat 1: 8372bca9 (button) folded before Flop (didn't bet)
Seat 2: 37ae2dd7 (small blind) folded before Flop
Seat 3: 982f33b1 (big blind) folded before Flop
Seat 4: bdffd813 collected ($0.6)
Seat 5: Hero folded before Flop (didn't bet)
Seat 6: 65837850 folded before Flop (didn't bet)


Poker Hand #RC95106618: Hold'em No Limit ($0.1/$0.25) - 2020/04/07 16:04:11
Table 'RushAndCash366817' 6-max Seat #1 is the button
Seat 1: a6846758 ($25.58 in chips)
Seat 2: d2986703 ($40.98 in chips)
Seat 3: ce59b684 ($44.96 in chips)
Seat 4: fe2378bf ($9.83 in chips)
Seat 5: d07b3de1 ($36.87 in chips)
Seat 6: Hero ($56.77 in chips)
d2986703: posts small blind $0.1
ce59b684: posts big blind $0.25
*** HOLE CARDS ***
Dealt to a6846758 
Dealt to d2986703 
Dealt to ce59b684 
Dealt to fe2378bf 
Dealt to d07b3de1 
Dealt to Hero [8s 5d]
fe2378bf: folds
d07b3de1: folds
Hero: folds
a6846758: folds
d2986703: folds
Uncalled bet ($0.15) returned to ce59b684
*** SHOWDOWN ***
ce59b684 collected $0.2 from pot
*** SUMMARY ***
Total pot $0.2
Seat 1: a6846758 (button) folded before Flop (didn't bet)
Seat 2: d2986703 (small blind) folded before Flop
Seat 3: ce59b684 (big blind) collected ($0.2)
Seat 4: fe2378bf folded before Flop (didn't bet)
Seat 5: d07b3de1 folded before Flop (didn't bet)
Seat 6: Hero folded before Flop (didn't bet)


Poker Hand #RC95106648: Hold'em No Limit ($0.1/$0.25) - 2020/04/07 16:04:16
Table 'RushAndCash366820' 6-max Seat #1 is the button
Seat 1: fe2378bf ($9.83 in chips)
Seat 2: 32953d2a ($13.07 in chips)
Seat 3: 65837850 ($117.51 in chips)
Seat 4: 4dd920ba ($94.86 in chips)
Seat 5: Hero ($56.77 in chips)
Seat 6: 8902e20 ($11.65 in chips)
32953d2a: posts small blind $0.1
65837850: posts big blind $0.25
*** HOLE CARDS ***
Dealt to fe2378bf 
Dealt to 32953d2a 
Dealt to 65837850 
Dealt to 4dd920ba 
Dealt to Hero [6h 5s]
Dealt to 8902e20 
4dd920ba: folds
Hero: folds
8902e20: raises $0.5 to $0.75
fe2378bf: folds
32953d2a: folds
65837850: folds
Uncalled bet ($0.5) returned to 8902e20
*** SHOWDOWN ***
8902e20 collected $0.6 from pot
*** SUMMARY ***
Total pot $0.6
Seat 1: fe2378bf (button) folded before Flop (didn't bet)
Seat 2: 32953d2a (small blind) folded before Flop
Seat 3: 65837850 (big blind) folded before Flop
Seat 4: 4dd920ba folded before Flop (didn't bet)
Seat 5: Hero folded before Flop (didn't bet)
Seat 6: 8902e20 collected ($0.6)


Poker Hand #RC95106671: Hold'em No Limit ($0.1/$0.25) - 2020/04/07 16:04:20
Table 'RushAndCash366823' 6-max Seat #1 is the button
Seat 1: ea254934 ($13.21 in chips)
Seat 2: Hero ($56.77 in chips)
Seat 3: 5be1f3e6 ($25 in chips)
Seat 4: dc1d83ec ($22.84 in chips)
Seat 5: acf1a889 ($20.79 in chips)
Seat 6: 181b6319 ($27.59 in chips)
Hero: posts small blind $0.1
5be1f3e6: posts big blind $0.25
*** HOLE CARDS ***
Dealt to ea254934 
Dealt to Hero [Ah Qs]
Dealt to 5be1f3e6 
Dealt to dc1d83ec 
Dealt to acf1a889 
Dealt to 181b6319 
dc1d83ec: folds
acf1a889: folds
181b6319: folds
ea254934: folds
Hero: raises $0.5 to $0.75
5be1f3e6: folds
Uncalled bet ($0.5) returned to Hero
*** SHOWDOWN ***
Hero collected $0.5 from pot
*** SUMMARY ***
Total pot $0.5
Seat 1: ea254934 (button) folded before Flop (didn't bet)
Seat 2: Hero (small blind) collected ($0.5)
Seat 3: 5be1f3e6 (big blind) folded before Flop
Seat 4: dc1d83ec folded before Flop (didn't bet)
Seat 5: acf1a889 folded before Flop (didn't bet)
Seat 6: 181b6319 folded before Flop (didn't bet)


Poker Hand #RC95106785: Hold'em No Limit ($0.1/$0.25) - 2020/04/07 16:04:36
Table 'RushAndCash366838' 6-max Seat #1 is the button
Seat 1: Hero ($57.02 in chips)
Seat 2: 7c935d24 ($25.12 in chips)
Seat 3: 36017ad1 ($44.85 in chips)
Seat 4: 57ff778 ($32.48 in chips)
Seat 5: ac90cf4e ($5.31 in chips)
Seat 6: 5be1f3e6 ($25 in chips)
7c935d24: posts small blind $0.1
36017ad1: posts big blind $0.25
*** HOLE CARDS ***
Dealt to Hero [7d 4h]
Dealt to 7c935d24 
Dealt to 36017ad1 
Dealt to 57ff778 
Dealt to ac90cf4e 
Dealt to 5be1f3e6 
57ff778: folds
ac90cf4e: folds
5be1f3e6: folds
Hero: folds
7c935d24: folds
Uncalled bet ($0.15) returned to 36017ad1
*** SHOWDOWN ***
36017ad1 collected $0.2 from pot
*** SUMMARY ***
Total pot $0.2
Seat 1: Hero (button) folded before Flop (didn't bet)
Seat 2: 7c935d24 (small blind) folded before Flop
Seat 3: 36017ad1 (big blind) collected ($0.2)
Seat 4: 57ff778 folded before Flop (didn't bet)
Seat 5: ac90cf4e folded before Flop (didn't bet)
Seat 6: 5be1f3e6 folded before Flop (didn't bet)


Poker Hand #RC95106901: Hold'em No Limit ($0.1/$0.25) - 2020/04/07 16:04:53
Table 'RushAndCash366854' 6-max Seat #1 is the button
Seat 1: 403fa816 ($9.32 in chips)
Seat 2: a4ba858f ($55.57 in chips)
Seat 3: Hero ($57.02 in chips)
Seat 4: bab42c59 ($25.55 in chips)
Seat 5: 3423a84d ($46.27 in chips)
Seat 6: c5856645 ($32.39 in chips)
a4ba858f: posts small blind $0.1
Hero: posts big blind $0.25
*** HOLE CARDS ***
Dealt to 403fa816 
Dealt to a4ba858f 
Dealt to Hero [Th 3s]
Dealt to bab42c59 
Dealt to 3423a84d 
Dealt to c5856645 
bab42c59: raises $0.38 to $0.63
3423a84d: folds
c5856645: folds
403fa816: folds
a4ba858f: raises $2.12 to $2.75
Hero: folds
bab42c59: folds
Uncalled bet ($2.12) returned to a4ba858f
*** SHOWDOWN ***
a4ba858f collected $1.51 from pot
*** SUMMARY ***
Total pot $1.51
Seat 1: 403fa816 (button) folded before Flop (didn't bet)
Seat 2: a4ba858f (small blind) collected ($1.51)
Seat 3: Hero (big blind) folded before Flop
Seat 4: bab42c59 folded before Flop
Seat 5: 3423a84d folded before Flop (didn't bet)
Seat 6: c5856645 folded before Flop (didn't bet)


Poker Hand #RC95106928: Hold'em No Limit ($0.1/$0.25) - 2020/04/07 16:04:57
Table 'RushAndCash366858' 6-max Seat #1 is the button
Seat 1: e131407f ($25.16 in chips)
Seat 2: 3423a84d ($46.27 in chips)
Seat 3: 40a91d41 ($25.25 in chips)
Seat 4: 32953d2a ($12.87 in chips)
Seat 5: 23bd7de3 ($12.35 in chips)
Seat 6: Hero ($56.77 in chips)
3423a84d: posts small blind $0.1
40a91d41: posts big blind $0.25
*** HOLE CARDS ***
Dealt to e131407f 
Dealt to 3423a84d 
Dealt to 40a91d41 
Dealt to 32953d2a 
Dealt to 23bd7de3 
Dealt to Hero [Ac Jh]
32953d2a: raises $0.38 to $0.63
23bd7de3: folds
Hero: folds
e131407f: folds
3423a84d: folds
40a91d41: folds
Uncalled bet ($0.38) returned to 32953d2a
*** SHOWDOWN ***
32953d2a collected $0.6 from pot
*** SUMMARY ***
Total pot $0.6
Seat 1: e131407f (button) folded before Flop (didn't bet)
Seat 2: 3423a84d (small blind) folded before Flop
Seat 3: 40a91d41 (big blind) folded before Flop
Seat 4: 32953d2a collected ($0.6)
Seat 5: 23bd7de3 folded before Flop (didn't bet)
Seat 6: Hero folded before Flop (didn't bet)


Poker Hand #RC95106992: Hold'em No Limit ($0.1/$0.25) - 2020/04/07 16:05:08
Table 'RushAndCash366864' 6-max Seat #1 is the button
Seat 1: 57ff778 ($32.38 in chips)
Seat 2: 8fef8ac2 ($8.69 in chips)
Seat 3: 811232a3 ($36.8 in chips)
Seat 4: Hero ($56.77 in chips)
Seat 5: c2e8a25c ($12.4 in chips)
Seat 6: c5856645 ($32.39 in chips)
8fef8ac2: posts small blind $0.1
811232a3: posts big blind $0.25
*** HOLE CARDS ***
Dealt to 57ff778 
Dealt to 8fef8ac2 
Dealt to 811232a3 
Dealt to Hero [Ah 9s]
Dealt to c2e8a25c 
Dealt to c5856645 
Hero: folds
c2e8a25c: folds
c5856645: raises $0.4 to $0.65
57ff778: folds
8fef8ac2: folds
811232a3: folds
Uncalled bet ($0.4) returned to c5856645
*** SHOWDOWN ***
c5856645 collected $0.6 from pot
*** SUMMARY ***
Total pot $0.6
Seat 1: 57ff778 (button) folded before Flop (didn't bet)
Seat 2: 8fef8ac2 (small blind) folded before Flop
Seat 3: 811232a3 (big blind) folded before Flop
Seat 4: Hero folded before Flop (didn't bet)
Seat 5: c2e8a25c folded before Flop (didn't bet)
Seat 6: c5856645 collected ($0.6)


Poker Hand #RC95107031: Hold'em No Limit ($0.1/$0.25) - 2020/04/07 16:05:15
Table 'RushAndCash366870' 6-max Seat #1 is the button
Seat 1: Hero ($56.77 in chips)
Seat 2: 8b8d197c ($35.33 in chips)
Seat 3: 103129d8 ($42.21 in chips)
Seat 4: fe2378bf ($9.33 in chips)
Seat 5: 13cda138 ($26.76 in chips)
Seat 6: c2e8a25c ($12.4 in chips)
8b8d197c: posts small blind $0.1
103129d8: posts big blind $0.25
*** HOLE CARDS ***
Dealt to Hero [Qd 4s]
Dealt to 8b8d197c 
Dealt to 103129d8 
Dealt to fe2378bf 
Dealt to 13cda138 
Dealt to c2e8a25c 
fe2378bf: folds
13cda138: raises $0.38 to $0.63
c2e8a25c: folds
Hero: folds
8b8d197c: raises $1.77 to $2.4
103129d8: folds
13cda138: calls $1.77
*** FLOP *** [Ac Td Jc]
8b8d197c: bets $2.6
13cda138: folds
Uncalled bet ($2.6) returned to 8b8d197c
*** SHOWDOWN ***
8b8d197c collected $5.05 from pot
*** SUMMARY ***
Total pot $5.05
Board [Ac Td Jc]
Seat 1: Hero (button) folded before Flop (didn't bet)
Seat 2: 8b8d197c (small blind) won ($5.05)
Seat 3: 103129d8 (big blind) folded before Flop
Seat 4: fe2378bf folded before Flop (didn't bet)
Seat 5: 13cda138 folded on the Flop
Seat 6: c2e8a25c folded before Flop (didn't bet)


Poker Hand #RC95107076: Hold'em No Limit ($0.1/$0.25) - 2020/04/07 16:05:21
Table 'RushAndCash366875' 6-max Seat #1 is the button
Seat 1: 4ab4e4a3 ($31.07 in chips)
Seat 2: 7c935d24 ($25.92 in chips)
Seat 3: 57ff778 ($32.38 in chips)
Seat 4: Hero ($56.77 in chips)
Seat 5: 2aaed573 ($8.82 in chips)
Seat 6: 32953d2a ($13.22 in chips)
7c935d24: posts small blind $0.1
57ff778: posts big blind $0.25
*** HOLE CARDS ***
Dealt to 4ab4e4a3 
Dealt to 7c935d24 
Dealt to 57ff778 
Dealt to Hero [Ac 3s]
Dealt to 2aaed573 
Dealt to 32953d2a 
Hero: folds
2aaed573: raises $0.63 to $0.88
32953d2a: folds
4ab4e4a3: folds
7c935d24: folds
57ff778: folds
Uncalled bet ($0.63) returned to 2aaed573
*** SHOWDOWN ***
2aaed573 collected $0.6 from pot
*** SUMMARY ***
Total pot $0.6
Seat 1: 4ab4e4a3 (button) folded before Flop (didn't bet)
Seat 2: 7c935d24 (small blind) folded before Flop
Seat 3: 57ff778 (big blind) folded before Flop
Seat 4: Hero folded before Flop (didn't bet)
Seat 5: 2aaed573 collected ($0.6)
Seat 6: 32953d2a folded before Flop (didn't bet)


Poker Hand #RC95107107: Hold'em No Limit ($0.1/$0.25) - 2020/04/07 16:05:26
Table 'RushAndCash366879' 6-max Seat #1 is the button
Seat 1: aabcb588 ($25.32 in chips)
Seat 2: 23bd7de3 ($12.1 in chips)
Seat 3: 16e6db78 ($10.32 in chips)
Seat 4: Hero ($56.77 in chips)
Seat 5: 4dd920ba ($94.11 in chips)
Seat 6: be711e9d ($33.98 in chips)
23bd7de3: posts small blind $0.1
16e6db78: posts big blind $0.25
*** HOLE CARDS ***
Dealt to aabcb588 
Dealt to 23bd7de3 
Dealt to 16e6db78 
Dealt to Hero [Qd 6s]
Dealt to 4dd920ba 
Dealt to be711e9d 
Hero: folds
4dd920ba: folds
be711e9d: raises $0.38 to $0.63
aabcb588: folds
23bd7de3: folds
16e6db78: calls $0.38
*** FLOP *** [9h 8d 4h]
16e6db78: checks
be711e9d: bets $0.5
16e6db78: folds
Uncalled bet ($0.5) returned to be711e9d
*** SHOWDOWN ***
be711e9d collected $1.36 from pot
*** SUMMARY ***
Total pot $1.36
Board [9h 8d 4h]
Seat 1: aabcb588 (button) folded before Flop (didn't bet)
Seat 2: 23bd7de3 (small blind) folded before Flop
Seat 3: 16e6db78 (big blind) folded on the Flop
Seat 4: Hero folded before Flop (didn't bet)
Seat 5: 4dd920ba folded before Flop (didn't bet)
Seat 6: be711e9d won ($1.36)


Poker Hand #RC95107127: Hold'em No Limit ($0.1/$0.25) - 2020/04/07 16:05:30
Table 'RushAndCash366883' 6-max Seat #1 is the button
Seat 1: 65837850 ($127.24 in chips)
Seat 2: 91db230c ($29.79 in chips)
Seat 3: 421d7a8a ($21.89 in chips)
Seat 4: 982f33b1 ($8.14 in chips)
Seat 5: 5d2a310d ($14.87 in chips)
Seat 6: Hero ($56.77 in chips)
91db230c: posts small blind $0.1
421d7a8a: posts big blind $0.25
*** HOLE CARDS ***
Dealt to 65837850 
Dealt to 91db230c 
Dealt to 421d7a8a 
Dealt to 982f33b1 
Dealt to 5d2a310d 
Dealt to Hero [Qs Ts]
982f33b1: calls $0.25
5d2a310d: folds
Hero: raises $0.85 to $1.1
65837850: folds
91db230c: folds
421d7a8a: folds
982f33b1: folds
Uncalled bet ($0.85) returned to Hero
*** SHOWDOWN ***
Hero collected $0.85 from pot
*** SUMMARY ***
Total pot $0.85
Seat 1: 65837850 (button) folded before Flop (didn't bet)
Seat 2: 91db230c (small blind) folded before Flop
Seat 3: 421d7a8a (big blind) folded before Flop
Seat 4: 982f33b1 folded before Flop
Seat 5: 5d2a310d folded before Flop (didn't bet)
Seat 6: Hero collected ($0.85)


Poker Hand #RC95107461: Hold'em No Limit ($0.1/$0.25) - 2020/04/07 16:06:16
Table 'RushAndCash366924' 6-max Seat #1 is the button
Seat 1: 5d2a310d ($15.45 in chips)
Seat 2: 4dd920ba ($93.26 in chips)
Seat 3: Hero ($57.33 in chips)
Seat 4: 982f33b1 ($7.89 in chips)
Seat 5: 40a91d41 ($25 in chips)
Seat 6: ce59b684 ($44.79 in chips)
4dd920ba: posts small blind $0.1
Hero: posts big blind $0.25
*** HOLE CARDS ***
Dealt to 5d2a310d 
Dealt to 4dd920ba 
Dealt to Hero [Ts 7h]
Dealt to 982f33b1 
Dealt to 40a91d41 
Dealt to ce59b684 
982f33b1: folds
40a91d41: folds
ce59b684: raises $0.38 to $0.63
5d2a310d: folds
4dd920ba: raises $2.12 to $2.75
Hero: folds
ce59b684: calls $2.12
*** FLOP *** [3c 4c 4s]
4dd920ba: bets $3
ce59b684: calls $3
*** TURN *** [3c 4c 4s] [5c]
4dd920ba: checks
ce59b684: bets $7.55
4dd920ba: folds
Uncalled bet ($7.55) returned to ce59b684
*** SHOWDOWN ***
ce59b684 collected $11.75 from pot
*** SUMMARY ***
Total pot $11.75
Board [3c 4c 4s 5c]
Seat 1: 5d2a310d (button) folded before Flop (didn't bet)
Seat 2: 4dd920ba (small blind) folded on the Turn
Seat 3: Hero (big blind) folded before Flop
Seat 4: 982f33b1 folded before Flop (didn't bet)
Seat 5: 40a91d41 folded before Flop (didn't bet)
Seat 6: ce59b684 won ($11.75)


Poker Hand #RC95107566: Hold'em No Limit ($0.1/$0.25) - 2020/04/07 16:06:31
Table 'RushAndCash366935' 6-max Seat #1 is the button
Seat 1: c32ac86b ($26.14 in chips)
Seat 2: a6846758 ($46.28 in chips)
Seat 3: Hero ($57.08 in chips)
Seat 4: 7c0ffa93 ($48.11 in chips)
Seat 5: ec1c524d ($25.35 in chips)
Seat 6: 403fa816 ($8.97 in chips)
a6846758: posts small blind $0.1
Hero: posts big blind $0.25
*** HOLE CARDS ***
Dealt to c32ac86b 
Dealt to a6846758 
Dealt to Hero [5s 4c]
Dealt to 7c0ffa93 
Dealt to ec1c524d 
Dealt to 403fa816 
7c0ffa93: folds
ec1c524d: folds
403fa816: folds
c32ac86b: raises $0.38 to $0.63
a6846758: folds
Hero: folds
Uncalled bet ($0.38) returned to c32ac86b
*** SHOWDOWN ***
c32ac86b collected $0.6 from pot
*** SUMMARY ***
Total pot $0.6
Seat 1: c32ac86b (button) collected ($0.6)
Seat 2: a6846758 (small blind) folded before Flop
Seat 3: Hero (big blind) folded before Flop
Seat 4: 7c0ffa93 folded before Flop (didn't bet)
Seat 5: ec1c524d folded before Flop (didn't bet)
Seat 6: 403fa816 folded before Flop (didn't bet)


Poker Hand #RC95107612: Hold'em No Limit ($0.1/$0.25) - 2020/04/07 16:06:37
Table 'RushAndCash366939' 6-max Seat #1 is the button
Seat 1: aabcb588 ($25 in chips)
Seat 2: 8fef8ac2 ($8.34 in chips)
Seat 3: 8902e20 ($12.66 in chips)
Seat 4: 8b8d197c ($38.74 in chips)
Seat 5: a4ba858f ($55.38 in chips)
Seat 6: Hero ($56.83 in chips)
8fef8ac2: posts small blind $0.1
8902e20: posts big blind $0.25
*** HOLE CARDS ***
Dealt to aabcb588 
Dealt to 8fef8ac2 
Dealt to 8902e20 
Dealt to 8b8d197c 
Dealt to a4ba858f 
Dealt to Hero [As 7d]
8b8d197c: raises $0.38 to $0.63
a4ba858f: folds
Hero: folds
aabcb588: folds
8fef8ac2: calls $0.53
8902e20: folds
*** FLOP *** [3h Jh 5s]
8fef8ac2: checks
8b8d197c: checks
*** TURN *** [3h Jh 5s] [8d]
8fef8ac2: checks
8b8d197c: checks
*** RIVER *** [3h Jh 5s 8d] [9d]
8fef8ac2: checks
8b8d197c: checks
8fef8ac2: shows [Ah 2h] (Ace-High)
8b8d197c: shows [Kh Ad] (Ace-High)
*** SHOWDOWN ***
8b8d197c collected $1.51 from pot
*** SUMMARY ***
Total pot $1.51
Board [3h Jh 5s 8d 9d]
Seat 1: aabcb588 (button) folded before Flop (didn't bet)
Seat 2: 8fef8ac2 (small blind) showed [Ah 2h] and lost with Ace-High
Seat 3: 8902e20 (big blind) folded before Flop
Seat 4: 8b8d197c showed [Ad Kh] and won ($1.51) with Ace-High
Seat 5: a4ba858f folded before Flop (didn't bet)
Seat 6: Hero folded before Flop (didn't bet)


Poker Hand #RC95107687: Hold'em No Limit ($0.1/$0.25) - 2020/04/07 16:06:46
Table 'RushAndCash366948' 6-max Seat #1 is the button
Seat 1: 421d7a8a ($21.19 in chips)
Seat 2: Hero ($56.83 in chips)
Seat 3: dcdc0b92 ($25 in chips)
Seat 4: 8902e20 ($12.41 in chips)
Seat 5: f178c62c ($36.32 in chips)
Seat 6: be3950eb ($25 in chips)
Hero: posts small blind $0.1
dcdc0b92: posts big blind $0.25
*** HOLE CARDS ***
Dealt to 421d7a8a 
Dealt to Hero [8h 6s]
Dealt to dcdc0b92 
Dealt to 8902e20 
Dealt to f178c62c 
Dealt to be3950eb 
8902e20: folds
f178c62c: folds
be3950eb: folds
421d7a8a: raises $0.5 to $0.75
Hero: folds
dcdc0b92: folds
Uncalled bet ($0.5) returned to 421d7a8a
*** SHOWDOWN ***
421d7a8a collected $0.6 from pot
*** SUMMARY ***
Total pot $0.6
Seat 1: 421d7a8a (button) collected ($0.6)
Seat 2: Hero (small blind) folded before Flop
Seat 3: dcdc0b92 (big blind) folded before Flop
Seat 4: 8902e20 folded before Flop (didn't bet)
Seat 5: f178c62c folded before Flop (didn't bet)
Seat 6: be3950eb folded before Flop (didn't bet)


Poker Hand #RC95107776: Hold'em No Limit ($0.1/$0.25) - 2020/04/07 16:06:58
Table 'RushAndCash366957' 6-max Seat #1 is the button
Seat 1: 23bd7de3 ($14.74 in chips)
Seat 2: Hero ($56.73 in chips)
Seat 3: 8902e20 ($12.41 in chips)
Seat 4: 57ff778 ($31.5 in chips)
Seat 5: 6185872b ($5.95 in chips)
Seat 6: 5d2a310d ($15.35 in chips)
Hero: posts small blind $0.1
8902e20: posts big blind $0.25
*** HOLE CARDS ***
Dealt to 23bd7de3 
Dealt to Hero [7d 3h]
Dealt to 8902e20 
Dealt to 57ff778 
Dealt to 6185872b 
Dealt to 5d2a310d 
57ff778: folds
6185872b: folds
5d2a310d: folds
23bd7de3: folds
Hero: folds
Uncalled bet ($0.15) returned to 8902e20
*** SHOWDOWN ***
8902e20 collected $0.2 from pot
*** SUMMARY ***
Total pot $0.2
Seat 1: 23bd7de3 (button) folded before Flop (didn't bet)
Seat 2: Hero (small blind) folded before Flop
Seat 3: 8902e20 (big blind) collected ($0.2)
Seat 4: 57ff778 folded before Flop (didn't bet)
Seat 5: 6185872b folded before Flop (didn't bet)
Seat 6: 5d2a310d folded before Flop (didn't bet)


Poker Hand #RC95107816: Hold'em No Limit ($0.1/$0.25) - 2020/04/07 16:07:04
Table 'RushAndCash366961' 6-max Seat #1 is the button
Seat 1: 16e6db78 ($9.69 in chips)
Seat 2: dcdc0b92 ($24.75 in chips)
Seat 3: 5be1f3e6 ($25.81 in chips)
Seat 4: 8ac4f082 ($25 in chips)
Seat 5: be3950eb ($25 in chips)
Seat 6: Hero ($56.63 in chips)
dcdc0b92: posts small blind $0.1
5be1f3e6: posts big blind $0.25
*** HOLE CARDS ***
Dealt to 16e6db78 
Dealt to dcdc0b92 
Dealt to 5be1f3e6 
Dealt to 8ac4f082 
Dealt to be3950eb 
Dealt to Hero [8d 4c]
8ac4f082: raises $0.38 to $0.63
be3950eb: folds
Hero: folds
16e6db78: raises $1.52 to $2.15
dcdc0b92: folds
5be1f3e6: folds
8ac4f082: folds
Uncalled bet ($1.52) returned to 16e6db78
*** SHOWDOWN ***
16e6db78 collected $1.61 from pot
*** SUMMARY ***
Total pot $1.61
Seat 1: 16e6db78 (button) collected ($1.61)
Seat 2: dcdc0b92 (small blind) folded before Flop
Seat 3: 5be1f3e6 (big blind) folded before Flop
Seat 4: 8ac4f082 folded before Flop
Seat 5: be3950eb folded before Flop (didn't bet)
Seat 6: Hero folded before Flop (didn't bet)


Poker Hand #RC95107879: Hold'em No Limit ($0.1/$0.25) - 2020/04/07 16:07:14
Table 'RushAndCash366968' 6-max Seat #1 is the button
Seat 1: Hero ($56.63 in chips)
Seat 2: 421d7a8a ($21.29 in chips)
Seat 3: bab42c59 ($24.64 in chips)
Seat 4: 488a0674 ($21.73 in chips)
Seat 5: 7ed3ab6b ($47.78 in chips)
Seat 6: 57ff778 ($31.5 in chips)
421d7a8a: posts small blind $0.1
bab42c59: posts big blind $0.25
*** HOLE CARDS ***
Dealt to Hero [Th 6d]
Dealt to 421d7a8a 
Dealt to bab42c59 
Dealt to 488a0674 
Dealt to 7ed3ab6b 
Dealt to 57ff778 
488a0674: folds
7ed3ab6b: folds
57ff778: folds
Hero: folds
421d7a8a: folds
Uncalled bet ($0.15) returned to bab42c59
*** SHOWDOWN ***
bab42c59 collected $0.2 from pot
*** SUMMARY ***
Total pot $0.2
Seat 1: Hero (button) folded before Flop (didn't bet)
Seat 2: 421d7a8a (small blind) folded before Flop
Seat 3: bab42c59 (big blind) collected ($0.2)
Seat 4: 488a0674 folded before Flop (didn't bet)
Seat 5: 7ed3ab6b folded before Flop (didn't bet)
Seat 6: 57ff778 folded before Flop (didn't bet)


Poker Hand #RC95107970: Hold'em No Limit ($0.1/$0.25) - 2020/04/07 16:07:29
Table 'RushAndCash366978' 6-max Seat #1 is the button
Seat 1: Hero ($56.63 in chips)
Seat 2: 2d45ce80 ($16.49 in chips)
Seat 3: 8ac4f082 ($25 in chips)
Seat 4: 5215e35b ($19.05 in chips)
Seat 5: fc8a29ea ($49.74 in chips)
Seat 6: 181b6319 ($26.26 in chips)
2d45ce80: posts small blind $0.1
8ac4f082: posts big blind $0.25
*** HOLE CARDS ***
Dealt to Hero [Tc 5d]
Dealt to 2d45ce80 
Dealt to 8ac4f082 
Dealt to 5215e35b 
Dealt to fc8a29ea 
Dealt to 181b6319 
5215e35b: folds
fc8a29ea: raises $0.38 to $0.63
181b6319: folds
Hero: folds
2d45ce80: folds
8ac4f082: folds
Uncalled bet ($0.38) returned to fc8a29ea
*** SHOWDOWN ***
fc8a29ea collected $0.6 from pot
*** SUMMARY ***
Total pot $0.6
Seat 1: Hero (button) folded before Flop (didn't bet)
Seat 2: 2d45ce80 (small blind) folded before Flop
Seat 3: 8ac4f082 (big blind) folded before Flop
Seat 4: 5215e35b folded before Flop (didn't bet)
Seat 5: fc8a29ea collected ($0.6)
Seat 6: 181b6319 folded before Flop (didn't bet)


Poker Hand #RC95108037: Hold'em No Limit ($0.1/$0.25) - 2020/04/07 16:07:37
Table 'RushAndCash366984' 6-max Seat #1 is the button
Seat 1: 4ab4e4a3 ($31.07 in chips)
Seat 2: d07b3de1 ($37.89 in chips)
Seat 3: 5be1f3e6 ($25.46 in chips)
Seat 4: 16e6db78 ($10.49 in chips)
Seat 5: Hero ($56.63 in chips)
Seat 6: 275e7f74 ($70.97 in chips)
d07b3de1: posts small blind $0.1
5be1f3e6: posts big blind $0.25
*** HOLE CARDS ***
Dealt to 4ab4e4a3 
Dealt to d07b3de1 
Dealt to 5be1f3e6 
Dealt to 16e6db78 
Dealt to Hero [9h 8s]
Dealt to 275e7f74 
16e6db78: raises $0.38 to $0.63
Hero: folds
275e7f74: folds
4ab4e4a3: folds
d07b3de1: folds
5be1f3e6: calls $0.38
*** FLOP *** [7h 9s 4d]
5be1f3e6: checks
16e6db78: bets $1.1
5be1f3e6: calls $1.1
*** TURN *** [7h 9s 4d] [2d]
5be1f3e6: checks
16e6db78: bets $2.95
5be1f3e6: calls $2.95
*** RIVER *** [7h 9s 4d 2d] [4s]
5be1f3e6: checks
16e6db78: bets $5.81 and is all-in
5be1f3e6: folds
Uncalled bet ($5.81) returned to 16e6db78
*** SHOWDOWN ***
16e6db78 collected $9.46 from pot
*** SUMMARY ***
Total pot $9.46
Board [7h 9s 4d 2d 4s]
Seat 1: 4ab4e4a3 (button) folded before Flop (didn't bet)
Seat 2: d07b3de1 (small blind) folded before Flop
Seat 3: 5be1f3e6 (big blind) folded on the River
Seat 4: 16e6db78 won ($9.46)
Seat 5: Hero folded before Flop (didn't bet)
Seat 6: 275e7f74 folded before Flop (didn't bet)


Poker Hand #RC95108068: Hold'em No Limit ($0.1/$0.25) - 2020/04/07 16:07:42
Table 'RushAndCash366987' 6-max Seat #1 is the button
Seat 1: be3950eb ($25.35 in chips)
Seat 2: f178c62c ($36.07 in chips)
Seat 3: a1e9a341 ($30.98 in chips)
Seat 4: 403fa816 ($9.32 in chips)
Seat 5: 5215e35b ($19.05 in chips)
Seat 6: Hero ($56.63 in chips)
f178c62c: posts small blind $0.1
a1e9a341: posts big blind $0.25
*** HOLE CARDS ***
Dealt to be3950eb 
Dealt to f178c62c 
Dealt to a1e9a341 
Dealt to 403fa816 
Dealt to 5215e35b 
Dealt to Hero [Kd Js]
403fa816: folds
5215e35b: folds
Hero: raises $0.38 to $0.63
be3950eb: raises $1.63 to $2.26
f178c62c: folds
a1e9a341: folds
Hero: folds
Uncalled bet ($1.63) returned to be3950eb
*** SHOWDOWN ***
be3950eb collected $1.61 from pot
*** SUMMARY ***
Total pot $1.61
Seat 1: be3950eb (button) collected ($1.61)
Seat 2: f178c62c (small blind) folded before Flop
Seat 3: a1e9a341 (big blind) folded before Flop
Seat 4: 403fa816 folded before Flop (didn't bet)
Seat 5: 5215e35b folded before Flop (didn't bet)
Seat 6: Hero folded before Flop


Poker Hand #RC95108337: Hold'em No Limit ($0.1/$0.25) - 2020/04/07 16:08:18
Table 'RushAndCash367015' 6-max Seat #1 is the button
Seat 1: fc8a29ea ($50.44 in chips)
Seat 2: f92ad063 ($26.35 in chips)
Seat 3: d07b3de1 ($37.79 in chips)
Seat 4: be3950eb ($26.25 in chips)
Seat 5: 4dd920ba ($87.61 in chips)
Seat 6: Hero ($56 in chips)
f92ad063: posts small blind $0.1
d07b3de1: posts big blind $0.25
*** HOLE CARDS ***
Dealt to fc8a29ea 
Dealt to f92ad063 
Dealt to d07b3de1 
Dealt to be3950eb 
Dealt to 4dd920ba 
Dealt to Hero [6d 3c]
be3950eb: folds
4dd920ba: raises $0.5 to $0.75
Hero: folds
fc8a29ea: folds
f92ad063: folds
d07b3de1: folds
Uncalled bet ($0.5) returned to 4dd920ba
*** SHOWDOWN ***
4dd920ba collected $0.6 from pot
*** SUMMARY ***
Total pot $0.6
Seat 1: fc8a29ea (button) folded before Flop (didn't bet)
Seat 2: f92ad063 (small blind) folded before Flop
Seat 3: d07b3de1 (big blind) folded before Flop
Seat 4: be3950eb folded before Flop (didn't bet)
Seat 5: 4dd920ba collected ($0.6)
Seat 6: Hero folded before Flop (didn't bet)


Poker Hand #RC95108415: Hold'em No Limit ($0.1/$0.25) - 2020/04/07 16:08:30
Table 'RushAndCash367022' 6-max Seat #1 is the button
Seat 1: 417e16c9 ($11.3 in chips)
Seat 2: Hero ($56 in chips)
Seat 3: 5215e35b ($19.3 in chips)
Seat 4: a1e9a341 ($30.63 in chips)
Seat 5: aabcb588 ($25 in chips)
Seat 6: 30cab83a ($74.31 in chips)
Hero: posts small blind $0.1
5215e35b: posts big blind $0.25
*** HOLE CARDS ***
Dealt to 417e16c9 
Dealt to Hero [Qs 4h]
Dealt to 5215e35b 
Dealt to a1e9a341 
Dealt to aabcb588 
Dealt to 30cab83a 
a1e9a341: raises $0.38 to $0.63
aabcb588: folds
30cab83a: calls $0.63
417e16c9: folds
Hero: folds
5215e35b: folds
*** FLOP *** [6c Ks 2c]
a1e9a341: bets $0.6
30cab83a: calls $0.6
*** TURN *** [6c Ks 2c] [Ac]
a1e9a341: bets $1.5
30cab83a: calls $1.5
*** RIVER *** [6c Ks 2c Ac] [5s]
a1e9a341: checks
30cab83a: checks
a1e9a341: shows [8s 8c] (Pair of Eights)
30cab83a: shows [Ad Ts] (Pair of Aces)
*** SHOWDOWN ***
30cab83a collected $5.81 from pot
*** SUMMARY ***
Total pot $5.81
Board [6c Ks 2c Ac 5s]
Seat 1: 417e16c9 (button) folded before Flop (didn't bet)
Seat 2: Hero (small blind) folded before Flop
Seat 3: 5215e35b (big blind) folded before Flop
Seat 4: a1e9a341 showed [8s 8c] and lost with Pair of Eights
Seat 5: aabcb588 folded before Flop (didn't bet)
Seat 6: 30cab83a showed [Ad Ts] and won ($5.81) with Pair of Aces


Poker Hand #RC95108472: Hold'em No Limit ($0.1/$0.25) - 2020/04/07 16:08:39
Table 'RushAndCash367027' 6-max Seat #1 is the button
Seat 1: 7ed3ab6b ($25 in chips)
Seat 2: 9c6a9689 ($25 in chips)
Seat 3: 563c733 ($25 in chips)
Seat 4: 488a0674 ($21.03 in chips)
Seat 5: f92ad063 ($26.25 in chips)
Seat 6: Hero ($55.9 in chips)
9c6a9689: posts small blind $0.1
563c733: posts big blind $0.25
*** HOLE CARDS ***
Dealt to 7ed3ab6b 
Dealt to 9c6a9689 
Dealt to 563c733 
Dealt to 488a0674 
Dealt to f92ad063 
Dealt to Hero [9h 9d]
488a0674: folds
f92ad063: folds
Hero: folds
7ed3ab6b: folds
9c6a9689: folds
Uncalled bet ($0.15) returned to 563c733
*** SHOWDOWN ***
563c733 collected $0.2 from pot
*** SUMMARY ***
Total pot $0.2
Seat 1: 7ed3ab6b (button) folded before Flop (didn't bet)
Seat 2: 9c6a9689 (small blind) folded before Flop
Seat 3: 563c733 (big blind) collected ($0.2)
Seat 4: 488a0674 folded before Flop (didn't bet)
Seat 5: f92ad063 folded before Flop (didn't bet)
Seat 6: Hero folded before Flop (didn't bet)


Poker Hand #RC95108519: Hold'em No Limit ($0.1/$0.25) - 2020/04/07 16:08:46
Table 'RushAndCash367032' 6-max Seat #1 is the button
Seat 1: 6f1c538f ($25.32 in chips)
Seat 2: 38e0f2fb ($23.47 in chips)
Seat 3: e5b62e2d ($25 in chips)
Seat 4: 459706be ($23 in chips)
Seat 5: c18bce1f ($26.16 in chips)
Seat 6: Hero ($55.9 in chips)
38e0f2fb: posts small blind $0.1
e5b62e2d: posts big blind $0.25
*** HOLE CARDS ***
Dealt to 6f1c538f 
Dealt to 38e0f2fb 
Dealt to e5b62e2d 
Dealt to 459706be 
Dealt to c18bce1f 
Dealt to Hero [3s 3d]
459706be: raises $0.5 to $0.75
c18bce1f: folds
Hero: folds
6f1c538f: folds
38e0f2fb: folds
e5b62e2d: calls $0.5
*** FLOP *** [4s 5d 8h]
e5b62e2d: checks
459706be: checks
*** TURN *** [4s 5d 8h] [2c]
e5b62e2d: checks
459706be: bets $0.8
e5b62e2d: folds
Uncalled bet ($0.8) returned to 459706be
*** SHOWDOWN ***
459706be collected $1.6 from pot
*** SUMMARY ***
Total pot $1.6
Board [4s 5d 8h 2c]
Seat 1: 6f1c538f (button) folded before Flop (didn't bet)
Seat 2: 38e0f2fb (small blind) folded before Flop
Seat 3: e5b62e2d (big blind) folded on the Turn
Seat 4: 459706be won ($1.6)
Seat 5: c18bce1f folded before Flop (didn't bet)
Seat 6: Hero folded before Flop (didn't bet)


Poker Hand #RC95108585: Hold'em No Limit ($0.1/$0.25) - 2020/04/07 16:08:55
Table 'RushAndCash367037' 6-max Seat #1 is the button
Seat 1: 421d7a8a ($20.59 in chips)
Seat 2: 9b075290 ($25 in chips)
Seat 3: Hero ($55.9 in chips)
Seat 4: 4ab4e4a3 ($29.97 in chips)
Seat 5: 23bd7de3 ($14.14 in chips)
Seat 6: 982f33b1 ($16.13 in chips)
9b075290: posts small blind $0.1
Hero: posts big blind $0.25
*** HOLE CARDS ***
Dealt to 421d7a8a 
Dealt to 9b075290 
Dealt to Hero [Ac 8s]
Dealt to 4ab4e4a3 
Dealt to 23bd7de3 
Dealt to 982f33b1 
4ab4e4a3: folds
23bd7de3: folds
982f33b1: folds
421d7a8a: folds
9b075290: raises $0.5 to $0.75
Hero: calls $0.5
*** FLOP *** [2s Kd 2c]
9b075290: bets $0.5
Hero: calls $0.5
*** TURN *** [2s Kd 2c] [Kc]
9b075290: checks
Hero: checks
*** RIVER *** [2s Kd 2c Kc] [8c]
9b075290: checks
Hero: bets $1.9
9b075290: folds
Uncalled bet ($1.9) returned to Hero
*** SHOWDOWN ***
Hero collected $2.5 from pot
*** SUMMARY ***
Total pot $2.5
Board [2s Kd 2c Kc 8c]
Seat 1: 421d7a8a (button) folded before Flop (didn't bet)
Seat 2: 9b075290 (small blind) folded on the River
Seat 3: Hero (big blind) won ($2.5)
Seat 4: 4ab4e4a3 folded before Flop (didn't bet)
Seat 5: 23bd7de3 folded before Flop (didn't bet)
Seat 6: 982f33b1 folded before Flop (didn't bet)


Poker Hand #RC95108972: Hold'em No Limit ($0.1/$0.25) - 2020/04/07 16:09:52
Table 'RushAndCash367080' 6-max Seat #1 is the button
Seat 1: Hero ($57.03 in chips)
Seat 2: a6846758 ($40.72 in chips)
Seat 3: 5be1f3e6 ($30.86 in chips)
Seat 4: 3f28d259 ($25 in chips)
Seat 5: 62eebc49 ($103.49 in chips)
Seat 6: 91db230c ($32.45 in chips)
a6846758: posts small blind $0.1
5be1f3e6: posts big blind $0.25
*** HOLE CARDS ***
Dealt to Hero [Qh 7h]
Dealt to a6846758 
Dealt to 5be1f3e6 
Dealt to 3f28d259 
Dealt to 62eebc49 
Dealt to 91db230c 
3f28d259: folds
62eebc49: raises $0.38 to $0.63
91db230c: folds
Hero: folds
a6846758: folds
5be1f3e6: calls $0.38
*** FLOP *** [Js 8h Jd]
5be1f3e6: checks
62eebc49: bets $0.5
5be1f3e6: folds
Uncalled bet ($0.5) returned to 62eebc49
*** SHOWDOWN ***
62eebc49 collected $1.36 from pot
*** SUMMARY ***
Total pot $1.36
Board [Js 8h Jd]
Seat 1: Hero (button) folded before Flop (didn't bet)
Seat 2: a6846758 (small blind) folded before Flop
Seat 3: 5be1f3e6 (big blind) folded on the Flop
Seat 4: 3f28d259 folded before Flop (didn't bet)
Seat 5: 62eebc49 won ($1.36)
Seat 6: 91db230c folded before Flop (didn't bet)


Poker Hand #RC95109043: Hold'em No Limit ($0.1/$0.25) - 2020/04/07 16:10:01
Table 'RushAndCash367091' 6-max Seat #1 is the button
Seat 1: a0877c39 ($25.57 in chips)
Seat 2: 2e4e94f0 ($11.75 in chips)
Seat 3: 23bd7de3 ($13.94 in chips)
Seat 4: Hero ($57.03 in chips)
Seat 5: a6846758 ($40.62 in chips)
Seat 6: 40529527 ($12.5 in chips)
2e4e94f0: posts small blind $0.1
23bd7de3: posts big blind $0.25
*** HOLE CARDS ***
Dealt to a0877c39 
Dealt to 2e4e94f0 
Dealt to 23bd7de3 
Dealt to Hero [Kc 3h]
Dealt to a6846758 
Dealt to 40529527 
Hero: folds
a6846758: folds
40529527: folds
a0877c39: raises $0.38 to $0.63
2e4e94f0: folds
23bd7de3: folds
Uncalled bet ($0.38) returned to a0877c39
*** SHOWDOWN ***
a0877c39 collected $0.6 from pot
*** SUMMARY ***
Total pot $0.6
Seat 1: a0877c39 (button) collected ($0.6)
Seat 2: 2e4e94f0 (small blind) folded before Flop
Seat 3: 23bd7de3 (big blind) folded before Flop
Seat 4: Hero folded before Flop (didn't bet)
Seat 5: a6846758 folded before Flop (didn't bet)
Seat 6: 40529527 folded before Flop (didn't bet)


Poker Hand #RC95109085: Hold'em No Limit ($0.1/$0.25) - 2020/04/07 16:10:06
Table 'RushAndCash367099' 6-max Seat #1 is the button
Seat 1: bdffd813 ($32.98 in chips)
Seat 2: af7077e5 ($16.46 in chips)
Seat 3: a4ba858f ($60.34 in chips)
Seat 4: a9313012 ($12.5 in chips)
Seat 5: e5b62e2d ($25 in chips)
Seat 6: Hero ($57.03 in chips)
af7077e5: posts small blind $0.1
a4ba858f: posts big blind $0.25
*** HOLE CARDS ***
Dealt to bdffd813 
Dealt to af7077e5 
Dealt to a4ba858f 
Dealt to a9313012 
Dealt to e5b62e2d 
Dealt to Hero [Th 6c]
a9313012: folds
e5b62e2d: folds
Hero: folds
bdffd813: folds
af7077e5: folds
Uncalled bet ($0.15) returned to a4ba858f
*** SHOWDOWN ***
a4ba858f collected $0.2 from pot
*** SUMMARY ***
Total pot $0.2
Seat 1: bdffd813 (button) folded before Flop (didn't bet)
Seat 2: af7077e5 (small blind) folded before Flop
Seat 3: a4ba858f (big blind) collected ($0.2)
Seat 4: a9313012 folded before Flop (didn't bet)
Seat 5: e5b62e2d folded before Flop (didn't bet)
Seat 6: Hero folded before Flop (didn't bet)


Poker Hand #RC95109112: Hold'em No Limit ($0.1/$0.25) - 2020/04/07 16:10:10
Table 'RushAndCash367104' 6-max Seat #1 is the button
Seat 1: c32ac86b ($25 in chips)
Seat 2: a6846758 ($40.62 in chips)
Seat 3: Hero ($57.03 in chips)
Seat 4: a9313012 ($12.5 in chips)
Seat 5: 20e032a ($25 in chips)
Seat 6: df1a836a ($25 in chips)
a6846758: posts small blind $0.1
Hero: posts big blind $0.25
*** HOLE CARDS ***
Dealt to c32ac86b 
Dealt to a6846758 
Dealt to Hero [8h 5s]
Dealt to a9313012 
Dealt to 20e032a 
Dealt to df1a836a 
a9313012: folds
20e032a: folds
df1a836a: raises $0.38 to $0.63
c32ac86b: folds
a6846758: folds
Hero: folds
Uncalled bet ($0.38) returned to df1a836a
*** SHOWDOWN ***
df1a836a collected $0.6 from pot
*** SUMMARY ***
Total pot $0.6
Seat 1: c32ac86b (button) folded before Flop (didn't bet)
Seat 2: a6846758 (small blind) folded before Flop
Seat 3: Hero (big blind) folded before Flop
Seat 4: a9313012 folded before Flop (didn't bet)
Seat 5: 20e032a folded before Flop (didn't bet)
Seat 6: df1a836a collected ($0.6)


Poker Hand #RC95109142: Hold'em No Limit ($0.1/$0.25) - 2020/04/07 16:10:14
Table 'RushAndCash367108' 6-max Seat #1 is the button
Seat 1: 5d2a310d ($15.55 in chips)
Seat 2: af97cfc8 ($25.77 in chips)
Seat 3: aabcb588 ($25 in chips)
Seat 4: Hero ($56.78 in chips)
Seat 5: deb69778 ($25.32 in chips)
Seat 6: 563c733 ($25 in chips)
af97cfc8: posts small blind $0.1
aabcb588: posts big blind $0.25
*** HOLE CARDS ***
Dealt to 5d2a310d 
Dealt to af97cfc8 
Dealt to aabcb588 
Dealt to Hero [5s 2d]
Dealt to deb69778 
Dealt to 563c733 
Hero: folds
deb69778: folds
563c733: folds
5d2a310d: raises $0.25 to $0.5
af97cfc8: folds
aabcb588: calls $0.25
*** FLOP *** [8s 5h 9c]
aabcb588: checks
5d2a310d: bets $0.9
aabcb588: calls $0.9
*** TURN *** [8s 5h 9c] [8c]
aabcb588: checks
5d2a310d: bets $2.2
aabcb588: calls $2.2
*** RIVER *** [8s 5h 9c 8c] [Qs]
aabcb588: checks
5d2a310d: checks
aabcb588: shows [9d Qc] (Pair of Queens and Pair of Nines)
5d2a310d: shows [7c Ac] (Pair of Eights)
*** SHOWDOWN ***
aabcb588 collected $7.3 from pot
*** SUMMARY ***
Total pot $7.3
Board [8s 5h 9c 8c Qs]
Seat 1: 5d2a310d (button) showed [Ac 7c] and lost with Pair of Eights
Seat 2: af97cfc8 (small blind) folded before Flop
Seat 3: aabcb588 (big blind) showed [Qc 9d] and won ($7.3) with Pair of Queens and Pair of Nines
Seat 4: Hero folded before Flop (didn't bet)
Seat 5: deb69778 folded before Flop (didn't bet)
Seat 6: 563c733 folded before Flop (didn't bet)


Poker Hand #RC95109172: Hold'em No Limit ($0.1/$0.25) - 2020/04/07 16:10:17
Table 'RushAndCash367114' 6-max Seat #1 is the button
Seat 1: 7ed3ab6b ($25 in chips)
Seat 2: 6b7fc6e4 ($28.54 in chips)
Seat 3: d2986703 ($25.7 in chips)
Seat 4: Hero ($56.78 in chips)
Seat 5: ce9b7dee ($25 in chips)
Seat 6: fc8a29ea ($49.71 in chips)
6b7fc6e4: posts small blind $0.1
d2986703: posts big blind $0.25
*** HOLE CARDS ***
Dealt to 7ed3ab6b 
Dealt to 6b7fc6e4 
Dealt to d2986703 
Dealt to Hero [As Qd]
Dealt to ce9b7dee 
Dealt to fc8a29ea 
Hero: raises $0.38 to $0.63
ce9b7dee: folds
fc8a29ea: folds
7ed3ab6b: folds
6b7fc6e4: folds
d2986703: folds
Uncalled bet ($0.38) returned to Hero
*** SHOWDOWN ***
Hero collected $0.6 from pot
*** SUMMARY ***
Total pot $0.6
Seat 1: 7ed3ab6b (button) folded before Flop (didn't bet)
Seat 2: 6b7fc6e4 (small blind) folded before Flop
Seat 3: d2986703 (big blind) folded before Flop
Seat 4: Hero collected ($0.6)
Seat 5: ce9b7dee folded before Flop (didn't bet)
Seat 6: fc8a29ea folded before Flop (didn't bet)


Poker Hand #RC95109276: Hold'em No Limit ($0.1/$0.25) - 2020/04/07 16:10:31
Table 'RushAndCash367132' 6-max Seat #1 is the button
Seat 1: ce59b684 ($58.87 in chips)
Seat 2: Hero ($57.13 in chips)
Seat 3: 1c78f672 ($25.6 in chips)
Seat 4: 2e4e94f0 ($11.65 in chips)
Seat 5: 181b6319 ($23.75 in chips)
Seat 6: c32ac86b ($25 in chips)
Hero: posts small blind $0.1
1c78f672: posts big blind $0.25
*** HOLE CARDS ***
Dealt to ce59b684 
Dealt to Hero [6c 3d]
Dealt to 1c78f672 
Dealt to 2e4e94f0 
Dealt to 181b6319 
Dealt to c32ac86b 
2e4e94f0: folds
181b6319: folds
c32ac86b: raises $0.38 to $0.63
ce59b684: folds
Hero: folds
1c78f672: folds
Uncalled bet ($0.38) returned to c32ac86b
*** SHOWDOWN ***
c32ac86b collected $0.6 from pot
*** SUMMARY ***
Total pot $0.6
Seat 1: ce59b684 (button) folded before Flop (didn't bet)
Seat 2: Hero (small blind) folded before Flop
Seat 3: 1c78f672 (big blind) folded before Flop
Seat 4: 2e4e94f0 folded before Flop (didn't bet)
Seat 5: 181b6319 folded before Flop (didn't bet)
Seat 6: c32ac86b collected ($0.6)


Poker Hand #RC95109308: Hold'em No Limit ($0.1/$0.25) - 2020/04/07 16:10:36
Table 'RushAndCash367137' 6-max Seat #1 is the button
Seat 1: Hero ($57.03 in chips)
Seat 2: a4ba858f ($60.44 in chips)
Seat 3: bab42c59 ($27.32 in chips)
Seat 4: df1a836a ($25.35 in chips)
Seat 5: 2e4e94f0 ($11.65 in chips)
Seat 6: ce59b684 ($58.87 in chips)
a4ba858f: posts small blind $0.1
bab42c59: posts big blind $0.25
*** HOLE CARDS ***
Dealt to Hero [Ac 2s]
Dealt to a4ba858f 
Dealt to bab42c59 
Dealt to df1a836a 
Dealt to 2e4e94f0 
Dealt to ce59b684 
df1a836a: folds
2e4e94f0: folds
ce59b684: folds
Hero: folds
a4ba858f: folds
Uncalled bet ($0.15) returned to bab42c59
*** SHOWDOWN ***
bab42c59 collected $0.2 from pot
*** SUMMARY ***
Total pot $0.2
Seat 1: Hero (button) folded before Flop (didn't bet)
Seat 2: a4ba858f (small blind) folded before Flop
Seat 3: bab42c59 (big blind) collected ($0.2)
Seat 4: df1a836a folded before Flop (didn't bet)
Seat 5: 2e4e94f0 folded before Flop (didn't bet)
Seat 6: ce59b684 folded before Flop (didn't bet)


Poker Hand #RC95109336: Hold'em No Limit ($0.1/$0.25) - 2020/04/07 16:10:40
Table 'RushAndCash367141' 6-max Seat #1 is the button
Seat 1: 8baa2ffa ($12.5 in chips)
Seat 2: c72d31c5 ($25 in chips)
Seat 3: d95bc49d ($11.37 in chips)
Seat 4: 91db230c ($32.3 in chips)
Seat 5: 38e0f2fb ($23.8 in chips)
Seat 6: Hero ($57.03 in chips)
c72d31c5: posts small blind $0.1
d95bc49d: posts big blind $0.25
*** HOLE CARDS ***
Dealt to 8baa2ffa 
Dealt to c72d31c5 
Dealt to d95bc49d 
Dealt to 91db230c 
Dealt to 38e0f2fb 
Dealt to Hero [Kd Qs]
91db230c: folds
38e0f2fb: folds
Hero: raises $0.38 to $0.63
8baa2ffa: folds
c72d31c5: folds
d95bc49d: folds
Uncalled bet ($0.38) returned to Hero
*** SHOWDOWN ***
Hero collected $0.6 from pot
*** SUMMARY ***
Total pot $0.6
Seat 1: 8baa2ffa (button) folded before Flop (didn't bet)
Seat 2: c72d31c5 (small blind) folded before Flop
Seat 3: d95bc49d (big blind) folded before Flop
Seat 4: 91db230c folded before Flop (didn't bet)
Seat 5: 38e0f2fb folded before Flop (didn't bet)
Seat 6: Hero collected ($0.6)


Poker Hand #RC95109449: Hold'em No Limit ($0.1/$0.25) - 2020/04/07 16:10:55
Table 'RushAndCash367158' 6-max Seat #1 is the button
Seat 1: 6736194e ($31.64 in chips)
Seat 2: Hero ($57.38 in chips)
Seat 3: a0877c39 ($25.82 in chips)
Seat 4: 3f28d259 ($25 in chips)
Seat 5: 2aaed573 ($9.28 in chips)
Seat 6: 7c935d24 ($27.1 in chips)
Hero: posts small blind $0.1
a0877c39: posts big blind $0.25
*** HOLE CARDS ***
Dealt to 6736194e 
Dealt to Hero [7d 5c]
Dealt to a0877c39 
Dealt to 3f28d259 
Dealt to 2aaed573 
Dealt to 7c935d24 
3f28d259: folds
2aaed573: raises $0.38 to $0.63
7c935d24: raises $1.38 to $2.01
6736194e: folds
Hero: folds
a0877c39: folds
2aaed573: raises $1.38 to $3.39
7c935d24: raises $7.21 to $10.6
2aaed573: folds
Uncalled bet ($7.21) returned to 7c935d24
*** SHOWDOWN ***
7c935d24 collected $7.13 from pot
*** SUMMARY ***
Total pot $7.13
Seat 1: 6736194e (button) folded before Flop (didn't bet)
Seat 2: Hero (small blind) folded before Flop
Seat 3: a0877c39 (big blind) folded before Flop
Seat 4: 3f28d259 folded before Flop (didn't bet)
Seat 5: 2aaed573 folded before Flop
Seat 6: 7c935d24 collected ($7.13)


Poker Hand #RC95109485: Hold'em No Limit ($0.1/$0.25) - 2020/04/07 16:11:00
Table 'RushAndCash367163' 6-max Seat #1 is the button
Seat 1: 459706be ($23.07 in chips)
Seat 2: a4ba858f ($60.34 in chips)
Seat 3: e131407f ($25 in chips)
Seat 4: 303861a8 ($25 in chips)
Seat 5: 9c6a9689 ($25.35 in chips)
Seat 6: Hero ($57.28 in chips)
a4ba858f: posts small blind $0.1
e131407f: posts big blind $0.25
*** HOLE CARDS ***
Dealt to 459706be 
Dealt to a4ba858f 
Dealt to e131407f 
Dealt to 303861a8 
Dealt to 9c6a9689 
Dealt to Hero [4s 2c]
303861a8: raises $0.38 to $0.63
9c6a9689: folds
Hero: folds
459706be: folds
a4ba858f: raises $2.12 to $2.75
e131407f: folds
303861a8: folds
Uncalled bet ($2.12) returned to a4ba858f
*** SHOWDOWN ***
a4ba858f collected $1.51 from pot
*** SUMMARY ***
Total pot $1.51
Seat 1: 459706be (button) folded before Flop (didn't bet)
Seat 2: a4ba858f (small blind) collected ($1.51)
Seat 3: e131407f (big blind) folded before Flop
Seat 4: 303861a8 folded before Flop
Seat 5: 9c6a9689 folded before Flop (didn't bet)
Seat 6: Hero folded before Flop (didn't bet)


Poker Hand #RC95109513: Hold'em No Limit ($0.1/$0.25) - 2020/04/07 16:11:03
Table 'RushAndCash367166' 6-max Seat #1 is the button
Seat 1: Hero ($57.28 in chips)
Seat 2: dffd3b47 ($25.1 in chips)
Seat 3: d6f2a39c ($9.67 in chips)
Seat 4: bab42c59 ($27.42 in chips)
Seat 5: c72d31c5 ($25 in chips)
Seat 6: 13cda138 ($25.35 in chips)
dffd3b47: posts small blind $0.1
d6f2a39c: posts big blind $0.25
*** HOLE CARDS ***
Dealt to Hero [3c 2d]
Dealt to dffd3b47 
Dealt to d6f2a39c 
Dealt to bab42c59 
Dealt to c72d31c5 
Dealt to 13cda138 
bab42c59: folds
c72d31c5: raises $0.38 to $0.63
13cda138: folds
Hero: folds
dffd3b47: raises $1.67 to $2.3
d6f2a39c: folds
c72d31c5: folds
Uncalled bet ($1.67) returned to dffd3b47
*** SHOWDOWN ***
dffd3b47 collected $1.51 from pot
*** SUMMARY ***
Total pot $1.51
Seat 1: Hero (button) folded before Flop (didn't bet)
Seat 2: dffd3b47 (small blind) collected ($1.51)
Seat 3: d6f2a39c (big blind) folded before Flop
Seat 4: bab42c59 folded before Flop (didn't bet)
Seat 5: c72d31c5 folded before Flop
Seat 6: 13cda138 folded before Flop (didn't bet)


Poker Hand #RC95109545: Hold'em No Limit ($0.1/$0.25) - 2020/04/07 16:11:07
Table 'RushAndCash367170' 6-max Seat #1 is the button
Seat 1: de360084 ($12.5 in chips)
Seat 2: c601b22b ($30.36 in chips)
Seat 3: Hero ($57.28 in chips)
Seat 4: c2e8a25c ($12.96 in chips)
Seat 5: f92ad063 ($26.17 in chips)
Seat 6: 30cab83a ($77.22 in chips)
c601b22b: posts small blind $0.1
Hero: posts big blind $0.25
*** HOLE CARDS ***
Dealt to de360084 
Dealt to c601b22b 
Dealt to Hero [Ac 5s]
Dealt to c2e8a25c 
Dealt to f92ad063 
Dealt to 30cab83a 
c2e8a25c: folds
f92ad063: folds
30cab83a: folds
de360084: folds
c601b22b: folds
Uncalled bet ($0.15) returned to Hero
*** SHOWDOWN ***
Hero collected $0.2 from pot
*** SUMMARY ***
Total pot $0.2
Seat 1: de360084 (button) folded before Flop (didn't bet)
Seat 2: c601b22b (small blind) folded before Flop
Seat 3: Hero (big blind) collected ($0.2)
Seat 4: c2e8a25c folded before Flop (didn't bet)
Seat 5: f92ad063 folded before Flop (didn't bet)
Seat 6: 30cab83a folded before Flop (didn't bet)


Poker Hand #RC95109571: Hold'em No Limit ($0.1/$0.25) - 2020/04/07 16:11:11
Table 'RushAndCash367174' 6-max Seat #1 is the button
Seat 1: a1e9a341 ($25.57 in chips)
Seat 2: 2e4e94f0 ($11.4 in chips)
Seat 3: deb69778 ($27.51 in chips)
Seat 4: 4dd920ba ($92.03 in chips)
Seat 5: Hero ($57.03 in chips)
Seat 6: e5b62e2d ($25 in chips)
2e4e94f0: posts small blind $0.1
deb69778: posts big blind $0.25
*** HOLE CARDS ***
Dealt to a1e9a341 
Dealt to 2e4e94f0 
Dealt to deb69778 
Dealt to 4dd920ba 
Dealt to Hero [Qs 9c]
Dealt to e5b62e2d 
4dd920ba: folds
Hero: folds
e5b62e2d: folds
a1e9a341: folds
2e4e94f0: folds
Uncalled bet ($0.15) returned to deb69778
*** SHOWDOWN ***
deb69778 collected $0.2 from pot
*** SUMMARY ***
Total pot $0.2
Seat 1: a1e9a341 (button) folded before Flop (didn't bet)
Seat 2: 2e4e94f0 (small blind) folded before Flop
Seat 3: deb69778 (big blind) collected ($0.2)
Seat 4: 4dd920ba folded before Flop (didn't bet)
Seat 5: Hero folded before Flop (didn't bet)
Seat 6: e5b62e2d folded before Flop (didn't bet)


Poker Hand #RC95109600: Hold'em No Limit ($0.1/$0.25) - 2020/04/07 16:11:14
Table 'RushAndCash367178' 6-max Seat #1 is the button
Seat 1: 103129d8 ($47.08 in chips)
Seat 2: 421d7a8a ($31.65 in chips)
Seat 3: 750933bc ($25.6 in chips)
Seat 4: 181b6319 ($23.5 in chips)
Seat 5: Hero ($57.03 in chips)
Seat 6: e131407f ($25 in chips)
421d7a8a: posts small blind $0.1
750933bc: posts big blind $0.25
*** HOLE CARDS ***
Dealt to 103129d8 
Dealt to 421d7a8a 
Dealt to 750933bc 
Dealt to 181b6319 
Dealt to Hero [4h 4d]
Dealt to e131407f 
181b6319: folds
Hero: raises $0.38 to $0.63
e131407f: folds
103129d8: folds
421d7a8a: folds
750933bc: calls $0.38
*** FLOP *** [4s Th Js]
750933bc: checks
Hero: bets $0.62
750933bc: raises $1.48 to $2.1
Hero: raises $5.6 to $7.7
750933bc: raises $17.27 to $24.97 and is all-in
Hero: calls $17.27
750933bc: shows [Ts 8s] (Pair of Tens)
Hero: shows [4h 4d] (Three Fours)
*** TURN *** [4s Th Js] [5h]
*** RIVER *** [4s Th Js 5h] [6h]
*** SHOWDOWN ***
Hero collected $51.3 from pot
*** SUMMARY ***
Total pot $51.3
Board [4s Th Js 5h 6h]
Seat 1: 103129d8 (button) folded before Flop (didn't bet)
Seat 2: 421d7a8a (small blind) folded before Flop
Seat 3: 750933bc (big blind) showed [Ts 8s] and lost with Pair of Tens
Seat 4: 181b6319 folded before Flop (didn't bet)
Seat 5: Hero showed [4h 4d] and won ($51.3) with Three Fours
Seat 6: e131407f folded before Flop (didn't bet)


